date_reference,num_commune,nom_commune,numero_EPCI,nom_EPCI,numero_departement,nom_departement,places_EAJE_PSU,places_hors_EAJE_PSU,places_EAJE_ensemble,places_prescolarisation,places_assistante_maternelle,places_salariee_domicile,places_accueil_individuel_ensemble,places_offertes_ensemble
2017,01004,AMBERIEU EN BUGEY,240100883,CC DE LA PLAINE DE L'AIN,01,AIN,80,3,83,0,320,2,322,406
2017,01033,VALSERHONE,240100891,CC DU PAYS BELLEGARDIEN (CCPB),01,AIN,65,1,66,51,269,5,274,392
2017,01053,BOURG EN BRESSE,200071751,CA DU BASSIN DE BOURG-EN-BRESSE,01,AIN,331,3,334,101,362,10,372,807
2017,01322,REYRIEUX,200042497,CC DOMBES SAONE VALLEE,01,AIN,35,0,35,3,79,3,82,120
2017,02168,CHATEAU THIERRY,200072031,CA DE LA REGION DE CHATEAU-THIERRY,02,AISNE,102,1,103,37,212,5,217,357
2017,02408,LAON,200043495,CA DU PAYS DE LAON,02,AISNE,116,0,116,61,272,9,281,458
2017,03095,CUSSET,200071363,CA VICHY COMMUNAUTE,03,ALLIER,32,0,32,53,135,4,139,224
2017,05023,BRIANCON,240500439,CC DU BRIANCONNAIS,05,HAUTES ALPES,103,3,106,11,84,4,88,204
2017,06161,VILLENEUVE LOUBET,240600585,CA DE SOPHIA ANTIPOLIS,06,ALPES MARITIMES,177,3,180,0,137,5,142,322
2017,07324,TOURNON SUR RHONE,200073096,CA ARCHE AGGLO,07,ARDECHE,50,0,50,43,127,6,133,226
2017,09225,PAMIERS,200066231,CC DES PORTES D'ARIEGE PYRENEES,09,ARIEGE,178,0,178,27,97,2,99,304
2017,11076,CASTELNAUDARY,200035855,CC CASTELNAUDARY LAURAGAIS AUDOIS,11,AUDE,40,10,50,29,98,6,104,183
2017,12202,RODEZ,241200187,CA RODEZ AGGLOMERATION,12,AVEYRON,216,5,221,67,169,18,187,475
2017,12300,VILLEFRANCHE DE ROUERGUE,200069383,CC DU GRAND VILLEFRANCHOIS,12,AVEYRON,44,0,44,36,135,0,135,215
2017,13001,AIX EN PROVENCE,200054807,METROPOLE D'AIX-MARSEILLE-PROVENCE,13,BOUCHES DU RHONE,1326,141,1467,85,977,133,1110,2662
2017,13028,LA CIOTAT,200054807,METROPOLE D'AIX-MARSEILLE-PROVENCE,13,BOUCHES DU RHONE,236,1,237,28,282,16,298,563
2017,13069,PELISSANNE,200054807,METROPOLE D'AIX-MARSEILLE-PROVENCE,13,BOUCHES DU RHONE,72,3,75,7,134,2,136,218
2017,13081,ROGNAC,200054807,METROPOLE D'AIX-MARSEILLE-PROVENCE,13,BOUCHES DU RHONE,81,3,84,0,133,3,136,220
2017,13117,VITROLLES,200054807,METROPOLE D'AIX-MARSEILLE-PROVENCE,13,BOUCHES DU RHONE,378,16,394,70,266,13,279,743
2017,13203,MARSEILLE 3E ARRONDISSEMENT,200054807,METROPOLE D'AIX-MARSEILLE-PROVENCE,13,BOUCHES DU RHONE,359,14,373,100,117,14,131,604
2017,13205,MARSEILLE 5E ARRONDISSEMENT,200054807,METROPOLE D'AIX-MARSEILLE-PROVENCE,13,BOUCHES DU RHONE,549,77,626,0,327,30,357,983
2017,13210,MARSEILLE 10E ARRONDISSEMENT,200054807,METROPOLE D'AIX-MARSEILLE-PROVENCE,13,BOUCHES DU RHONE,320,45,365,48,374,23,397,810
2017,21166,CHENOVE,242100410,DIJON METROPOLE,21,COTE D OR,96,7,103,90,159,8,167,360
2017,21231,DIJON,242100410,DIJON METROPOLE,21,COTE D OR,1555,128,1683,185,1210,78,1288,3156
2017,23096,GUERET,200034825,CA DU GRAND GUERET,23,CREUSE,82,0,82,33,164,1,165,280
2017,26057,BOURG DE PEAGE,200068781,CA VALENCE ROMANS AGGLO,26,DROME,20,7,27,0,129,8,137,163
2017,26198,MONTELIMAR,200040459,CA MONTELIMAR AGGLOMERATION,26,DROME,186,33,219,58,396,5,401,678
2017,27229,EVREUX,200071454,CA EVREUX PORTES DE NORMANDIE,27,EURE,483,12,495,75,318,3,321,890
2017,27467,PONT AUDEMER,200065787,CC DE PONT-AUDEMER / VAL DE RISLE,27,EURE,20,1,21,30,147,0,147,198
2017,28085,CHARTRES,200033181,CA CHARTRES METROPOLE,28,EURE ET LOIR,365,7,372,43,363,17,380,795
2017,29046,DOUARNENEZ,242900645,CC DOUARNENEZ COMMUNAUTE,29,FINISTERE,42,0,42,56,139,0,139,237
2017,30341,VAUVERT,243000593,CC DE PETITE CAMARGUE,30,GARD,37,0,37,31,71,1,72,140
2017,31116,CASTELGINEST,243100518,TOULOUSE METROPOLE,31,HAUTE GARONNE,49,0,49,0,201,4,205,255
2017,31557,TOURNEFEUILLE,243100518,TOULOUSE METROPOLE,31,HAUTE GARONNE,268,5,273,14,318,33,351,638
2017,33005,ANDERNOS LES BAINS,243301504,CA DU BASSIN D'ARCACHON NORD,33,GIRONDE,42,0,42,5,108,3,111,158
2017,33249,LORMONT,243300316,BORDEAUX METROPOLE,33,GIRONDE,166,4,170,74,223,4,227,471
2017,33522,TALENCE,243300316,BORDEAUX METROPOLE,33,GIRONDE,390,28,418,6,448,34,482,906
2017,34123,JUVIGNAC,243400017,MONTPELLIER MEDITERRANEE METROPOLE,34,HERAULT,70,3,73,0,125,7,132,205
2017,34145,LUNEL,243400520,CC DU PAYS DE LUNEL,34,HERAULT,103,3,106,35,273,7,280,420
2017,34301,SETE,200066355,CA SETE AGGLOPOLE MEDITERRANEE,34,HERAULT,226,32,258,35,168,11,179,472
2017,35115,FOUGERES,200072452,CA FOUGERES AGGLOMERATION,35,ILLE ET VILAINE,84,18,102,67,223,4,227,395
2017,35360,VITRE,200039022,CA VITRE COMMUNAUTE,35,ILLE ET VILAINE,105,0,105,45,342,12,354,504
2017,37109,FONDETTES,243700754,TOURS METROPOLE VAL DE LOIRE,37,INDRE ET LOIRE,70,1,71,0,160,8,168,238
2017,37156,MONTLOUIS SUR LOIRE,200073161,CC TOURAINE-EST VALLEES,37,INDRE ET LOIRE,35,0,35,0,273,6,279,315
2017,38158,EYBENS,200040715,GRENOBLE-ALPES-METROPOLE,38,ISERE,191,15,206,0,131,12,143,349
2017,38229,MEYLAN,200040715,GRENOBLE-ALPES-METROPOLE,38,ISERE,194,15,209,0,199,23,222,430
2017,38317,LE PONT DE CLAIX,200040715,GRENOBLE-ALPES-METROPOLE,38,ISERE,119,0,119,38,143,1,144,302
2017,40046,BISCARROSSE,244000873,CC DES GRANDS LACS,40,LANDES,84,1,85,0,178,1,179,264
2017,40312,TARNOS,244000659,CC DU SEIGNANX,40,LANDES,60,40,100,3,137,7,144,248
2017,42184,RIORGES,200035731,CA ROANNAIS AGGLOMERATION,42,LOIRE,42,4,46,7,115,6,121,174
2017,43157,LE PUY EN VELAY,200073419,CA DU PUY-EN-VELAY,43,HAUTE LOIRE,81,3,84,131,175,7,182,397
2017,44047,COUERON,244400404,NANTES METROPOLE,44,LOIRE ATLANTIQUE,64,31,95,0,525,10,535,630
2017,45075,LA CHAPELLE SAINT MESMIN,244500468,ORLEANS METROPOLE,45,LOIRET,59,8,67,0,196,3,199,266
2017,45208,MONTARGIS,244500203,CA MONTARGOISE ET RIVES DU LOING (AME),45,LOIRET,131,1,132,35,69,6,75,242
2017,45234,ORLEANS,244500468,ORLEANS METROPOLE,45,LOIRET,1149,87,1236,201,1075,128,1203,2641
2017,45284,SAINT JEAN DE BRAYE,244500468,ORLEANS METROPOLE,45,LOIRET,198,23,221,0,276,12,288,509
2017,49015,AVRILLE,244900015,CU ANGERS LOIRE METROPOLE,49,MAINE ET LOIRE,84,16,100,18,213,6,219,337
2017,49099,CHOLET,200071678,CA AGGLOMERATION DU CHOLETAIS,49,MAINE ET LOIRE,308,3,311,174,709,23,732,1218
2017,55545,VERDUN,200049187,CA DU GRAND VERDUN,55,MEUSE,82,0,82,40,200,8,208,330
2017,56162,PLOEMEUR,200042174,CA LORIENT AGGLOMERATION,56,MORBIHAN,100,5,105,49,157,13,170,324
2017,57433,MAIZIERES LES METZ,200039949,CC RIVES DE MOSELLE,57,MOSELLE,30,1,31,0,220,1,221,252
2017,58194,NEVERS,245804406,CA DE NEVERS,58,NIEVRE,246,5,251,81,204,12,216,548
2017,59014,ANZIN,245901160,CA VALENCIENNES METROPOLE,59,NORD,37,0,37,83,118,2,120,240
2017,59249,FOURMIES,200043404,CC DU SUD AVESNOIS,59,NORD,24,5,29,60,66,0,66,155
2017,59360,LOOS,245900410,METROPOLE EUROPEENNE DE LILLE,59,NORD,135,12,147,46,320,11,331,524
2017,59421,MOUVAUX,245900410,METROPOLE EUROPEENNE DE LILLE,59,NORD,85,34,119,25,229,30,259,403
2017,59526,SAINT AMAND LES EAUX,200042190,CA DE LA PORTE DU HAINAUT,59,NORD,70,0,70,42,218,5,223,335
2017,59574,SOMAIN,245901152,CC COEUR D'OSTREVENT (CCCO),59,NORD,40,4,44,44,123,2,125,213
2017,59650,WATTRELOS,245900410,METROPOLE EUROPEENNE DE LILLE,59,NORD,205,24,229,178,469,7,476,882
2017,60157,CLERMONT,246000376,CC DU CLERMONTOIS,60,OISE,65,2,67,12,135,1,136,215
2017,60176,CREPY EN VALOIS,246000871,CC DU PAYS DE VALOIS,60,OISE,137,2,139,14,259,5,264,417
2017,62108,BERCK,200069029,CA DES DEUX BAIES EN MONTREUILLOIS,62,PAS DE CALAIS,136,3,139,35,78,1,79,253
2017,62160,BOULOGNE SUR MER,246200729,CA DU BOULONNAIS,62,PAS DE CALAIS,259,6,265,159,155,7,162,585
2017,62186,BULLY LES MINES,246200364,CA DE LENS - LIEVIN,62,PAS DE CALAIS,30,5,35,42,137,2,139,216
2017,62413,HARNES,246200364,CA DE LENS - LIEVIN,62,PAS DE CALAIS,0,17,17,46,133,1,134,197
2017,62498,LENS,246200364,CA DE LENS - LIEVIN,62,PAS DE CALAIS,115,29,144,134,173,5,178,456
2017,04070,DIGNE LES BAINS,200067437,CA PROVENCE-ALPES-AGGLOMERATION,04,ALPES DE HAUTE PROVENCE,104,11,115,20,132,2,134,270
2017,06033,CARROS,200030195,METROPOLE NICE COTE D'AZUR,06,ALPES MARITIMES,78,10,88,24,136,3,139,250
2017,10362,SAINTE SAVINE,200069250,CA TROYES CHAMPAGNE METROPOLE,10,AUBE,69,0,69,0,168,2,170,239
2017,11069,CARCASSONNE,200035715,CA CARCASSONNE AGGLO,11,AUDE,269,0,269,94,341,33,374,737
2017,13041,GARDANNE,200054807,METROPOLE D'AIX-MARSEILLE-PROVENCE,13,BOUCHES DU RHONE,155,12,167,52,221,4,225,445
2017,13047,ISTRES,200054807,METROPOLE D'AIX-MARSEILLE-PROVENCE,13,BOUCHES DU RHONE,454,0,454,0,318,8,326,780
2017,13054,MARIGNANE,200054807,METROPOLE D'AIX-MARSEILLE-PROVENCE,13,BOUCHES DU RHONE,290,9,299,0,269,7,276,575
2017,13108,TARASCON,241300417,CA D'ARLES-CRAU-CAMARGUE-MONTAGNETTE,13,BOUCHES DU RHONE,95,1,96,10,81,1,82,188
2017,13201,MARSEILLE 1ER ARRONDISSEMENT,200054807,METROPOLE D'AIX-MARSEILLE-PROVENCE,13,BOUCHES DU RHONE,235,42,277,16,148,31,179,472
2017,13204,MARSEILLE 4E ARRONDISSEMENT,200054807,METROPOLE D'AIX-MARSEILLE-PROVENCE,13,BOUCHES DU RHONE,409,51,460,15,380,26,406,882
2017,13212,MARSEILLE 12E ARRONDISSEMENT,200054807,METROPOLE D'AIX-MARSEILLE-PROVENCE,13,BOUCHES DU RHONE,280,99,379,17,434,45,479,875
2017,13215,MARSEILLE 15E ARRONDISSEMENT,200054807,METROPOLE D'AIX-MARSEILLE-PROVENCE,13,BOUCHES DU RHONE,478,18,496,328,200,17,217,1041
2017,13216,MARSEILLE 16E ARRONDISSEMENT,200054807,METROPOLE D'AIX-MARSEILLE-PROVENCE,13,BOUCHES DU RHONE,238,8,246,48,68,12,80,374
2017,15014,AURILLAC,241500230,CA DU BASSIN D'AURILLAC,15,CANTAL,190,4,194,44,252,7,259,497
2017,17299,ROCHEFORT,200041762,CA ROCHEFORT OCEAN,17,CHARENTE MARITIME,205,0,205,45,244,3,247,497
2017,17415,SAINTES,200036473,CA DE SAINTES,17,CHARENTE MARITIME,139,0,139,24,319,6,325,488
2017,22215,PLOUFRAGAN,200069409,CA SAINT-BRIEUC ARMOR AGGLOMERATION,22,COTES D ARMOR,72,0,72,25,171,5,176,273
2017,25580,VALENTIGNEY,200065647,CA PAYS DE MONTBELIARD AGGLOMERATION,25,DOUBS,37,0,37,23,83,3,86,146
2017,26362,VALENCE,200068781,CA VALENCE ROMANS AGGLO,26,DROME,720,24,744,161,465,51,516,1420
2017,27284,GISORS,200071843,CC DU VEXIN NORMAND,27,EURE,109,2,111,3,116,1,117,230
2017,27375,LOUVIERS,200035665,CA SEINE EURE,27,EURE,183,1,184,36,167,4,171,391
2017,27681,VERNON,200072312,CA SEINE NORMANDIE AGGLOMERATION,27,EURE,170,34,204,9,199,8,207,419
2017,28218,LUCE,200033181,CA CHARTRES METROPOLE,28,EURE ET LOIR,158,1,159,0,212,4,216,375
2017,29212,PLOUZANE,242900314,BREST METROPOLE,29,FINISTERE,48,0,48,54,307,10,317,419
2017,2A247,PORTO VECCHIO,200040764,CC DU SUD CORSE,2A,CORSE DU SUD,78,0,78,16,37,10,47,141
2017,30189,NIMES,243000643,CA DE NIMES METROPOLE,30,GARD,1095,3,1098,185,419,75,494,1777
2017,31044,BALMA,243100518,TOULOUSE METROPOLE,31,HAUTE GARONNE,186,16,202,0,216,23,239,442
2017,31424,PLAISANCE DU TOUCH,243100781,CC DE LA SAVE AU TOUCH,31,HAUTE GARONNE,118,2,120,0,287,10,297,418
2017,31483,SAINT GAUDENS,200072643,CC COEUR ET COTEAUX DU COMMINGES,31,HAUTE GARONNE,114,0,114,2,89,1,90,206
2017,31488,SAINT JEAN,243100518,TOULOUSE METROPOLE,31,HAUTE GARONNE,76,2,78,0,160,3,163,241
2017,33003,AMBARES ET LAGRAVE,243300316,BORDEAUX METROPOLE,33,GIRONDE,99,15,114,10,301,1,302,426
2017,33009,ARCACHON,243300563,CA BASSIN D'ARCACHON SUD-POLE ATLANTIQUE (COBAS),33,GIRONDE,88,1,89,18,24,1,25,132
2017,33075,BRUGES,243300316,BORDEAUX METROPOLE,33,GIRONDE,253,6,259,0,301,23,324,583
2017,33238,LEOGNAN,243301264,CC DE MONTESQUIEU,33,GIRONDE,39,14,53,16,180,5,185,254
2017,33449,SAINT MEDARD EN JALLES,243300316,BORDEAUX METROPOLE,33,GIRONDE,222,3,225,0,541,9,550,775
2017,33550,VILLENAVE D ORNON,243300316,BORDEAUX METROPOLE,33,GIRONDE,332,13,345,18,560,23,583,946
2017,35024,BETTON,243500139,RENNES METROPOLE,35,ILLE ET VILAINE,44,23,67,17,248,12,260,343
2017,35210,PACE,243500139,RENNES METROPOLE,35,ILLE ET VILAINE,60,2,62,21,193,6,199,282
2017,35281,SAINT JACQUES DE LA LANDE,243500139,RENNES METROPOLE,35,ILLE ET VILAINE,133,11,144,28,217,10,227,399
2017,36044,CHATEAUROUX,243600327,CA CHATEAUROUX METROPOLE,36,INDRE,274,0,274,72,517,10,527,874
2017,37122,JOUE LES TOURS,243700754,TOURS METROPOLE VAL DE LOIRE,37,INDRE ET LOIRE,240,16,256,42,624,14,638,936
2017,37233,SAINT PIERRE DES CORPS,243700754,TOURS METROPOLE VAL DE LOIRE,37,INDRE ET LOIRE,96,9,105,55,296,6,302,462
2017,38169,FONTAINE,200040715,GRENOBLE-ALPES-METROPOLE,38,ISERE,147,7,154,43,350,16,366,562
2017,38382,SAINT EGREVE,200040715,GRENOBLE-ALPES-METROPOLE,38,ISERE,184,2,186,0,271,9,280,466
2017,40088,DAX,244000675,CA DU GRAND DAX,40,LANDES,202,1,203,54,124,11,135,391
2017,41018,BLOIS,200030385,CA DE BLOIS ''AGGLOPOLYS'',41,LOIR ET CHER,340,0,340,126,482,22,504,970
2017,44026,CARQUEFOU,244400404,NANTES METROPOLE,44,LOIRE ATLANTIQUE,158,0,158,21,353,10,363,542
2017,44036,CHATEAUBRIANT,200072726,CC CHATEAUBRIANT-DERVAL,44,LOIRE ATLANTIQUE,56,0,56,26,150,3,153,235
2017,44184,SAINT NAZAIRE,244400644,CA DE LA REGION NAZAIRIENNE ET DE L'ESTUAIRE (CARENE),44,LOIRE ATLANTIQUE,380,19,399,177,866,40,906,1482
2017,45155,GIEN,244500211,CC GIENNOISES,45,LOIRET,80,5,85,24,141,2,143,252
2017,45232,OLIVET,244500468,ORLEANS METROPOLE,45,LOIRET,231,14,245,17,208,15,223,485
2017,45302,SARAN,244500468,ORLEANS METROPOLE,45,LOIRET,182,3,185,0,242,5,247,433
2017,49069,OREE D ANJOU,200060010,CA MAUGES COMMUNAUTE,49,MAINE ET LOIRE,24,2,26,42,472,2,474,542
2017,49328,SAUMUR,200071876,CA SAUMUR VAL DE LOIRE,49,MAINE ET LOIRE,170,12,182,80,289,11,300,563
2017,50041,LA HAGUE,200067205,CA DU COTENTIN,50,MANCHE,22,0,22,21,278,4,282,325
2017,50099,CARENTAN LES MARAIS,200042729,CC DE LA BAIE DU COTENTIN,50,MANCHE,23,0,23,35,176,0,176,235
2017,54329,LUNEVILLE,200070324,CC DU TERRITOIRE DE LUNEVILLE A BACCARAT,54,MEURTHE ET MOSELLE,96,0,96,64,199,2,201,361
2017,54431,PONT MOUSSON,200041515,CC DU BASSIN DE PONT-A-MOUSSON,54,MEURTHE ET MOSELLE,50,0,50,21,168,3,171,242
2017,56078,GUIDEL,200042174,CA LORIENT AGGLOMERATION,56,MORBIHAN,30,1,31,38,187,9,196,265
2017,56098,LANESTER,200042174,CA LORIENT AGGLOMERATION,56,MORBIHAN,119,4,123,104,312,4,316,543
2017,57306,HAYANGE,245701222,CA DU VAL DE FENSCH,57,MOSELLE,55,4,59,3,138,3,141,203
2017,57660,STIRING WENDEL,245700372,CA DE FORBACH PORTE DE FRANCE,57,MOSELLE,40,0,40,8,67,0,67,115
2017,59011,ANNOEULLIN,245901061,CC DE LA HAUTE DEULE,59,NORD,54,5,59,45,130,2,132,236
2017,59178,DOUAI,200044618,CA DU DOUAISIS (CAD),59,NORD,221,7,228,224,245,12,257,709
2017,59271,GRANDE SYNTHE,245900428,CU DE DUNKERQUE,59,NORD,158,5,163,172,124,0,124,459
2017,59295,HAZEBROUCK,200040947,CC DE FLANDRE INTERIEURE,59,NORD,86,0,86,100,342,5,347,533
2017,59324,JEUMONT,200043396,CA MAUBEUGE VAL DE SAMBRE,59,NORD,20,0,20,64,90,1,91,175
2017,59392,MAUBEUGE,200043396,CA MAUBEUGE VAL DE SAMBRE,59,NORD,116,0,116,162,167,3,170,448
2017,59426,NEUVILLE EN FERRAIN,245900410,METROPOLE EUROPEENNE DE LILLE,59,NORD,90,4,94,67,102,1,103,264
2017,59508,RONCQ,245900410,METROPOLE EUROPEENNE DE LILLE,59,NORD,82,8,90,59,149,3,152,301
2017,59527,SAINT ANDRE LEZ LILLE,245900410,METROPOLE EUROPEENNE DE LILLE,59,NORD,100,24,124,34,157,15,172,330
2017,59599,TOURCOING,245900410,METROPOLE EUROPEENNE DE LILLE,59,NORD,555,74,629,451,956,29,985,2064
2017,60141,CHANTILLY,246000764,CC DE L'AIRE CANTILIENNE,60,OISE,138,4,142,12,195,3,198,352
2017,60175,CREIL,200068047,CA CREIL SUD OISE,60,OISE,249,2,251,68,177,4,181,499
2017,61169,FLERS,200035814,CA FLERS AGGLO,61,ORNE,62,1,63,33,152,2,154,251
2017,62427,HENIN BEAUMONT,246200299,CA D'HENIN-CARVIN,62,PAS DE CALAIS,110,32,142,52,212,2,214,408
2019,57630,SARREBOURG,200068146,CC SARREBOURG MOSELLE SUD,57,MOSELLE,50,3,53,3,133,2,135,192
2019,57631,SARREGUEMINES,200070746,CA SARREGUEMINES CONFLUENCES,57,MOSELLE,270,0,270,35,62,1,63,368
2019,57660,STIRING WENDEL,245700372,CA DE FORBACH PORTE DE FRANCE,57,MOSELLE,40,0,40,10,54,0,54,104
2019,57672,THIONVILLE,245701362,CA PORTES DE FRANCE-THIONVILLE,57,MOSELLE,238,55,293,7,313,13,326,626
2019,57751,WOIPPY,200039865,METZ METROPOLE,57,MOSELLE,30,5,35,19,149,3,152,206
2019,59009,VILLENEUVE D ASCQ,245900410,METROPOLE EUROPEENNE DE LILLE,59,NORD,610,109,719,222,585,25,610,1551
2019,59163,CROIX,245900410,METROPOLE EUROPEENNE DE LILLE,59,NORD,119,41,160,68,297,19,316,543
2019,59179,DOUCHY LES MINES,200042190,CA DE LA PORTE DU HAINAUT,59,NORD,20,2,22,94,134,0,134,250
2019,59286,HAUBOURDIN,245900410,METROPOLE EUROPEENNE DE LILLE,59,NORD,61,26,87,43,235,9,244,374
2019,59367,LYS LEZ LANNOY,245900410,METROPOLE EUROPEENNE DE LILLE,59,NORD,44,17,61,51,179,6,185,298
2019,59386,MARQUETTE LEZ LILLE,245900410,METROPOLE EUROPEENNE DE LILLE,59,NORD,115,8,123,10,243,9,252,385
2019,59392,MAUBEUGE,200043396,CA MAUBEUGE VAL DE SAMBRE,59,NORD,116,1,117,141,166,2,168,427
2019,59421,MOUVAUX,245900410,METROPOLE EUROPEENNE DE LILLE,59,NORD,85,58,143,42,218,22,240,425
2019,59512,ROUBAIX,245900410,METROPOLE EUROPEENNE DE LILLE,59,NORD,900,44,944,373,388,35,423,1740
2019,59526,SAINT AMAND LES EAUX,200042190,CA DE LA PORTE DU HAINAUT,59,NORD,85,1,86,40,228,6,234,360
2019,59527,SAINT ANDRE LEZ LILLE,245900410,METROPOLE EUROPEENNE DE LILLE,59,NORD,103,27,130,21,155,5,160,311
2019,59569,SIN LE NOBLE,200044618,CA DOUAISIS AGGLO,59,NORD,60,9,69,76,153,2,155,300
2019,59574,SOMAIN,245901152,CC COEUR D'OSTREVENT (CCCO),59,NORD,40,7,47,54,127,2,129,230
2019,59606,VALENCIENNES,245901160,CA VALENCIENNES METROPOLE,59,NORD,362,10,372,166,312,9,321,858
2019,60057,BEAUVAIS,200067999,CA DU BEAUVAISIS,60,OISE,530,10,540,175,440,10,450,1165
2019,60157,CLERMONT,246000376,CC DU CLERMONTOIS,60,OISE,65,0,65,10,138,8,146,222
2019,60175,CREIL,200068047,CA CREIL SUD OISE,60,OISE,247,5,252,70,176,8,184,506
2019,60463,NOGENT SUR OISE,200068047,CA CREIL SUD OISE,60,OISE,110,1,111,47,166,5,171,329
2019,60612,SENLIS,200066975,CC SENLIS SUD OISE,60,OISE,144,3,147,11,211,18,229,387
2019,62041,ARRAS,200033579,CU D'ARRAS,62,PAS DE CALAIS,339,62,401,136,284,25,309,845
2019,62065,AVION,246200364,CA DE LENS - LIEVIN,62,PAS DE CALAIS,24,16,40,60,123,1,124,224
2019,62108,BERCK,200069029,CA DES DEUX BAIES EN MONTREUILLOIS,62,PAS DE CALAIS,136,3,139,41,66,0,66,247
2019,62178,BRUAY LA BUISSIERE,200072460,CA DE BETHUNE-BRUAY,62,PAS DE CALAIS,60,7,67,80,163,0,163,310
2019,62186,BULLY LES MINES,246200364,CA DE LENS - LIEVIN,62,PAS DE CALAIS,30,11,41,33,119,0,119,194
2019,62215,CARVIN,246200299,CA D'HENIN-CARVIN,62,PAS DE CALAIS,60,14,74,23,242,2,244,341
2019,62250,COURRIERES,246200299,CA D'HENIN-CARVIN,62,PAS DE CALAIS,70,8,78,48,116,0,116,242
2019,62427,HENIN BEAUMONT,246200299,CA D'HENIN-CARVIN,62,PAS DE CALAIS,110,53,163,48,205,4,209,420
2019,62498,LENS,246200364,CA DE LENS - LIEVIN,62,PAS DE CALAIS,115,35,150,142,163,4,167,459
2019,62570,MERICOURT,246200364,CA DE LENS - LIEVIN,62,PAS DE CALAIS,10,16,26,28,96,2,98,152
2019,62617,NOEUX LES MINES,200072460,CA DE BETHUNE-BRUAY,62,PAS DE CALAIS,60,2,62,37,91,2,93,192
2019,62643,OUTREAU,246200729,CA DU BOULONNAIS,62,PAS DE CALAIS,60,1,61,51,87,1,88,200
2019,62758,SAINT MARTIN BOULOGNE,246200729,CA DU BOULONNAIS,62,PAS DE CALAIS,50,10,60,55,110,4,114,229
2019,63014,AUBIERE,246300701,CLERMONT AUVERGNE METROPOLE,63,PUY DE DOME,92,3,95,0,110,4,114,209
2019,63032,BEAUMONT,246300701,CLERMONT AUVERGNE METROPOLE,63,PUY DE DOME,52,22,74,0,139,2,141,216
2019,63164,GERZAT,246300701,CLERMONT AUVERGNE METROPOLE,63,PUY DE DOME,40,0,40,0,215,3,218,258
2019,63430,THIERS,200070712,CC THIERS DORE ET MONTAGNE,63,PUY DE DOME,15,2,17,14,116,9,125,155
2019,64122,BIARRITZ,200067106,CA DU PAYS BASQUE,64,PYRENEES ATLANTIQUES,200,39,239,19,114,15,129,387
2019,64260,HENDAYE,200067106,CA DU PAYS BASQUE,64,PYRENEES ATLANTIQUES,86,16,102,12,72,1,73,187
2019,64422,OLORON SAINTE MARIE,200067262,CC DU HAUT BEARN,64,PYRENEES ATLANTIQUES,91,0,91,22,69,0,69,182
2019,64545,URRUGNE,200067106,CA DU PAYS BASQUE,64,PYRENEES ATLANTIQUES,81,19,100,9,62,4,66,175
2019,65286,LOURDES,200069300,CA TARBES-LOURDES-PYRENEES,65,HAUTES PYRENEES,129,1,130,38,49,2,51,218
2019,66008,ARGELES SUR MER,200043602,CC DES ALBERES,66,PYRENEES ORIENTALES,47,6,53,0,67,5,72,125
2019,66136,PERPIGNAN,200027183,CU PERPIGNAN MEDITERRANEE METROPOLE,66,PYRENEES ORIENTALES,742,99,841,379,448,33,481,1701
2019,67180,HAGUENAU,200067874,CA DE HAGUENAU,67,BAS RHIN,338,96,434,0,228,6,234,668
2019,67218,ILLKIRCH GRAFFENSTADEN,246700488,EUROMETROPOLE DE STRASBOURG,67,BAS RHIN,409,34,443,0,257,5,262,705
2019,67365,OSTWALD,246700488,EUROMETROPOLE DE STRASBOURG,67,BAS RHIN,160,12,172,0,114,3,117,289
2019,67437,SAVERNE,200068112,CC DU PAYS DE SAVERNE,67,BAS RHIN,111,12,123,20,73,6,79,223
2019,68063,CERNAY,200036465,CC DE THANN-CERNAY,68,HAUT RHIN,33,10,43,8,115,0,115,166
2019,68112,GUEBWILLER,246800569,CC DE LA REGION DE GUEBWILLER,68,HAUT RHIN,70,6,76,0,36,6,42,117
2019,68271,RIEDISHEIM,200066009,CA MULHOUSE ALSACE AGGLOMERATION,68,HAUT RHIN,70,1,71,0,84,3,87,158
2019,68375,WITTELSHEIM,200066009,CA MULHOUSE ALSACE AGGLOMERATION,68,HAUT RHIN,40,7,47,0,136,2,138,185
2019,69019,BELLEVILLE EN BEAUJOLAIS,200067817,CC SAONE-BEAUJOLAIS,69,RHONE,40,10,50,14,189,3,192,256
2019,69089,FRANCHEVILLE,200046977,METROPOLE DE LYON,69,RHONE,105,46,151,0,163,14,177,328
2019,69149,OULLINS,200046977,METROPOLE DE LYON,69,RHONE,204,36,240,21,350,27,377,638
2019,69199,SAINT FONS,200046977,METROPOLE DE LYON,69,RHONE,157,1,158,93,104,6,110,361
2019,69243,TARARE,200040566,CA DE L'OUEST RHODANIEN,69,RHONE,98,2,100,30,87,3,90,220
2019,69244,TASSIN LA DEMI LUNE,200046977,METROPOLE DE LYON,69,RHONE,158,73,231,3,235,21,256,490
2019,69273,CORBAS,200046977,METROPOLE DE LYON,69,RHONE,84,4,88,0,149,4,153,241
2019,69275,DECINES CHARPIEU,200046977,METROPOLE DE LYON,69,RHONE,174,51,225,51,372,7,379,655
2019,69277,GENAS,246900575,CC DE L'EST LYONNAIS (CCEL),69,RHONE,96,25,121,0,160,12,172,293
2019,69283,MIONS,200046977,METROPOLE DE LYON,69,RHONE,59,31,90,0,232,5,237,327
2019,69286,RILLIEUX LA PAPE,200046977,METROPOLE DE LYON,69,RHONE,224,53,277,57,261,15,276,610
2019,69382,LYON 2E ARRONDISSEMENT,200046977,METROPOLE DE LYON,69,RHONE,406,97,503,3,263,118,381,887
2019,69383,LYON 3E ARRONDISSEMENT,200046977,METROPOLE DE LYON,69,RHONE,1415,266,1681,18,977,274,1251,2950
2019,69389,LYON 9E ARRONDISSEMENT,200046977,METROPOLE DE LYON,69,RHONE,640,62,702,149,529,70,599,1450
2019,71014,AUTUN,200070530,CC DU GRAND AUTUNOIS MORVAN,71,SAONE ET LOIRE,91,0,91,37,118,2,120,248
2019,71153,LE CREUSOT,247100290,CU LE CREUSOT MONTCEAU-LES-MINES,71,SAONE ET LOIRE,68,19,87,71,191,3,194,352
2019,71306,MONTCEAU LES MINES,247100290,CU LE CREUSOT MONTCEAU-LES-MINES,71,SAONE ET LOIRE,55,6,61,60,159,0,159,280
2019,72181,LE MANS,247200132,CU LE MANS METROPOLE,72,SARTHE,623,31,654,253,1975,75,2050,2957
2019,73008,AIX LES BAINS,200068674,CA GRAND LAC,73,SAVOIE,155,42,197,27,335,16,351,576
2019,73179,LA MOTTE SERVOLEX,200069110,CA DU GRAND CHAMBERY,73,SAVOIE,50,8,58,2,183,7,190,250
2019,74010,ANNECY,200066793,CA DU GRAND ANNECY,74,HAUTE SAVOIE,1241,83,1324,51,1224,94,1318,2693
2019,74012,ANNEMASSE,200011773,CA ANNEMASSE-LES VOIRONS-AGGLOMERATION,74,HAUTE SAVOIE,185,9,194,42,354,8,362,599
2019,74042,BONNEVILLE,200000172,CC FAUCIGNY-GLIERES,74,HAUTE SAVOIE,52,18,70,0,202,1,203,273
2019,74133,GAILLARD,200011773,CA ANNEMASSE-LES VOIRONS-AGGLOMERATION,74,HAUTE SAVOIE,101,0,101,26,78,3,81,208
2019,74256,SALLANCHES,200034882,CC PAYS DU MONT-BLANC,74,HAUTE SAVOIE,108,8,116,0,185,4,189,305
2019,74281,THONON LES BAINS,200067551,CA THONON AGGLOMERATION,74,HAUTE SAVOIE,165,19,184,0,417,11,428,612
2019,75103,PARIS 3E ARRONDISSEMENT,200054781,METROPOLE DU GRAND PARIS,75,PARIS,601,23,624,11,67,191,258,893
2019,75112,PARIS 12E ARRONDISSEMENT,200054781,METROPOLE DU GRAND PARIS,75,PARIS,2902,194,3096,7,450,576,1026,4129
2019,75115,PARIS 15E ARRONDISSEMENT,200054781,METROPOLE DU GRAND PARIS,75,PARIS,4034,318,4352,63,420,1441,1861,6276
2019,75119,PARIS 19E ARRONDISSEMENT,200054781,METROPOLE DU GRAND PARIS,75,PARIS,4510,19,4529,171,332,607,939,5639
2019,76114,BOLBEC,200010700,CA CAUX SEINE AGGLO,76,SEINE MARITIME,38,0,38,41,153,3,156,235
2019,76157,CANTELEU,200023414,METROPOLE ROUEN NORMANDIE,76,SEINE MARITIME,157,3,160,42,139,0,139,341
2019,76351,LE HAVRE,200084952,CU LE HAVRE SEINE METROPOLE,76,SEINE MARITIME,863,146,1009,124,1996,72,2068,3202
2019,76451,MONT SAINT AIGNAN,200023414,METROPOLE ROUEN NORMANDIE,76,SEINE MARITIME,258,18,276,5,157,23,180,461
2019,76476,PORT JEROME SUR SEINE,200010700,CA CAUX SEINE AGGLO,76,SEINE MARITIME,30,1,31,0,220,3,223,254
2019,76498,LE PETIT QUEVILLY,200023414,METROPOLE ROUEN NORMANDIE,76,SEINE MARITIME,114,14,128,52,306,3,309,489
2019,77014,AVON,200072346,CA DU PAYS DE FONTAINEBLEAU,77,SEINE ET MARNE,78,6,84,3,174,2,176,262
2019,77053,BRIE COMTE ROBERT,247700644,CC L'OREE DE LA BRIE,77,SEINE ET MARNE,163,5,168,8,306,6,312,488
2019,77058,BUSSY SAINT GEORGES,247700594,CA MARNE ET GONDOIRE,77,SEINE ET MARNE,370,14,384,15,246,9,255,654
2019,77131,COULOMMIERS,200090504,CA COULOMMIERS PAYS DE BRIE,77,SEINE ET MARNE,147,7,154,24,154,3,157,335
2019,77152,DAMMARIE LES LYS,247700057,CA MELUN VAL DE SEINE,77,SEINE ET MARNE,220,0,220,0,244,4,248,468
2019,77153,DAMMARTIN EN GOELE,200055655,CA ROISSY PAYS DE FRANCE,77,SEINE ET MARNE,40,2,42,0,166,1,167,208
2019,77186,FONTAINEBLEAU,200072346,CA DU PAYS DE FONTAINEBLEAU,77,SEINE ET MARNE,131,15,146,10,120,20,140,296
2019,77258,LOGNES,200057958,CA PARIS - VALLEE DE LA MARNE,77,SEINE ET MARNE,207,3,210,0,143,11,154,364
2019,77296,MOISSY CRAMAYEL,200059228,CA GRAND PARIS SUD SEINE ESSONNE SENART,77,SEINE ET MARNE,105,9,114,19,305,2,307,440
2019,77305,MONTEREAU FAULT YONNE,247700107,CC PAYS DE MONTEREAU,77,SEINE ET MARNE,128,6,134,16,149,4,153,303
2019,77307,MONTEVRAIN,247700594,CA MARNE ET GONDOIRE,77,SEINE ET MARNE,136,21,157,0,202,4,206,363
2019,77316,MORET LOING ET ORVANNE,247700032,CC MORET SEINE ET LOING,77,SEINE ET MARNE,185,3,188,1,153,4,157,346
2019,77350,OZOIR LA FERRIERE,200023125,CC LES PORTES BRIARDES ENTRE VILLES ET FORETS,77,SEINE ET MARNE,200,6,206,6,243,1,244,457
2019,77373,PONTAULT COMBAULT,200057958,CA PARIS - VALLEE DE LA MARNE,77,SEINE ET MARNE,195,5,200,41,612,10,622,863
2019,77407,SAINT FARGEAU PONTHIERRY,247700057,CA MELUN VAL DE SEINE,77,SEINE ET MARNE,124,3,127,1,222,13,235,363
2019,77479,VAIRES SUR MARNE,200057958,CA PARIS - VALLEE DE LA MARNE,77,SEINE ET MARNE,131,2,133,0,138,6,144,277
2019,78005,ACHERES,200059889,CU GRAND PARIS SEINE ET OISE,78,YVELINES,187,31,218,13,257,12,269,500
2019,78029,AUBERGENVILLE,200059889,CU GRAND PARIS SEINE ET OISE,78,YVELINES,97,19,116,0,116,3,119,234
2019,78073,BOIS D ARCY,247800584,CA VERSAILLES GRAND PARC (CAVGP),78,YVELINES,222,8,230,0,152,10,162,393
2019,78123,CARRIERES SOUS POISSY,200059889,CU GRAND PARIS SEINE ET OISE,78,YVELINES,161,17,178,18,229,6,235,431
2019,78126,LA CELLE SAINT CLOUD,247800584,CA VERSAILLES GRAND PARC (CAVGP),78,YVELINES,237,13,250,0,151,32,183,433
2019,78172,CONFLANS SAINTE HONORINE,200059889,CU GRAND PARIS SEINE ET OISE,78,YVELINES,331,26,357,5,455,24,479,841
2019,78361,MANTES LA JOLIE,200059889,CU GRAND PARIS SEINE ET OISE,78,YVELINES,340,47,387,46,161,21,182,616
2019,78383,MAUREPAS,200058782,CA DE SAINT QUENTIN EN YVELINES,78,YVELINES,220,4,224,12,206,6,212,448
2019,78423,MONTIGNY LE BRETONNEUX,200058782,CA DE SAINT QUENTIN EN YVELINES,78,YVELINES,526,6,532,3,386,18,404,939
2019,78490,PLAISIR,200058782,CA DE SAINT QUENTIN EN YVELINES,78,YVELINES,243,91,334,43,366,13,379,756
2019,78498,POISSY,200059889,CU GRAND PARIS SEINE ET OISE,78,YVELINES,578,59,637,1,376,23,399,1037
2019,78551,SAINT GERMAIN EN LAYE,200058519,CA SAINT GERMAIN BOUCLES DE SEINE,78,YVELINES,499,103,602,13,228,103,331,946
2019,78586,SARTROUVILLE,200058519,CA SAINT GERMAIN BOUCLES DE SEINE,78,YVELINES,352,216,568,60,612,87,699,1326
2019,78643,VERNOUILLET,200059889,CU GRAND PARIS SEINE ET OISE,78,YVELINES,82,10,92,17,109,6,115,224
2019,78650,LE VESINET,200058519,CA SAINT GERMAIN BOUCLES DE SEINE,78,YVELINES,233,3,236,15,48,65,113,364
2019,78688,VOISINS LE BRETONNEUX,200058782,CA DE SAINT QUENTIN EN YVELINES,78,YVELINES,95,2,97,0,101,5,106,203
2019,79049,BRESSUIRE,200040244,CA DU BOCAGE BRESSUIRAIS,79,DEUX SEVRES,70,0,70,17,303,2,305,392
2019,79191,NIORT,200041317,CA DU NIORTAIS,79,DEUX SEVRES,415,0,415,77,650,33,683,1175
2019,79202,PARTHENAY,200041333,CC DE PARTHENAY-GATINE,79,DEUX SEVRES,72,0,72,8,87,2,89,169
2019,81004,ALBI,248100737,CA DE L'ALBIGEOIS (C2A),81,TARN,399,70,469,38,265,22,287,793
2019,82033,CASTELSARRASIN,200066322,CC TERRES DES CONFLUENCES,82,TARN ET GARONNE,90,0,90,3,122,1,123,216
2019,83042,COGOLIN,200036077,CC DU GOLFE DE SAINT-TROPEZ,83,VAR,108,2,110,0,94,3,97,207
2019,83047,LA CRAU,248300543,METROPOLE TOULON-PROVENCE-MEDITERRANEE,83,VAR,97,16,113,0,240,9,249,362
2019,83061,FREJUS,200035319,CA VAR ESTEREL MEDITERRANEE (CAVEM),83,VAR,378,22,400,30,328,31,359,789
2019,83098,LE PRADET,248300543,METROPOLE TOULON-PROVENCE-MEDITERRANEE,83,VAR,76,7,83,3,84,4,88,173
2019,83115,SAINTE MAXIME,200036077,CC DU GOLFE DE SAINT-TROPEZ,83,VAR,160,0,160,5,51,6,57,222
2019,83123,SANARY SUR MER,248300394,CA SUD SAINTE BAUME,83,VAR,111,23,134,1,74,7,81,215
2019,83129,SIX FOURS LES PLAGES,248300543,METROPOLE TOULON-PROVENCE-MEDITERRANEE,83,VAR,243,63,306,3,230,6,236,545
2019,83130,SOLLIES PONT,248300410,CC DE LA VALLEE DU GAPEAU,83,VAR,75,12,87,7,118,3,121,215
2019,83144,LA VALETTE DU VAR,248300543,METROPOLE TOULON-PROVENCE-MEDITERRANEE,83,VAR,80,12,92,0,218,13,231,323
2019,84031,CARPENTRAS,248400053,CA VENTOUX-COMTAT-VENAISSIN (COVE),84,VAUCLUSE,238,4,242,13,175,9,184,439
2019,84087,ORANGE,248400236,CC DU PAYS REUNI D'ORANGE,84,VAUCLUSE,172,5,177,0,258,6,264,441
2019,84089,PERTUIS,200054807,METROPOLE D'AIX-MARSEILLE-PROVENCE,84,VAUCLUSE,150,2,152,5,243,9,252,410
2019,84141,VEDENE,248400251,CA DU GRAND AVIGNON (COGA),84,VAUCLUSE,65,20,85,0,152,2,154,239
2019,85047,CHALLANS,200071629,CC CHALLANS-GOIS COMMUNAUTE,85,VENDEE,50,22,72,39,353,1,354,465
2019,85109,LES HERBIERS,248500621,CC DU PAYS DES HERBIERS,85,VENDEE,45,38,83,35,296,8,304,422
2019,85194,LES SABLES D OLONNE,200071165,CA LES SABLES D'OLONNE AGGLOMERATION,85,VENDEE,100,32,132,68,374,25,399,599
2019,85226,SAINT HILAIRE DE RIEZ,200023778,CC DU PAYS DE SAINT GILLES-CROIX-DE-VIE,85,VENDEE,35,2,37,23,160,1,161,220
2019,86194,POITIERS,200069854,CU DU GRAND POITIERS,86,VIENNE,706,0,706,81,624,47,671,1458
2019,89387,SENS,248900334,CA DU GRAND SENONAIS,89,YONNE,252,0,252,0,230,13,243,495
2019,91021,ARPAJON,200057859,CA COEUR D'ESSONNE AGGLOMERATION,91,ESSONNE,91,6,97,0,114,7,121,218
2019,91216,EPINAY SUR ORGE,200056232,CA COMMUNAUTE PARIS-SACLAY,91,ESSONNE,155,1,156,0,100,6,106,262
2019,91235,FLEURY MEROGIS,200057859,CA COEUR D'ESSONNE AGGLOMERATION,91,ESSONNE,154,5,159,21,110,4,114,294
2019,91326,JUVISY SUR ORGE,200054781,METROPOLE DU GRAND PARIS,91,ESSONNE,180,18,198,0,148,18,166,363
2019,91377,MASSY,200056232,CA COMMUNAUTE PARIS-SACLAY,91,ESSONNE,890,35,925,19,676,34,710,1655
2019,91386,MENNECY,249100546,CC DU VAL D'ESSONNE (CCVE),91,ESSONNE,100,0,100,0,173,6,179,279
2019,91434,MORSANG SUR ORGE,200057859,CA COEUR D'ESSONNE AGGLOMERATION,91,ESSONNE,180,12,192,0,261,7,268,460
2019,91552,SAINT GERMAIN LES ARPAJON,200057859,CA COEUR D'ESSONNE AGGLOMERATION,91,ESSONNE,14,6,20,0,173,4,177,197
2019,91645,VERRIERES LE BUISSON,200056232,CA COMMUNAUTE PARIS-SACLAY,91,ESSONNE,147,4,151,1,102,11,113,265
2019,91691,YERRES,200058477,CA VAL D'YERRES VAL DE SEINE,91,ESSONNE,415,10,425,19,312,11,323,767
2019,92002,ANTONY,200054781,METROPOLE DU GRAND PARIS,92,HAUTS DE SEINE,904,47,951,15,467,155,622,1588
2019,92004,ASNIERES SUR SEINE,200054781,METROPOLE DU GRAND PARIS,92,HAUTS DE SEINE,1265,142,1407,21,484,787,1271,2700
2019,92009,BOIS COLOMBES,200054781,METROPOLE DU GRAND PARIS,92,HAUTS DE SEINE,395,112,507,0,179,159,338,845
2019,92012,BOULOGNE BILLANCOURT,200054781,METROPOLE DU GRAND PARIS,92,HAUTS DE SEINE,2322,200,2522,53,538,984,1522,4097
2019,92024,CLICHY,200054781,METROPOLE DU GRAND PARIS,92,HAUTS DE SEINE,891,70,961,27,485,211,696,1683
2019,92025,COLOMBES,200054781,METROPOLE DU GRAND PARIS,92,HAUTS DE SEINE,1235,88,1323,48,618,276,894,2265
2019,92040,ISSY LES MOULINEAUX,200054781,METROPOLE DU GRAND PARIS,92,HAUTS DE SEINE,1455,47,1502,25,616,350,966,2493
2019,92071,SCEAUX,200054781,METROPOLE DU GRAND PARIS,92,HAUTS DE SEINE,265,2,267,0,65,59,124,391
2019,92075,VANVES,200054781,METROPOLE DU GRAND PARIS,92,HAUTS DE SEINE,316,6,322,5,156,76,232,559
2019,92077,VILLE D AVRAY,200054781,METROPOLE DU GRAND PARIS,92,HAUTS DE SEINE,171,0,171,0,76,33,109,280
2019,93001,AUBERVILLIERS,200054781,METROPOLE DU GRAND PARIS,93,SEINE SAINT DENIS,701,13,714,43,224,41,265,1022
2019,93027,LA COURNEUVE,200054781,METROPOLE DU GRAND PARIS,93,SEINE SAINT DENIS,336,1,337,57,122,8,130,525
2019,93029,DRANCY,200054781,METROPOLE DU GRAND PARIS,93,SEINE SAINT DENIS,493,3,496,0,313,24,337,833
2019,93030,DUGNY,200054781,METROPOLE DU GRAND PARIS,93,SEINE SAINT DENIS,80,0,80,0,71,4,75,156
2019,93057,LES PAVILLONS SOUS BOIS,200054781,METROPOLE DU GRAND PARIS,93,SEINE SAINT DENIS,222,16,238,24,135,18,153,414
2019,93061,LE PRE SAINT GERVAIS,200054781,METROPOLE DU GRAND PARIS,93,SEINE SAINT DENIS,193,3,196,9,140,23,163,368
2019,93064,ROSNY SOUS BOIS,200054781,METROPOLE DU GRAND PARIS,93,SEINE SAINT DENIS,525,10,535,5,355,49,404,944
2019,93066,SAINT DENIS,200054781,METROPOLE DU GRAND PARIS,93,SEINE SAINT DENIS,1070,31,1101,174,582,65,647,1922
2019,93071,SEVRAN,200054781,METROPOLE DU GRAND PARIS,93,SEINE SAINT DENIS,327,4,331,92,209,11,220,643
2019,93077,VILLEMOMBLE,200054781,METROPOLE DU GRAND PARIS,93,SEINE SAINT DENIS,346,19,365,0,223,30,253,618
2019,94002,ALFORTVILLE,200054781,METROPOLE DU GRAND PARIS,94,VAL DE MARNE,409,60,469,40,379,59,438,947
2019,94003,ARCUEIL,200054781,METROPOLE DU GRAND PARIS,94,VAL DE MARNE,260,21,281,16,132,31,163,460
2019,94004,BOISSY SAINT LEGER,200054781,METROPOLE DU GRAND PARIS,94,VAL DE MARNE,140,18,158,0,141,2,143,301
2019,94011,BONNEUIL SUR MARNE,200054781,METROPOLE DU GRAND PARIS,94,VAL DE MARNE,190,2,192,84,99,5,104,380
2019,94017,CHAMPIGNY SUR MARNE,200054781,METROPOLE DU GRAND PARIS,94,VAL DE MARNE,554,35,589,109,597,42,639,1338
2019,94034,FRESNES,200054781,METROPOLE DU GRAND PARIS,94,VAL DE MARNE,280,36,316,0,232,14,246,562
2019,94037,GENTILLY,200054781,METROPOLE DU GRAND PARIS,94,VAL DE MARNE,261,7,268,67,92,17,109,443
2019,94043,LE KREMLIN BICETRE,200054781,METROPOLE DU GRAND PARIS,94,VAL DE MARNE,493,7,500,16,197,27,224,741
2019,94054,ORLY,200054781,METROPOLE DU GRAND PARIS,94,VAL DE MARNE,241,7,248,76,147,11,158,482
2019,94055,ORMESSON SUR MARNE,200054781,METROPOLE DU GRAND PARIS,94,VAL DE MARNE,105,4,109,0,81,1,82,191
2019,94058,LE PERREUX SUR MARNE,200054781,METROPOLE DU GRAND PARIS,94,VAL DE MARNE,411,39,450,2,247,88,335,787
2019,94059,LE PLESSIS TREVISE,200054781,METROPOLE DU GRAND PARIS,94,VAL DE MARNE,205,8,213,0,168,15,183,396
2019,94071,SUCY EN BRIE,200054781,METROPOLE DU GRAND PARIS,94,VAL DE MARNE,160,13,173,0,190,15,205,378
2019,94074,VALENTON,200054781,METROPOLE DU GRAND PARIS,94,VAL DE MARNE,122,3,125,60,64,13,77,262
2019,94075,VILLECRESNES,200054781,METROPOLE DU GRAND PARIS,94,VAL DE MARNE,36,18,54,2,115,15,130,187
2019,95176,CORMEILLES EN PARISIS,200058485,CA VAL PARISIS,95,VAL D OISE,180,35,215,0,275,37,312,528
2019,95199,DOMONT,200056380,CA PLAINE VALLEE,95,VAL D OISE,120,23,143,0,189,12,201,343
2019,95218,ERAGNY,249500109,CA DE CERGY-PONTOISE,95,VAL D OISE,106,25,131,0,263,9,272,403
2019,95219,ERMONT,200058485,CA VAL PARISIS,95,VAL D OISE,227,15,242,0,364,26,390,632
2019,95252,FRANCONVILLE,200058485,CA VAL PARISIS,95,VAL D OISE,310,15,325,0,501,18,519,844
2019,95268,GARGES LES GONESSE,200055655,CA ROISSY PAYS DE FRANCE,95,VAL D OISE,273,1,274,155,191,3,194,623
2019,95487,PERSAN,249500489,CC DU HAUT VAL D'OISE,95,VAL D OISE,57,4,61,21,146,6,152,235
2019,95555,SAINT GRATIEN,200056380,CA PLAINE VALLEE,95,VAL D OISE,178,2,180,0,216,19,235,415
2019,95563,SAINT LEU LA FORET,200058485,CA VAL PARISIS,95,VAL D OISE,97,14,111,0,190,11,201,312
2019,95585,SARCELLES,200055655,CA ROISSY PAYS DE FRANCE,95,VAL D OISE,391,34,425,266,244,20,264,955
2019,95598,SOISY SOUS MONTMORENCY,200056380,CA PLAINE VALLEE,95,VAL D OISE,92,15,107,7,209,16,225,338
2019,95680,VILLIERS LE BEL,200055655,CA ROISSY PAYS DE FRANCE,95,VAL D OISE,160,0,160,2,177,4,181,343
2019,97116,MORNE A L EAU,200044691,CA DU NORD GRANDE TERRE,971,GUADELOUPE,40,3,43,41,68,1,69,153
2019,97118,PETIT BOURG,249710062,CA DU NORD BASSE-TERRE,971,GUADELOUPE,0,47,47,48,160,29,189,284
2019,97120,POINTE A PITRE,200018653,CA CAP EXCELLENCE,971,GUADELOUPE,150,2,152,48,40,2,42,243
2019,97220,RIVIERE PILOTE,249720053,CA DE L'ESPACE SUD DE LA MARTINIQUE,972,MARTINIQUE,35,10,45,49,23,3,26,119
2019,97228,SAINTE MARIE,200041788,CA DU PAYS NORD MARTINIQUE,972,MARTINIQUE,40,30,70,25,32,1,33,127
2019,97230,LA TRINITE,200041788,CA DU PAYS NORD MARTINIQUE,972,MARTINIQUE,100,13,113,24,42,5,47,183
2019,97305,MACOURIA,249730045,CA DU CENTRE LITTORAL,973,GUYANE,80,1,81,1,28,6,34,116
2019,97307,MATOURY,249730045,CA DU CENTRE LITTORAL,973,GUYANE,356,1,357,2,50,7,57,417
2019,97311,SAINT LAURENT DU MARONI,249730037,CC DE L'OUEST GUYANAIS,973,GUYANE,170,0,170,1,70,7,77,248
2019,97405,PETITE ILE,249740077,CA CIVIS (COMMUNAUTE INTERCOMMUNALE DES VILLES SOLIDAIRES),974,LA REUNION,55,29,84,18,44,8,52,154
2019,97407,LE PORT,249740101,CA TERRITOIRE DE LA COTE OUEST (TCO),974,LA REUNION,230,36,266,87,70,6,76,429
2019,97409,SAINT ANDRE,249740093,CA INTERCOMMUNALE DE LA REUNION EST (CIREST),974,LA REUNION,458,143,601,83,165,27,192,876
2019,97415,SAINT PAUL,249740101,CA TERRITOIRE DE LA COTE OUEST (TCO),974,LA REUNION,430,564,994,321,406,90,496,1811
2020,01321,REVONNAS,200071751,CA DU BASSIN DE BOURG-EN-BRESSE,01,AIN,0,3,3,0,10,0,10,13
2020,01322,REYRIEUX,200042497,CC DOMBES SAONE VALLEE,01,AIN,35,1,36,2,104,3,107,145
2020,01323,REYSSOUZE,200071371,CC BRESSE ET SAONE,01,AIN,0,0,0,0,11,1,12,12
2020,02173,CHAUNY,200071785,CA CHAUNY TERGNIER LA FERE,02,AISNE,68,16,84,18,150,1,151,253
2020,02722,SOISSONS,240200477,CA GRANDSOISSONS AGGLOMERATION,02,AISNE,141,38,179,57,222,2,224,460
2020,06004,ANTIBES,240600585,CA DE SOPHIA ANTIPOLIS,06,ALPES MARITIMES,480,54,534,8,715,38,753,1295
2020,06033,CARROS,200030195,METROPOLE NICE COTE D'AZUR,06,ALPES MARITIMES,79,16,95,8,138,5,143,246
2020,06083,MENTON,240600551,CA DE LA RIVIERA FRANCAISE,06,ALPES MARITIMES,197,0,197,3,216,11,227,427
2020,06104,ROQUEBRUNE CAP MARTIN,240600551,CA DE LA RIVIERA FRANCAISE,06,ALPES MARITIMES,134,0,134,8,57,3,60,202
2020,06123,SAINT LAURENT DU VAR,200030195,METROPOLE NICE COTE D'AZUR,06,ALPES MARITIMES,249,41,290,0,333,9,342,632
2020,06161,VILLENEUVE LOUBET,240600585,CA DE SOPHIA ANTIPOLIS,06,ALPES MARITIMES,153,6,159,0,119,9,128,288
2020,07102,GUILHERAND GRANGES,200041366,CC RHONE CRUSSOL,07,ARDECHE,73,12,85,3,130,10,140,228
2020,08105,CHARLEVILLE MEZIERES,200041630,CA ARDENNE METROPOLE,08,ARDENNES,358,40,398,97,251,16,267,762
2020,10333,SAINT ANDRE LES VERGERS,200069250,CA TROYES CHAMPAGNE METROPOLE,10,AUBE,112,0,112,0,137,10,147,259
2020,11069,CARCASSONNE,200035715,CA CARCASSONNE AGGLO,11,AUDE,216,1,217,74,278,29,307,598
2020,11206,LIMOUX,200071926,CC DU LIMOUXIN,11,AUDE,55,2,57,38,48,1,49,144
2020,11262,NARBONNE,241100593,CA LE GRAND NARBONNE,11,AUDE,273,12,285,70,307,18,325,680
2020,12145,MILLAU,241200567,CC DE MILLAU GRANDS CAUSSES,12,AVEYRON,121,0,121,49,179,2,181,351
2020,12202,RODEZ,241200187,CA RODEZ AGGLOMERATION,12,AVEYRON,204,24,228,43,138,12,150,421
2020,12300,VILLEFRANCHE DE ROUERGUE,200069383,CC OUEST AVEYRON COMMUNAUTE,12,AVEYRON,44,0,44,26,103,2,105,175
2020,13001,AIX EN PROVENCE,200054807,METROPOLE D'AIX-MARSEILLE-PROVENCE,13,BOUCHES DU RHONE,1387,253,1640,51,874,148,1022,2713
2020,13015,BOUC BEL AIR,200054807,METROPOLE D'AIX-MARSEILLE-PROVENCE,13,BOUCHES DU RHONE,129,17,146,0,161,6,167,313
2020,13026,CHATEAUNEUF LES MARTIGUES,200054807,METROPOLE D'AIX-MARSEILLE-PROVENCE,13,BOUCHES DU RHONE,127,29,156,4,166,7,173,333
2020,13047,ISTRES,200054807,METROPOLE D'AIX-MARSEILLE-PROVENCE,13,BOUCHES DU RHONE,504,20,524,0,283,16,299,822
2020,13056,MARTIGUES,200054807,METROPOLE D'AIX-MARSEILLE-PROVENCE,13,BOUCHES DU RHONE,569,6,575,15,192,16,208,798
2020,13077,PORT DE BOUC,200054807,METROPOLE D'AIX-MARSEILLE-PROVENCE,13,BOUCHES DU RHONE,140,0,140,64,83,2,85,289
2020,13097,SAINT MARTIN DE CRAU,241300417,CA D'ARLES-CRAU-CAMARGUE-MONTAGNETTE,13,BOUCHES DU RHONE,112,3,115,6,136,2,138,259
2020,13108,TARASCON,241300417,CA D'ARLES-CRAU-CAMARGUE-MONTAGNETTE,13,BOUCHES DU RHONE,85,2,87,9,52,0,52,148
2020,13110,TRETS,200054807,METROPOLE D'AIX-MARSEILLE-PROVENCE,13,BOUCHES DU RHONE,98,16,114,0,86,2,88,201
2020,13117,VITROLLES,200054807,METROPOLE D'AIX-MARSEILLE-PROVENCE,13,BOUCHES DU RHONE,364,18,382,48,246,12,258,689
2020,13201,MARSEILLE 1ER ARRONDISSEMENT,200054807,METROPOLE D'AIX-MARSEILLE-PROVENCE,13,BOUCHES DU RHONE,299,27,326,9,122,43,165,500
2020,13204,MARSEILLE 4E ARRONDISSEMENT,200054807,METROPOLE D'AIX-MARSEILLE-PROVENCE,13,BOUCHES DU RHONE,409,73,482,26,325,24,349,857
2020,13205,MARSEILLE 5E ARRONDISSEMENT,200054807,METROPOLE D'AIX-MARSEILLE-PROVENCE,13,BOUCHES DU RHONE,583,100,683,0,305,42,347,1030
2020,13206,MARSEILLE 6E ARRONDISSEMENT,200054807,METROPOLE D'AIX-MARSEILLE-PROVENCE,13,BOUCHES DU RHONE,602,168,770,6,226,99,325,1100
2020,13213,MARSEILLE 13E ARRONDISSEMENT,200054807,METROPOLE D'AIX-MARSEILLE-PROVENCE,13,BOUCHES DU RHONE,799,77,876,210,386,52,438,1523
2020,13215,MARSEILLE 15E ARRONDISSEMENT,200054807,METROPOLE D'AIX-MARSEILLE-PROVENCE,13,BOUCHES DU RHONE,714,20,734,269,183,20,203,1206
2020,14118,CAEN,200065597,CU CAEN LA MER,14,CALVADOS,1096,63,1159,216,664,70,734,2108
2020,14327,HEROUVILLE SAINT CLAIR,200065597,CU CAEN LA MER,14,CALVADOS,255,9,264,52,230,10,240,557
2020,14366,LISIEUX,200069532,CA LISIEUX NORMANDIE,14,CALVADOS,92,1,93,38,298,2,300,431
2020,16102,COGNAC,200070514,CA DU GRAND COGNAC,16,CHARENTE,137,0,137,38,130,28,158,333
2020,17300,LA ROCHELLE,241700434,CA DE LA ROCHELLE,17,CHARENTE MARITIME,544,43,587,97,576,76,652,1336
2020,18279,VIERZON,200090561,CC VIERZON-SOLOGNE-BERRY,18,CHER,75,0,75,35,276,2,278,388
2020,19031,BRIVE LA GAILLARDE,200043172,CA DU BASSIN DE BRIVE,19,CORREZE,362,1,363,111,286,40,326,800
2020,21171,CHEVIGNY SAINT SAUVEUR,242100410,DIJON METROPOLE,21,COTE D OR,36,8,44,0,161,4,165,209
2020,22050,DINAN,200068989,CA DINAN AGGLOMERATION,22,COTES D ARMOR,65,6,71,23,77,1,78,172
2020,22215,PLOUFRAGAN,200069409,CA SAINT-BRIEUC ARMOR AGGLOMERATION,22,COTES D ARMOR,70,0,70,30,174,4,178,278
2020,22278,SAINT BRIEUC,200069409,CA SAINT-BRIEUC ARMOR AGGLOMERATION,22,COTES D ARMOR,268,7,275,115,437,13,450,840
2020,25580,VALENTIGNEY,200065647,CA PAYS DE MONTBELIARD AGGLOMERATION,25,DOUBS,37,0,37,21,72,1,73,131
2020,26058,BOURG LES VALENCE,200068781,CA VALENCE ROMANS AGGLO,26,DROME,71,12,83,9,205,6,211,303
2020,26198,MONTELIMAR,200040459,CA MONTELIMAR AGGLOMERATION,26,DROME,169,58,227,37,366,8,374,638
2020,27681,VERNON,200072312,CA SEINE NORMANDIE AGGLOMERATION,27,EURE,155,55,210,4,264,6,270,484
2020,27701,VAL DE REUIL,200089456,CA SEINE-EURE,27,EURE,115,0,115,37,101,2,103,255
2020,28134,DREUX,200040277,CA AGGLO DU PAYS DE DREUX,28,EURE ET LOIR,270,12,282,31,192,17,209,521
2020,28218,LUCE,200033181,CA CHARTRES METROPOLE,28,EURE ET LOIR,100,6,106,0,201,1,202,307
2020,29019,BREST,242900314,BREST METROPOLE,29,FINISTERE,1037,37,1074,368,1371,125,1496,2938
2020,29039,CONCARNEAU,242900769,CA CONCARNEAU CORNOUAILLE AGGLOMERATION,29,FINISTERE,72,0,72,36,176,9,185,293
2020,29046,DOUARNENEZ,242900645,CC DOUARNENEZ COMMUNAUTE,29,FINISTERE,48,1,49,35,127,2,129,213
2020,29103,LANDERNEAU,242900801,CA DU PAYS DE LANDERNEAU-DAOULAS,29,FINISTERE,60,0,60,70,260,4,264,394
2020,29212,PLOUZANE,242900314,BREST METROPOLE,29,FINISTERE,48,0,48,30,292,5,297,375
2020,29232,QUIMPER,200068120,CA QUIMPER BRETAGNE OCCIDENTALE,29,FINISTERE,285,12,297,164,761,22,783,1244
2020,29235,LE RELECQ KERHUON,242900314,BREST METROPOLE,29,FINISTERE,42,2,44,15,162,13,175,234
2020,2A004,AJACCIO,242010056,CA DU PAYS AJACCIEN,2A,CORSE DU SUD,483,9,492,14,183,24,207,713
2020,2B033,BASTIA,242000354,CA DE BASTIA,2B,HAUTE CORSE,299,17,316,25,129,6,135,476
2020,30028,BAGNOLS SUR CEZE,200034692,CA DU GARD RHODANIEN,30,GARD,120,0,120,29,75,0,75,224
2020,30258,SAINT GILLES,243000643,CA DE NIMES METROPOLE,30,GARD,41,1,42,33,118,2,120,195
2020,30351,VILLENEUVE LES AVIGNON,248400251,CA DU GRAND AVIGNON (COGA),30,GARD,89,13,102,8,68,5,73,182
2020,31069,BLAGNAC,243100518,TOULOUSE METROPOLE,31,HAUTE GARONNE,542,1,543,0,203,23,226,768
2020,31187,FONSORBES,200068641,CA LE MURETAIN AGGLO,31,HAUTE GARONNE,76,13,89,0,195,6,201,289
2020,31424,PLAISANCE DU TOUCH,243100781,CC LE GRAND OUEST TOULOUSAIN,31,HAUTE GARONNE,102,9,111,5,253,12,265,381
2020,31446,RAMONVILLE SAINT AGNE,243100633,CA DU SICOVAL,31,HAUTE GARONNE,192,2,194,0,126,8,134,329
2020,31483,SAINT GAUDENS,200072643,CC COEUR ET COTEAUX DU COMMINGES,31,HAUTE GARONNE,106,0,106,5,72,1,73,184
2020,31488,SAINT JEAN,243100518,TOULOUSE METROPOLE,31,HAUTE GARONNE,78,8,86,0,155,7,162,248
2020,31506,SAINT ORENS DE GAMEVILLE,243100518,TOULOUSE METROPOLE,31,HAUTE GARONNE,104,17,121,0,134,10,144,265
2020,31557,TOURNEFEUILLE,243100518,TOULOUSE METROPOLE,31,HAUTE GARONNE,251,11,262,0,256,41,297,559
2020,31561,L'UNION,243100518,TOULOUSE METROPOLE,31,HAUTE GARONNE,109,6,115,0,117,10,127,242
2020,32013,AUCH,200066926,CA GRAND AUCH COEUR DE GASCOGNE,32,GERS,189,0,189,44,193,0,193,426
2020,33005,ANDERNOS LES BAINS,243301504,CA DU BASSIN D'ARCACHON NORD,33,GIRONDE,42,1,43,1,125,1,126,169
2020,33009,ARCACHON,243300563,CA BASSIN D'ARCACHON SUD (COBAS),33,GIRONDE,66,2,68,6,13,2,15,89
2020,33056,BLANQUEFORT,243300316,BORDEAUX METROPOLE,33,GIRONDE,122,11,133,0,216,1,217,350
2020,33119,CENON,243300316,BORDEAUX METROPOLE,33,GIRONDE,58,24,82,59,315,12,327,469
2020,33122,CESTAS,243301165,CC JALLE-EAU-BOURDE,33,GIRONDE,116,7,123,0,194,8,202,325
2020,33162,EYSINES,243300316,BORDEAUX METROPOLE,33,GIRONDE,168,40,208,0,392,7,399,607
2020,33167,FLOIRAC,243300316,BORDEAUX METROPOLE,33,GIRONDE,156,5,161,50,255,8,263,473
2020,33192,GRADIGNAN,243300316,BORDEAUX METROPOLE,33,GIRONDE,244,18,262,14,207,14,221,496
2020,33238,LEOGNAN,243301264,CC DE MONTESQUIEU,33,GIRONDE,39,16,55,3,174,3,177,235
2020,33249,LORMONT,243300316,BORDEAUX METROPOLE,33,GIRONDE,166,16,182,59,236,13,249,491
2020,33449,SAINT MEDARD EN JALLES,243300316,BORDEAUX METROPOLE,33,GIRONDE,192,12,204,0,484,16,500,704
2020,33529,LA TESTE DE BUCH,243300563,CA BASSIN D'ARCACHON SUD (COBAS),33,GIRONDE,97,27,124,4,265,5,270,398
2020,34003,AGDE,243400819,CA HERAULT-MEDITERRANEE,34,HERAULT,181,15,196,46,90,2,92,334
2020,34123,JUVIGNAC,243400017,MONTPELLIER MEDITERRANEE METROPOLE,34,HERAULT,100,17,117,0,135,10,145,262
2020,34145,LUNEL,243400520,CC DU PAYS DE LUNEL,34,HERAULT,90,2,92,22,252,4,256,370
2020,34154,MAUGUIO,243400470,CA DU PAYS DE L'OR,34,HERAULT,150,6,156,4,175,7,182,343
2020,34157,MEZE,200066355,CA SETE AGGLOPOLE MEDITERRANEE,34,HERAULT,93,3,96,0,72,1,73,169
2020,34301,SETE,200066355,CA SETE AGGLOPOLE MEDITERRANEE,34,HERAULT,214,45,259,40,145,10,155,454
2020,35051,CESSON SEVIGNE,243500139,RENNES METROPOLE,35,ILLE ET VILAINE,222,27,249,24,210,20,230,503
2020,35093,DINARD,243500725,CC COTE D'EMERAUDE,35,ILLE ET VILAINE,38,2,40,20,57,0,57,117
2020,35238,RENNES,243500139,RENNES METROPOLE,35,ILLE ET VILAINE,1725,227,1952,670,1921,219,2140,4763
2020,35281,SAINT JACQUES DE LA LANDE,243500139,RENNES METROPOLE,35,ILLE ET VILAINE,126,9,135,13,196,6,202,350
2020,35288,SAINT MALO,243500782,CA DU PAYS DE SAINT MALO AGGLOMERATION,35,ILLE ET VILAINE,290,15,305,131,348,32,380,816
2020,36044,CHATEAUROUX,243600327,CA CHATEAUROUX METROPOLE,36,INDRE,273,10,283,77,475,13,488,848
2020,37122,JOUE LES TOURS,243700754,TOURS METROPOLE VAL DE LOIRE,37,INDRE ET LOIRE,229,24,253,33,532,16,548,834
2020,37156,MONTLOUIS SUR LOIRE,200073161,CC TOURAINE-EST VALLEES,37,INDRE ET LOIRE,40,2,42,0,210,7,217,259
2020,37195,LA RICHE,243700754,TOURS METROPOLE VAL DE LOIRE,37,INDRE ET LOIRE,70,17,87,0,150,2,152,239
2020,37208,SAINT AVERTIN,243700754,TOURS METROPOLE VAL DE LOIRE,37,INDRE ET LOIRE,124,2,126,1,159,9,168,295
2020,38193,L'ISLE D ABEAU,243800604,CA PORTE DE L'ISERE (CAPI),38,ISERE,123,37,160,0,234,7,241,401
2020,38317,LE PONT DE CLAIX,200040715,GRENOBLE-ALPES-METROPOLE,38,ISERE,122,4,126,40,120,1,121,287
2020,38421,SAINT MARTIN D HERES,200040715,GRENOBLE-ALPES-METROPOLE,38,ISERE,262,31,293,32,420,10,430,755
2020,38474,SASSENAGE,200040715,GRENOBLE-ALPES-METROPOLE,38,ISERE,88,6,94,0,164,3,167,261
2020,38485,SEYSSINET PARISET,200040715,GRENOBLE-ALPES-METROPOLE,38,ISERE,104,13,117,0,149,4,153,270
2020,38544,VIENNE,200077014,CA VIENNE CONDRIEU,38,ISERE,180,24,204,30,447,10,457,692
2020,38553,VILLEFONTAINE,243800604,CA PORTE DE L'ISERE (CAPI),38,ISERE,168,28,196,24,266,3,269,490
2020,40279,SAINT PAUL LES DAX,244000675,CA DU GRAND DAX,40,LANDES,60,5,65,0,141,1,142,207
2020,42184,RIORGES,200035731,CA ROANNAIS AGGLOMERATION,42,LOIRE,42,3,45,8,146,3,149,202
2020,44020,BOUGUENAIS,244400404,NANTES METROPOLE,44,LOIRE ATLANTIQUE,161,22,183,14,375,14,389,586
2020,44026,CARQUEFOU,244400404,NANTES METROPOLE,44,LOIRE ATLANTIQUE,183,20,203,14,336,20,356,572
2020,44035,LA CHAPELLE SUR ERDRE,244400404,NANTES METROPOLE,44,LOIRE ATLANTIQUE,170,13,183,8,332,17,349,540
2020,44047,COUERON,244400404,NANTES METROPOLE,44,LOIRE ATLANTIQUE,104,42,146,0,547,20,567,713
2020,44055,LA BAULE ESCOUBLAC,244400610,CA DE LA PRESQU'ILE DE GUERANDE ATLANTIQUE (CAP ATLANTIQUE),44,LOIRE ATLANTIQUE,60,5,65,16,92,7,99,180
2020,44069,GUERANDE,244400610,CA DE LA PRESQU'ILE DE GUERANDE ATLANTIQUE (CAP ATLANTIQUE),44,LOIRE ATLANTIQUE,70,2,72,29,239,7,246,347
2020,44143,REZE,244400404,NANTES METROPOLE,44,LOIRE ATLANTIQUE,163,57,220,7,732,49,781,1008
2020,44204,THOUARE SUR LOIRE,244400404,NANTES METROPOLE,44,LOIRE ATLANTIQUE,50,16,66,0,239,4,243,309
2020,45208,MONTARGIS,244500203,CA MONTARGOISE ET RIVES DU LOING (AME),45,LOIRET,131,9,140,21,81,1,82,243
2020,45232,OLIVET,244500468,ORLEANS METROPOLE,45,LOIRET,226,33,259,16,187,15,202,477
2020,45284,SAINT JEAN DE BRAYE,244500468,ORLEANS METROPOLE,45,LOIRET,168,27,195,0,260,12,272,468
2020,45285,SAINT JEAN DE LA RUELLE,244500468,ORLEANS METROPOLE,45,LOIRET,170,14,184,38,210,11,221,442
2020,45302,SARAN,244500468,ORLEANS METROPOLE,45,LOIRET,182,8,190,0,221,5,226,416
2020,47001,AGEN,200035459,CA D'AGEN,47,LOT ET GARONNE,229,0,229,73,304,8,312,615
2020,49018,BAUGE EN ANJOU,244900882,CC BAUGEOIS VALLEE,49,MAINE ET LOIRE,56,9,65,8,127,0,127,200
2020,49023,BEAUPREAU EN MAUGES,200060010,CA MAUGES COMMUNAUTE,49,MAINE ET LOIRE,72,24,96,61,451,9,460,616
2020,49050,BRISSAC LOIRE AUBANCE,200071553,CC LOIRE LAYON AUBANCE,49,MAINE ET LOIRE,48,2,50,3,220,2,222,275
2020,49069,OREE D ANJOU,200060010,CA MAUGES COMMUNAUTE,49,MAINE ET LOIRE,26,3,29,32,345,5,350,410
2020,49328,SAUMUR,200071876,CA SAUMUR VAL DE LOIRE,49,MAINE ET LOIRE,160,27,187,59,241,14,255,501
2020,50025,AVRANCHES,200069425,CA MONT-SAINT-MICHEL-NORMANDIE,50,MANCHE,45,0,45,33,104,1,105,183
2020,50099,CARENTAN LES MARAIS,200042729,CC DE LA BAIE DU COTENTIN,50,MANCHE,23,0,23,10,150,1,151,184
2020,52121,CHAUMONT,200068658,CA DE CHAUMONT,52,HAUTE MARNE,112,13,125,32,263,3,266,423
2020,54304,LAXOU,245400676,METROPOLE DU GRAND NANCY,54,MEURTHE ET MOSELLE,189,8,197,12,65,5,70,279
2020,54329,LUNEVILLE,200070324,CC DU TERRITOIRE DE LUNEVILLE A BACCARAT,54,MEURTHE ET MOSELLE,96,0,96,29,177,6,183,308
2020,54547,VANDOEUVRE LES NANCY,245400676,METROPOLE DU GRAND NANCY,54,MEURTHE ET MOSELLE,284,10,294,57,187,9,196,547
2020,54580,VILLERUPT,245701404,CC DU PAYS HAUT VAL D'ALZETTE,54,MEURTHE ET MOSELLE,30,0,30,0,27,0,27,57
2020,55029,BAR LE DUC,200033025,CA DE BAR-LE-DUC - SUD MEUSE,55,MEUSE,131,0,131,41,100,4,104,276
2020,56078,GUIDEL,200042174,CA LORIENT AGGLOMERATION,56,MORBIHAN,30,9,39,37,148,6,154,230
2020,56098,LANESTER,200042174,CA LORIENT AGGLOMERATION,56,MORBIHAN,104,9,113,88,298,7,305,505
2020,56162,PLOEMEUR,200042174,CA LORIENT AGGLOMERATION,56,MORBIHAN,100,10,110,44,148,9,157,311
2020,56178,PONTIVY,245614433,CC PONTIVY COMMUNAUTE,56,MORBIHAN,45,0,45,68,165,3,168,281
2020,57240,FREYMING MERLEBACH,245700398,CC DE FREYMING-MERLEBACH,57,MOSELLE,0,1,1,18,95,2,97,116
2020,57306,HAYANGE,245701222,CA DU VAL DE FENSCH,57,MOSELLE,55,6,61,0,116,2,118,180
2020,57433,MAIZIERES LES METZ,200039949,CC RIVES DE MOSELLE,57,MOSELLE,30,2,32,0,205,2,207,239
2020,57447,MARLY,200039865,METZ METROPOLE,57,MOSELLE,25,14,39,0,138,1,139,178
2020,57463,METZ,200039865,METZ METROPOLE,57,MOSELLE,1173,68,1241,58,817,50,867,2166
2020,57606,SAINT AVOLD,200067502,CA SAINT-AVOLD SYNERGIE,57,MOSELLE,44,5,49,11,132,3,135,195
2020,57630,SARREBOURG,200068146,CC SARREBOURG MOSELLE SUD,57,MOSELLE,50,2,52,14,124,0,124,190
2020,57672,THIONVILLE,245701362,CA PORTES DE FRANCE-THIONVILLE,57,MOSELLE,238,53,291,6,313,7,320,617
2020,58194,NEVERS,245804406,CA DE NEVERS,58,NIEVRE,258,9,267,52,197,8,205,524
2020,59122,CAMBRAI,200068500,CA DE CAMBRAI,59,NORD,102,6,108,96,267,13,280,484
2020,59183,DUNKERQUE,245900428,CU DE DUNKERQUE,59,NORD,451,51,502,350,683,19,702,1554
2020,59220,FACHES THUMESNIL,200093201,METROPOLE EUROPEENNE DE LILLE,59,NORD,130,33,163,3,322,3,325,491
2020,59295,HAZEBROUCK,200040947,CC DE FLANDRE INTERIEURE,59,NORD,87,2,89,57,278,4,282,428
2020,59328,LAMBERSART,200093201,METROPOLE EUROPEENNE DE LILLE,59,NORD,210,92,302,47,296,45,341,690
2020,59350,LILLE,200093201,METROPOLE EUROPEENNE DE LILLE,59,NORD,1993,429,2422,591,1744,213,1957,4969
2020,59368,LA MADELEINE,200093201,METROPOLE EUROPEENNE DE LILLE,59,NORD,181,75,256,39,209,57,266,561
2020,59421,MOUVAUX,200093201,METROPOLE EUROPEENNE DE LILLE,59,NORD,85,50,135,35,196,25,221,391
2020,59544,SAINT SAULVE,245901160,CA VALENCIENNES METROPOLE,59,NORD,150,3,153,30,93,1,94,277
2020,59574,SOMAIN,245901152,CC COEUR D'OSTREVENT (CCCO),59,NORD,40,4,44,53,126,3,129,227
2020,59606,VALENCIENNES,245901160,CA VALENCIENNES METROPOLE,59,NORD,302,12,314,167,279,18,297,778
2020,59648,WATTIGNIES,200093201,METROPOLE EUROPEENNE DE LILLE,59,NORD,74,40,114,0,144,6,150,263
2020,60175,CREIL,200068047,CA CREIL SUD OISE,60,OISE,230,4,234,65,149,5,154,452
2020,60395,MERU,246000582,CC DES SABLONS,60,OISE,80,1,81,31,153,5,158,270
2020,62041,ARRAS,200033579,CU D'ARRAS,62,PAS DE CALAIS,339,72,411,121,263,24,287,819
2020,62065,AVION,246200364,CA DE LENS - LIEVIN,62,PAS DE CALAIS,24,21,45,40,116,4,120,205
2020,62160,BOULOGNE SUR MER,246200729,CA DU BOULONNAIS,62,PAS DE CALAIS,259,8,267,144,141,10,151,562
2020,62193,CALAIS,200090751,CA GRAND CALAIS TERRES ET MERS,62,PAS DE CALAIS,341,9,350,206,413,9,422,978
2020,62250,COURRIERES,246200299,CA D'HENIN-CARVIN,62,PAS DE CALAIS,70,9,79,21,120,1,121,221
2020,63014,AUBIERE,246300701,CLERMONT AUVERGNE METROPOLE,63,PUY DE DOME,92,3,95,0,112,5,117,212
2020,63113,CLERMONT FERRAND,246300701,CLERMONT AUVERGNE METROPOLE,63,PUY DE DOME,977,58,1035,112,1149,100,1249,2396
2020,64122,BIARRITZ,200067106,CA DU PAYS BASQUE,64,PYRENEES ATLANTIQUES,184,31,215,13,92,19,111,339
2020,64348,LONS,200067254,CA PAU BEARN PYRENEES,64,PYRENEES ATLANTIQUES,74,15,89,6,191,9,200,295
2020,65286,LOURDES,200069300,CA TARBES-LOURDES-PYRENEES,65,HAUTES PYRENEES,129,0,129,29,48,1,49,207
2020,65440,TARBES,200069300,CA TARBES-LOURDES-PYRENEES,65,HAUTES PYRENEES,315,12,327,74,179,15,194,595
2020,66028,CABESTANY,200027183,CU PERPIGNAN MEDITERRANEE METROPOLE,66,PYRENEES ORIENTALES,75,9,84,5,69,1,70,159
2020,66171,SAINT CYPRIEN,246600282,CC SUD-ROUSSILLON,66,PYRENEES ORIENTALES,40,1,41,9,42,1,43,94
2020,66172,SAINT ESTEVE,200027183,CU PERPIGNAN MEDITERRANEE METROPOLE,66,PYRENEES ORIENTALES,40,13,53,10,109,2,111,175
2020,66180,SAINT LAURENT DE LA SALANQUE,200027183,CU PERPIGNAN MEDITERRANEE METROPOLE,66,PYRENEES ORIENTALES,50,4,54,0,74,0,74,127
2020,67043,BISCHHEIM,246700488,EUROMETROPOLE DE STRASBOURG,67,BAS RHIN,206,40,246,33,111,9,120,399
2020,67067,BRUMATH,200067874,CA DE HAGUENAU,67,BAS RHIN,44,43,87,0,129,1,130,216
2020,67130,ERSTEIN,200067924,CC DU CANTON D'ERSTEIN,67,BAS RHIN,65,25,90,0,131,0,131,221
2020,67180,HAGUENAU,200067874,CA DE HAGUENAU,67,BAS RHIN,338,117,455,0,216,2,218,673
2020,67348,OBERNAI,246701080,CC DU PAYS DE SAINTE-ODILE,67,BAS RHIN,126,17,143,5,70,1,71,219
2020,68066,COLMAR,246800726,CA COLMAR AGGLOMERATION,68,HAUT RHIN,693,45,738,46,357,16,373,1157
2020,68166,KINGERSHEIM,200066009,CA MULHOUSE ALSACE AGGLOMERATION,68,HAUT RHIN,75,5,80,0,115,2,117,197
2020,68224,MULHOUSE,200066009,CA MULHOUSE ALSACE AGGLOMERATION,68,HAUT RHIN,1113,17,1130,299,359,24,383,1812
2020,68297,SAINT LOUIS,200066058,CA SAINT-LOUIS AGGLOMERATION,68,HAUT RHIN,153,12,165,32,126,0,126,324
2020,68375,WITTELSHEIM,200066009,CA MULHOUSE ALSACE AGGLOMERATION,68,HAUT RHIN,40,11,51,0,128,0,128,179
2020,69019,BELLEVILLE EN BEAUJOLAIS,200067817,CC SAONE-BEAUJOLAIS,69,RHONE,40,14,54,26,191,1,192,272
2020,69027,BRIGNAIS,246900757,CC DE LA VALLEE DU GARON (CCVG),69,RHONE,88,23,111,14,170,1,171,296
2020,69069,CRAPONNE,200046977,METROPOLE DE LYON,69,RHONE,112,38,150,0,165,7,172,322
2020,69149,OULLINS,200046977,METROPOLE DE LYON,69,RHONE,204,38,242,28,344,19,363,633
2020,69204,SAINT GENIS LAVAL,200046977,METROPOLE DE LYON,69,RHONE,190,23,213,19,210,22,232,464
2020,69243,TARARE,200040566,CA DE L'OUEST RHODANIEN,69,RHONE,98,2,100,25,93,3,96,221
2020,69266,VILLEURBANNE,200046977,METROPOLE DE LYON,69,RHONE,898,281,1179,412,1837,83,1920,3510
2020,69286,RILLIEUX LA PAPE,200046977,METROPOLE DE LYON,69,RHONE,224,52,276,52,254,17,271,598
2020,69290,SAINT PRIEST,200046977,METROPOLE DE LYON,69,RHONE,510,58,568,40,547,15,562,1170
2020,69385,LYON 5E ARRONDISSEMENT,200046977,METROPOLE DE LYON,69,RHONE,451,66,517,40,323,49,372,929
2020,69386,LYON 6E ARRONDISSEMENT,200046977,METROPOLE DE LYON,69,RHONE,580,193,773,21,362,226,588,1382
2020,71014,AUTUN,200070530,CC DU GRAND AUTUNOIS MORVAN,71,SAONE ET LOIRE,91,0,91,23,99,3,102,216
2020,71270,MACON,200070308,CA MACONNAIS BEAUJOLAIS AGGLOMERATION,71,SAONE ET LOIRE,286,11,297,43,285,7,292,633
2020,72154,LA FLECHE,247200348,CC DU PAYS FLECHOIS,72,SARTHE,80,0,80,21,186,0,186,287
2020,72181,LE MANS,247200132,CU LE MANS METROPOLE,72,SARTHE,623,35,658,174,1880,97,1977,2809
2020,74133,GAILLARD,200011773,CA ANNEMASSE-LES VOIRONS-AGGLOMERATION,74,HAUTE SAVOIE,101,0,101,15,89,2,91,207
2020,74224,LA ROCHE SUR FORON,247400724,CC DU PAYS ROCHOIS,74,HAUTE SAVOIE,42,1,43,0,122,6,128,171
2020,74225,RUMILLY,247400740,CC RUMILLY TERRE DE SAVOIE,74,HAUTE SAVOIE,170,27,197,2,147,6,153,352
2020,74256,SALLANCHES,200034882,CC PAYS DU MONT-BLANC,74,HAUTE SAVOIE,108,7,115,2,145,5,150,268
2020,74281,THONON LES BAINS,200067551,CA THONON AGGLOMERATION,74,HAUTE SAVOIE,165,18,183,1,358,8,366,550
2020,75105,PARIS 5E ARRONDISSEMENT,200054781,METROPOLE DU GRAND PARIS,75,PARIS,1015,16,1031,28,10,173,183,1242
2020,75109,PARIS 9E ARRONDISSEMENT,200054781,METROPOLE DU GRAND PARIS,75,PARIS,1109,101,1210,3,74,615,689,1902
2020,75111,PARIS 11E ARRONDISSEMENT,200054781,METROPOLE DU GRAND PARIS,75,PARIS,2751,206,2957,30,182,710,892,3879
2020,75113,PARIS 13E ARRONDISSEMENT,200054781,METROPOLE DU GRAND PARIS,75,PARIS,3703,110,3813,22,322,330,652,4487
2020,75115,PARIS 15E ARRONDISSEMENT,200054781,METROPOLE DU GRAND PARIS,75,PARIS,4139,324,4463,60,400,1369,1769,6292
2020,75116,PARIS 16E ARRONDISSEMENT,200054781,METROPOLE DU GRAND PARIS,75,PARIS,1607,244,1851,81,73,1274,1347,3279
2020,75117,PARIS 17E ARRONDISSEMENT,200054781,METROPOLE DU GRAND PARIS,75,PARIS,2409,402,2811,47,387,1693,2080,4938
2020,75118,PARIS 18E ARRONDISSEMENT,200054781,METROPOLE DU GRAND PARIS,75,PARIS,3571,226,3797,107,373,986,1359,5262
2020,75119,PARIS 19E ARRONDISSEMENT,200054781,METROPOLE DU GRAND PARIS,75,PARIS,4597,19,4616,123,301,603,904,5643
2020,76108,BOIS GUILLAUME,200023414,METROPOLE ROUEN NORMANDIE,76,SEINE MARITIME,186,18,204,1,107,15,122,327
2020,76114,BOLBEC,200010700,CA CAUX SEINE AGGLO,76,SEINE MARITIME,38,0,38,29,144,2,146,213
2020,76217,DIEPPE,247600786,CA DE LA REGION DIEPPOISE,76,SEINE MARITIME,194,3,197,82,178,9,187,465
2020,76231,ELBEUF,200023414,METROPOLE ROUEN NORMANDIE,76,SEINE MARITIME,74,5,79,23,126,6,132,234
2020,76540,ROUEN,200023414,METROPOLE ROUEN NORMANDIE,76,SEINE MARITIME,1002,190,1192,28,864,87,951,2171
2020,76758,YVETOT,247600620,CC YVETOT NORMANDIE,76,SEINE MARITIME,62,0,62,0,222,4,226,288
2020,77108,CHELLES,200057958,CA PARIS - VALLEE DE LA MARNE,77,SEINE ET MARNE,359,49,408,49,620,21,641,1098
2020,77243,LAGNY SUR MARNE,247700594,CA MARNE ET GONDOIRE,77,SEINE ET MARNE,99,22,121,1,289,6,295,418
2020,77251,LIEUSAINT,200059228,CA GRAND PARIS SUD SEINE ESSONNE SENART,77,SEINE ET MARNE,135,12,147,0,269,3,272,420
2020,77296,MOISSY CRAMAYEL,200059228,CA GRAND PARIS SUD SEINE ESSONNE SENART,77,SEINE ET MARNE,143,11,154,18,269,3,272,444
2020,77379,PROVINS,200037133,CC DU PROVINOIS,77,SEINE ET MARNE,100,7,107,33,72,3,75,215
2020,77445,SAVIGNY LE TEMPLE,200059228,CA GRAND PARIS SUD SEINE ESSONNE SENART,77,SEINE ET MARNE,250,4,254,38,355,7,362,654
2020,77479,VAIRES SUR MARNE,200057958,CA PARIS - VALLEE DE LA MARNE,77,SEINE ET MARNE,131,2,133,0,121,6,127,259
2020,77514,VILLEPARISIS,200055655,CA ROISSY PAYS DE FRANCE,77,SEINE ET MARNE,138,5,143,5,388,6,394,542
2020,78005,ACHERES,200059889,CU GRAND PARIS SEINE ET OISE,78,YVELINES,187,30,217,11,235,14,249,477
2020,78073,BOIS D ARCY,247800584,CA VERSAILLES GRAND PARC (CAVGP),78,YVELINES,222,5,227,0,154,8,162,389
2020,78335,LIMAY,200059889,CU GRAND PARIS SEINE ET OISE,78,YVELINES,135,17,152,0,197,4,201,353
2020,78358,MAISONS LAFFITTE,200058519,CA SAINT GERMAIN BOUCLES DE SEINE,78,YVELINES,329,63,392,0,93,94,187,579
2020,78361,MANTES LA JOLIE,200059889,CU GRAND PARIS SEINE ET OISE,78,YVELINES,340,51,391,40,146,16,162,593
2020,78383,MAUREPAS,200058782,CA DE SAINT QUENTIN EN YVELINES,78,YVELINES,192,7,199,24,195,3,198,420
2020,78423,MONTIGNY LE BRETONNEUX,200058782,CA DE SAINT QUENTIN EN YVELINES,78,YVELINES,526,7,533,5,362,20,382,920
2020,78481,LE PECQ,200058519,CA SAINT GERMAIN BOUCLES DE SEINE,78,YVELINES,169,13,182,8,122,28,150,340
2020,78490,PLAISIR,200058782,CA DE SAINT QUENTIN EN YVELINES,78,YVELINES,243,103,346,27,347,9,356,729
2020,78643,VERNOUILLET,200059889,CU GRAND PARIS SEINE ET OISE,78,YVELINES,82,9,91,14,95,8,103,209
2020,78646,VERSAILLES,247800584,CA VERSAILLES GRAND PARC (CAVGP),78,YVELINES,1117,150,1267,77,538,333,871,2215
2020,78688,VOISINS LE BRETONNEUX,200058782,CA DE SAINT QUENTIN EN YVELINES,78,YVELINES,95,3,98,3,96,14,110,211
2020,79202,PARTHENAY,200041333,CC DE PARTHENAY-GATINE,79,DEUX SEVRES,72,0,72,2,86,3,89,163
2020,80001,ABBEVILLE,200070993,CA DE LA BAIE DE SOMME,80,SOMME,54,18,72,40,277,2,279,391
2020,81065,CASTRES,248100430,CA DE CASTRES MAZAMET,81,TARN,281,43,324,47,194,21,215,586
2020,81105,GRAULHET,200066124,CA GAILLAC-GRAULHET,81,TARN,74,0,74,29,65,1,66,169
2020,82033,CASTELSARRASIN,200066322,CC TERRES DES CONFLUENCES,82,TARN ET GARONNE,85,3,88,5,110,5,115,208
2020,83050,DRAGUIGNAN,248300493,CA DRACENIE PROVENCE VERDON AGGLOMERATION,83,VAR,236,15,251,18,276,16,292,562
2020,83073,LE LUC,248300550,CC COEUR DU VAR,83,VAR,90,5,95,0,72,2,74,169
2020,83115,SAINTE MAXIME,200036077,CC DU GOLFE DE SAINT-TROPEZ,83,VAR,160,0,160,0,41,3,44,204
2020,83118,SAINT RAPHAEL,200035319,CA ESTEREL COTE D'AZUR AGGLOMERATION,83,VAR,207,16,223,12,144,9,153,389
2020,83148,VIDAUBAN,248300493,CA DRACENIE PROVENCE VERDON AGGLOMERATION,83,VAR,20,3,23,0,135,3,138,161
2020,84035,CAVAILLON,200040442,CA LUBERON MONTS DE VAUCLUSE,84,VAUCLUSE,200,2,202,0,118,10,128,330
2020,84087,ORANGE,248400236,CC PAYS D'ORANGE EN PROVENCE,84,VAUCLUSE,172,5,177,3,282,6,288,468
2020,84088,PERNES LES FONTAINES,248400293,CA DES SORGUES DU COMTAT,84,VAUCLUSE,68,4,72,3,117,10,127,202
2020,85047,CHALLANS,200071629,CC CHALLANS-GOIS COMMUNAUTE,85,VENDEE,50,20,70,22,360,2,362,454
2020,85226,SAINT HILAIRE DE RIEZ,200023778,CA DU PAYS DE SAINT-GILLES-CROIX-DE-VIE,85,VENDEE,35,1,36,21,177,2,179,236
2020,86194,POITIERS,200069854,CU DU GRAND POITIERS,86,VIENNE,730,4,734,41,607,39,646,1421
2020,88413,SAINT DIE DES VOSGES,200071066,CA DE SAINT-DIE-DES-VOSGES,88,VOSGES,126,0,126,41,128,1,129,296
2020,91027,ATHIS MONS,200054781,METROPOLE DU GRAND PARIS,91,ESSONNE,298,30,328,52,374,16,390,770
2020,91201,DRAVEIL,200058477,CA VAL D'YERRES VAL DE SEINE,91,ESSONNE,411,15,426,11,279,10,289,727
2020,91215,EPINAY SOUS SENART,200058477,CA VAL D'YERRES VAL DE SEINE,91,ESSONNE,80,1,81,22,134,2,136,239
2020,91216,EPINAY SUR ORGE,200056232,CA COMMUNAUTE PARIS-SACLAY,91,ESSONNE,95,1,96,0,95,6,101,198
2020,91235,FLEURY MEROGIS,200057859,CA COEUR D'ESSONNE AGGLOMERATION,91,ESSONNE,114,5,119,0,109,4,113,232
2020,91286,GRIGNY,200059228,CA GRAND PARIS SUD SEINE ESSONNE SENART,91,ESSONNE,177,2,179,160,145,1,146,485
2020,91432,MORANGIS,200054781,METROPOLE DU GRAND PARIS,91,ESSONNE,125,3,128,0,159,8,167,295
2020,91434,MORSANG SUR ORGE,200057859,CA COEUR D'ESSONNE AGGLOMERATION,91,ESSONNE,200,10,210,0,260,4,264,474
2020,91471,ORSAY,200056232,CA COMMUNAUTE PARIS-SACLAY,91,ESSONNE,202,7,209,1,98,14,112,323
2020,91521,RIS ORANGIS,200059228,CA GRAND PARIS SUD SEINE ESSONNE SENART,91,ESSONNE,221,4,225,18,317,4,321,564
2020,91573,SAINT PIERRE DU PERRAY,200059228,CA GRAND PARIS SUD SEINE ESSONNE SENART,91,ESSONNE,97,4,101,0,217,5,222,323
2020,91645,VERRIERES LE BUISSON,200056232,CA COMMUNAUTE PARIS-SACLAY,91,ESSONNE,147,1,148,7,106,15,121,276
2020,91661,VILLEBON SUR YVETTE,200056232,CA COMMUNAUTE PARIS-SACLAY,91,ESSONNE,240,12,252,0,62,5,67,319
2020,91692,LES ULIS,200056232,CA COMMUNAUTE PARIS-SACLAY,91,ESSONNE,292,3,295,16,259,6,265,576
2020,92012,BOULOGNE BILLANCOURT,200054781,METROPOLE DU GRAND PARIS,92,HAUTS DE SEINE,2408,238,2646,36,512,949,1461,4143
2020,92014,BOURG LA REINE,200054781,METROPOLE DU GRAND PARIS,92,HAUTS DE SEINE,327,4,331,0,88,67,155,486
2020,92022,CHAVILLE,200054781,METROPOLE DU GRAND PARIS,92,HAUTS DE SEINE,248,22,270,1,138,93,231,502
2020,92025,COLOMBES,200054781,METROPOLE DU GRAND PARIS,92,HAUTS DE SEINE,1235,99,1334,41,566,291,857,2232
2020,92026,COURBEVOIE,200054781,METROPOLE DU GRAND PARIS,92,HAUTS DE SEINE,1918,95,2013,26,592,316,908,2947
2020,92035,LA GARENNE COLOMBES,200054781,METROPOLE DU GRAND PARIS,92,HAUTS DE SEINE,660,41,701,6,103,119,222,928
2020,92036,GENNEVILLIERS,200054781,METROPOLE DU GRAND PARIS,92,HAUTS DE SEINE,711,6,717,186,213,30,243,1146
2020,92050,NANTERRE,200054781,METROPOLE DU GRAND PARIS,92,HAUTS DE SEINE,1405,45,1450,155,702,157,859,2463
2020,92077,VILLE D AVRAY,200054781,METROPOLE DU GRAND PARIS,92,HAUTS DE SEINE,171,2,173,0,74,31,105,277
2020,93005,AULNAY SOUS BOIS,200054781,METROPOLE DU GRAND PARIS,93,SEINE SAINT DENIS,791,19,810,111,324,29,353,1274
2020,93014,CLICHY SOUS BOIS,200054781,METROPOLE DU GRAND PARIS,93,SEINE SAINT DENIS,185,1,186,46,100,4,104,336
2020,93029,DRANCY,200054781,METROPOLE DU GRAND PARIS,93,SEINE SAINT DENIS,493,5,498,0,316,16,332,830
2020,93032,GAGNY,200054781,METROPOLE DU GRAND PARIS,93,SEINE SAINT DENIS,345,16,361,3,309,27,336,700
2020,93049,NEUILLY PLAISANCE,200054781,METROPOLE DU GRAND PARIS,93,SEINE SAINT DENIS,162,31,193,0,154,15,169,362
2020,93053,NOISY LE SEC,200054781,METROPOLE DU GRAND PARIS,93,SEINE SAINT DENIS,314,5,319,6,215,32,247,571
2020,93057,LES PAVILLONS SOUS BOIS,200054781,METROPOLE DU GRAND PARIS,93,SEINE SAINT DENIS,222,10,232,19,133,14,147,398
2020,93070,SAINT OUEN SUR SEINE,200054781,METROPOLE DU GRAND PARIS,93,SEINE SAINT DENIS,587,50,637,48,382,182,564,1249
2020,93072,STAINS,200054781,METROPOLE DU GRAND PARIS,93,SEINE SAINT DENIS,341,12,353,37,143,15,158,548
2020,94003,ARCUEIL,200054781,METROPOLE DU GRAND PARIS,94,VAL DE MARNE,269,28,297,18,132,30,162,478
2020,94011,BONNEUIL SUR MARNE,200054781,METROPOLE DU GRAND PARIS,94,VAL DE MARNE,190,4,194,70,109,14,123,387
2020,94015,BRY SUR MARNE,200054781,METROPOLE DU GRAND PARIS,94,VAL DE MARNE,299,17,316,9,111,32,143,467
2020,94021,CHEVILLY LARUE,200054781,METROPOLE DU GRAND PARIS,94,VAL DE MARNE,275,9,284,0,158,6,164,448
2020,94028,CRETEIL,200054781,METROPOLE DU GRAND PARIS,94,VAL DE MARNE,1483,23,1506,88,373,61,434,2028
2020,94033,FONTENAY SOUS BOIS,200054781,METROPOLE DU GRAND PARIS,94,VAL DE MARNE,513,46,559,40,397,168,565,1164
2020,94037,GENTILLY,200054781,METROPOLE DU GRAND PARIS,94,VAL DE MARNE,261,8,269,63,84,17,101,432
2020,94046,MAISONS ALFORT,200054781,METROPOLE DU GRAND PARIS,94,VAL DE MARNE,630,30,660,1,498,135,633,1294
2020,94052,NOGENT SUR MARNE,200054781,METROPOLE DU GRAND PARIS,94,VAL DE MARNE,520,54,574,16,153,157,310,900
2020,94054,ORLY,200054781,METROPOLE DU GRAND PARIS,94,VAL DE MARNE,241,6,247,85,143,8,151,484
2020,94055,ORMESSON SUR MARNE,200054781,METROPOLE DU GRAND PARIS,94,VAL DE MARNE,105,4,109,0,85,3,88,197
2020,94060,LA QUEUE EN BRIE,200054781,METROPOLE DU GRAND PARIS,94,VAL DE MARNE,115,0,115,0,115,2,117,232
2020,94071,SUCY EN BRIE,200054781,METROPOLE DU GRAND PARIS,94,VAL DE MARNE,160,19,179,0,205,19,224,403
2020,94078,VILLENEUVE SAINT GEORGES,200054781,METROPOLE DU GRAND PARIS,94,VAL DE MARNE,210,2,212,28,163,8,171,411
2020,95018,ARGENTEUIL,200054781,METROPOLE DU GRAND PARIS,95,VAL D OISE,1046,57,1103,45,785,53,838,1987
2020,95199,DOMONT,200056380,CA PLAINE VALLEE,95,VAL D OISE,120,20,140,0,180,11,191,332
2020,95218,ERAGNY,249500109,CA DE CERGY-PONTOISE,95,VAL D OISE,101,28,129,0,253,6,259,388
2020,95219,ERMONT,200058485,CA VAL PARISIS,95,VAL D OISE,227,16,243,0,328,24,352,595
2020,95313,L'ISLE ADAM,249500455,CC DE LA VALLEE DE L'OISE ET DES TROIS FORETS,95,VAL D OISE,67,34,101,7,120,7,127,235
2020,95323,JOUY LE MOUTIER,249500109,CA DE CERGY-PONTOISE,95,VAL D OISE,132,9,141,0,242,4,246,387
2020,95487,PERSAN,249500489,CC DU HAUT VAL D'OISE,95,VAL D OISE,57,8,65,20,155,6,161,246
2020,95563,SAINT LEU LA FORET,200058485,CA VAL PARISIS,95,VAL D OISE,97,14,111,0,179,19,198,309
2020,95585,SARCELLES,200055655,CA ROISSY PAYS DE FRANCE,95,VAL D OISE,392,36,428,242,220,40,260,930
2020,95637,VAUREAL,249500109,CA DE CERGY-PONTOISE,95,VAL D OISE,113,13,126,0,228,4,232,358
2020,95680,VILLIERS LE BEL,200055655,CA ROISSY PAYS DE FRANCE,95,VAL D OISE,160,1,161,7,175,6,181,349
2020,97113,LE GOSIER,200041507,CA LA RIVIERA DU LEVANT,971,GUADELOUPE,175,43,218,69,125,15,140,427
2020,97115,LAMENTIN,249710062,CA DU NORD BASSE-TERRE,971,GUADELOUPE,56,20,76,46,119,14,133,255
2020,97118,PETIT BOURG,249710062,CA DU NORD BASSE-TERRE,971,GUADELOUPE,25,48,73,48,154,30,184,305
2020,97120,POINTE A PITRE,200018653,CA CAP EXCELLENCE,971,GUADELOUPE,150,5,155,31,41,1,42,227
2020,97125,SAINT FRANCOIS,200041507,CA LA RIVIERA DU LEVANT,971,GUADELOUPE,53,34,87,39,75,4,79,205
2020,97128,SAINTE ANNE,200041507,CA LA RIVIERA DU LEVANT,971,GUADELOUPE,55,55,110,37,120,7,127,274
2020,97207,DUCOS,249720053,CA DE L'ESPACE SUD DE LA MARTINIQUE,972,MARTINIQUE,26,40,66,16,134,9,143,226
2020,97213,LE LAMENTIN,249720061,CA DU CENTRE DE LA MARTINIQUE,972,MARTINIQUE,719,34,753,65,152,12,164,981
2020,97221,RIVIERE SALEE,249720053,CA DE L'ESPACE SUD DE LA MARTINIQUE,972,MARTINIQUE,0,11,11,61,67,0,67,139
2020,97224,SAINT JOSEPH,249720061,CA DU CENTRE DE LA MARTINIQUE,972,MARTINIQUE,112,55,167,70,34,4,38,275
2020,97306,MANA,249730037,CC DE L'OUEST GUYANAIS,973,GUYANE,0,0,0,10,3,2,5,15
2020,97307,MATOURY,249730045,CA DU CENTRE LITTORAL,973,GUYANE,396,0,396,3,50,3,53,452
2020,97401,LES AVIRONS,249740077,CA CIVIS (COMMUNAUTE INTERCOMMUNALE DES VILLES SOLIDAIRES),974,LA REUNION,0,61,61,1,93,13,106,167
2020,97402,BRAS PANON,249740093,CA INTERCOMMUNALE DE LA REUNION EST (CIREST),974,LA REUNION,52,38,90,61,57,4,61,212
2020,97414,SAINT LOUIS,249740077,CA CIVIS (COMMUNAUTE INTERCOMMUNALE DES VILLES SOLIDAIRES),974,LA REUNION,208,92,300,81,226,64,290,670
2020,97422,LE TAMPON,249740085,CA DU SUD,974,LA REUNION,216,156,372,6,449,54,503,881
2021,01033,VALSERHONE,240100891,CC DU PAYS BELLEGARDIEN (CCPB),01,AIN,65,20,85,46,212,0,212,343
2021,01249,MIRIBEL,240100800,CC DE MIRIBEL ET DU PLATEAU,01,AIN,102,10,112,10,147,7,154,275
2021,01354,SAINT GENIS POUILLY,240100750,CA DU PAYS DE GEX,01,AIN,105,5,110,0,111,2,113,223
2021,02408,LAON,200043495,CA DU PAYS DE LAON,02,AISNE,116,4,120,46,221,1,222,388
2021,03185,MONTLUCON,200071082,CA MONTLUCON COMMUNAUTE,03,ALLIER,129,0,129,48,319,6,325,502
2021,03310,VICHY,200071363,CA VICHY COMMUNAUTE,03,ALLIER,165,0,165,73,158,7,165,403
2021,04070,DIGNE LES BAINS,200067437,CA PROVENCE-ALPES-AGGLOMERATION,04,ALPES DE HAUTE PROVENCE,102,14,116,16,102,4,106,238
2021,06079,MANDELIEU LA NAPOULE,200039915,CA CANNES PAYS DE LERINS,06,ALPES MARITIMES,237,15,252,0,116,15,131,383
2021,06085,MOUGINS,200039915,CA CANNES PAYS DE LERINS,06,ALPES MARITIMES,245,33,278,0,130,16,146,424
2021,06069,GRASSE,200039857,CA DU PAYS DE GRASSE,06,ALPES MARITIMES,437,27,464,8,389,18,407,879
2021,06030,LE CANNET,200039915,CA CANNES PAYS DE LERINS,06,ALPES MARITIMES,276,41,317,8,239,18,257,581
2021,06033,CARROS,200030195,METROPOLE NICE COTE D'AZUR,06,ALPES MARITIMES,79,16,95,0,126,2,128,224
2021,07010,ANNONAY,200072015,CA ANNONAY RHONE AGGLO,07,ARDECHE,122,16,138,27,83,6,89,254
2021,08105,CHARLEVILLE MEZIERES,200041630,CA ARDENNE METROPOLE,08,ARDENNES,358,41,399,105,230,20,250,754
2021,09225,PAMIERS,200066231,CC DES PORTES D'ARIEGE PYRENEES,09,ARIEGE,193,1,194,5,96,3,99,298
2021,10081,LA CHAPELLE SAINT LUC,200069250,CA TROYES CHAMPAGNE METROPOLE,10,AUBE,78,0,78,49,102,6,108,236
2021,10323,ROMILLY SUR SEINE,200000545,CC DES PORTES DE ROMILLY SUR SEINE,10,AUBE,55,1,56,41,149,2,151,248
2021,11262,NARBONNE,241100593,CA LE GRAND NARBONNE,11,AUDE,273,21,294,63,329,24,353,711
2021,12300,VILLEFRANCHE DE ROUERGUE,200069383,CC OUEST AVEYRON COMMUNAUTE,12,AVEYRON,44,0,44,27,93,1,94,165
2021,12145,MILLAU,241200567,CC DE MILLAU GRANDS CAUSSES,12,AVEYRON,121,0,121,46,199,2,201,368
2021,13007,AURIOL,200054807,METROPOLE D'AIX-MARSEILLE-PROVENCE,13,BOUCHES DU RHONE,72,4,76,0,110,2,112,187
2021,13039,FOS SUR MER,200054807,METROPOLE D'AIX-MARSEILLE-PROVENCE,13,BOUCHES DU RHONE,150,2,152,0,123,2,125,276
2021,13040,FUVEAU,200054807,METROPOLE D'AIX-MARSEILLE-PROVENCE,13,BOUCHES DU RHONE,75,16,91,0,126,0,126,217
2021,13056,MARTIGUES,200054807,METROPOLE D'AIX-MARSEILLE-PROVENCE,13,BOUCHES DU RHONE,512,11,523,26,173,17,190,739
2021,13063,MIRAMAS,200054807,METROPOLE D'AIX-MARSEILLE-PROVENCE,13,BOUCHES DU RHONE,173,4,177,34,141,4,145,356
2021,13103,SALON DE PROVENCE,200054807,METROPOLE D'AIX-MARSEILLE-PROVENCE,13,BOUCHES DU RHONE,392,37,429,4,363,31,394,827
2021,13108,TARASCON,241300417,CA D'ARLES-CRAU-CAMARGUE-MONTAGNETTE,13,BOUCHES DU RHONE,85,3,88,16,46,2,48,151
2021,13117,VITROLLES,200054807,METROPOLE D'AIX-MARSEILLE-PROVENCE,13,BOUCHES DU RHONE,364,30,394,42,225,13,238,674
2021,13201,MARSEILLE 1ER ARRONDISSEMENT,200054807,METROPOLE D'AIX-MARSEILLE-PROVENCE,13,BOUCHES DU RHONE,301,33,334,11,117,37,154,499
2021,13202,MARSEILLE 2E ARRONDISSEMENT,200054807,METROPOLE D'AIX-MARSEILLE-PROVENCE,13,BOUCHES DU RHONE,342,40,382,35,49,5,54,471
2021,13206,MARSEILLE 6E ARRONDISSEMENT,200054807,METROPOLE D'AIX-MARSEILLE-PROVENCE,13,BOUCHES DU RHONE,608,183,791,3,233,81,314,1108
2021,13216,MARSEILLE 16E ARRONDISSEMENT,200054807,METROPOLE D'AIX-MARSEILLE-PROVENCE,13,BOUCHES DU RHONE,222,15,237,32,38,5,43,312
2021,15014,AURILLAC,241500230,CA DU BASSIN D'AURILLAC,15,CANTAL,186,1,187,46,232,7,239,472
2021,16015,ANGOULEME,200071827,CA DU GRAND ANGOULEME,16,CHARENTE,315,24,339,61,201,25,226,626
2021,16102,COGNAC,200070514,CA DU GRAND COGNAC,16,CHARENTE,137,0,137,35,124,25,149,321
2021,17306,ROYAN,241700640,CA ROYAN ATLANTIQUE,17,CHARENTE MARITIME,49,0,49,24,92,2,94,167
2021,18279,VIERZON,200090561,CC VIERZON-SOLOGNE-BERRY,18,CHER,75,0,75,30,264,2,266,371
2021,19272,TULLE,241927201,CA TULLE AGGLO,19,CORREZE,136,0,136,27,88,4,92,255
2021,2A004,AJACCIO,242010056,CA DU PAYS AJACCIEN,20R,CORSE,465,9,474,23,185,17,202,699
2021,2B033,BASTIA,242000354,CA DE BASTIA,20R,CORSE,299,18,317,33,133,7,140,490
2021,21617,TALANT,242100410,DIJON METROPOLE,21,COTE D OR,126,17,143,11,91,3,94,248
2021,22278,SAINT BRIEUC,200069409,CA SAINT-BRIEUC ARMOR AGGLOMERATION,22,COTES D ARMOR,268,5,273,97,434,11,445,815
2021,22050,DINAN,200068989,CA DINAN AGGLOMERATION,22,COTES D ARMOR,65,6,71,30,84,2,86,187
2021,22093,LAMBALLE ARMOR,200069391,CA LAMBALLE TERRE ET MER,22,COTES D ARMOR,46,10,56,42,314,5,319,417
2021,23096,GUERET,200034825,CA DU GRAND GUERET,23,CREUSE,82,0,82,16,132,0,132,230
2021,24322,PERIGUEUX,200040392,CA LE GRAND PERIGUEUX,24,DORDOGNE,288,5,293,45,135,18,153,491
2021,25580,VALENTIGNEY,200065647,CA PAYS DE MONTBELIARD AGGLOMERATION,25,DOUBS,37,0,37,22,80,2,82,142
2021,26252,PORTES LES VALENCE,200068781,CA VALENCE ROMANS AGGLO,26,DROME,35,2,37,10,172,0,172,219
2021,26235,PIERRELATTE,200042901,CC DROME SUD PROVENCE,26,DROME,50,14,64,14,157,3,160,239
2021,27229,EVREUX,200071454,CA EVREUX PORTES DE NORMANDIE,27,EURE,438,34,472,78,313,6,319,869
2021,27681,VERNON,200072312,CA SEINE NORMANDIE AGGLOMERATION,27,EURE,155,73,228,2,258,12,270,500
2021,28134,DREUX,200040277,CA AGGLO DU PAYS DE DREUX,28,EURE ET LOIR,270,18,288,25,173,16,189,502
2021,29212,PLOUZANE,242900314,BREST METROPOLE,29,FINISTERE,48,2,50,32,269,3,272,354
2021,29151,MORLAIX,242900835,CA MORLAIX COMMUNAUTE,29,FINISTERE,130,0,130,42,102,3,105,277
2021,29039,CONCARNEAU,242900769,CA CONCARNEAU CORNOUAILLE AGGLOMERATION,29,FINISTERE,72,0,72,26,178,8,186,284
2021,29103,LANDERNEAU,242900801,CA DU PAYS DE LANDERNEAU-DAOULAS,29,FINISTERE,60,0,60,58,274,1,275,393
2021,29075,GUIPAVAS,242900314,BREST METROPOLE,29,FINISTERE,167,2,169,21,300,11,311,501
2021,29189,PLOUGASTEL DAOULAS,242900314,BREST METROPOLE,29,FINISTERE,56,0,56,44,248,10,258,358
2021,30028,BAGNOLS SUR CEZE,200034692,CA DU GARD RHODANIEN,30,GARD,120,4,124,19,73,5,78,221
2021,30007,ALES,200066918,CA ALES AGGLOMERATION,30,GARD,181,5,186,85,227,12,239,510
2021,30202,PONT SAINT ESPRIT,200034692,CA DU GARD RHODANIEN,30,GARD,60,5,65,12,87,0,87,164
2021,30032,BEAUCAIRE,243000585,CC BEAUCAIRE TERRE D'ARGENCE,30,GARD,120,1,121,18,71,5,76,215
2021,30258,SAINT GILLES,243000643,CA DE NIMES METROPOLE,30,GARD,32,4,36,11,126,3,129,175
2021,30189,NIMES,243000643,CA DE NIMES METROPOLE,30,GARD,1170,12,1182,125,562,98,660,1968
2021,30351,VILLENEUVE LES AVIGNON,248400251,CA DU GRAND AVIGNON (COGA),30,GARD,89,24,113,10,55,8,63,186
2021,31395,MURET,200068641,CA LE MURETAIN AGGLO,31,HAUTE GARONNE,193,1,194,1,293,5,298,493
2021,31116,CASTELGINEST,243100518,TOULOUSE METROPOLE,31,HAUTE GARONNE,49,2,51,0,188,1,189,240
2021,31187,FONSORBES,200068641,CA LE MURETAIN AGGLO,31,HAUTE GARONNE,76,12,88,0,177,2,179,267
2021,31044,BALMA,243100518,TOULOUSE METROPOLE,31,HAUTE GARONNE,209,11,220,0,137,15,152,371
2021,31113,CASTANET TOLOSAN,243100633,CA DU SICOVAL,31,HAUTE GARONNE,120,16,136,0,171,4,175,311
2021,32013,AUCH,200066926,CA GRAND AUCH COEUR DE GASCOGNE,32,GERS,172,0,172,70,185,3,188,430
2021,33162,EYSINES,243300316,BORDEAUX METROPOLE,33,GIRONDE,168,39,207,0,383,12,395,603
2021,33199,GUJAN MESTRAS,243300563,CA BASSIN D'ARCACHON SUD (COBAS),33,GIRONDE,108,23,131,15,182,5,187,333
2021,33449,SAINT MEDARD EN JALLES,243300316,BORDEAUX METROPOLE,33,GIRONDE,174,26,200,0,498,9,507,707
2021,33069,LE BOUSCAT,243300316,BORDEAUX METROPOLE,33,GIRONDE,222,57,279,1,221,47,268,548
2021,33243,LIBOURNE,200070092,CA DU LIBOURNAIS,33,GIRONDE,222,16,238,0,206,3,209,447
2021,33281,MERIGNAC,243300316,BORDEAUX METROPOLE,33,GIRONDE,590,136,726,0,1018,52,1070,1795
2021,33366,SAINT ANDRE DE CUBZAC,243301223,CC DU GRAND CUBZAGUAIS,33,GIRONDE,46,7,53,0,287,2,289,343
2021,33192,GRADIGNAN,243300316,BORDEAUX METROPOLE,33,GIRONDE,244,10,254,15,202,7,209,479
2021,33318,PESSAC,243300316,BORDEAUX METROPOLE,33,GIRONDE,521,79,600,28,804,36,840,1468
2021,33550,VILLENAVE D ORNON,243300316,BORDEAUX METROPOLE,33,GIRONDE,323,43,366,17,563,16,579,962
2021,33039,BEGLES,243300316,BORDEAUX METROPOLE,33,GIRONDE,196,40,236,0,422,26,448,683
2021,33009,ARCACHON,243300563,CA BASSIN D'ARCACHON SUD (COBAS),33,GIRONDE,66,2,68,13,19,2,21,103
2021,34108,FRONTIGNAN,200066355,CA SETE AGGLOPOLE MEDITERRANEE,34,HERAULT,121,25,146,14,182,8,190,349
2021,34255,SAINT GELY DU FESC,200022986,CC DU GRAND PIC SAINT-LOUP,34,HERAULT,63,20,83,0,130,1,131,214
2021,34301,SETE,200066355,CA SETE AGGLOPOLE MEDITERRANEE,34,HERAULT,214,54,268,37,158,7,165,470
2021,34337,VILLENEUVE LES MAGUELONE,243400017,MONTPELLIER MEDITERRANEE METROPOLE,34,HERAULT,91,8,99,0,88,9,97,196
2021,35210,PACE,243500139,RENNES METROPOLE,35,ILLE ET VILAINE,60,3,63,14,164,6,170,247
2021,35024,BETTON,243500139,RENNES METROPOLE,35,ILLE ET VILAINE,48,50,98,7,200,6,206,311
2021,35055,CHANTEPIE,243500139,RENNES METROPOLE,35,ILLE ET VILAINE,42,16,58,17,180,4,184,259
2021,35288,SAINT MALO,243500782,CA DU PAYS DE SAINT MALO AGGLOMERATION,35,ILLE ET VILAINE,225,18,243,106,360,34,394,743
2021,35047,BRUZ,243500139,RENNES METROPOLE,35,ILLE ET VILAINE,75,51,126,43,255,6,261,429
2021,37233,SAINT PIERRE DES CORPS,243700754,TOURS METROPOLE VAL DE LOIRE,37,INDRE ET LOIRE,78,15,93,54,227,1,228,375
2021,37050,CHAMBRAY LES TOURS,243700754,TOURS METROPOLE VAL DE LOIRE,37,INDRE ET LOIRE,103,10,113,0,168,4,172,285
2021,38563,VOIRON,243800984,CA DU PAYS VOIRONNAIS,38,ISERE,150,29,179,3,250,6,256,438
2021,38421,SAINT MARTIN D HERES,200040715,GRENOBLE-ALPES-METROPOLE,38,ISERE,253,35,288,30,413,6,419,737
2021,40192,MONT DE MARSAN,244000808,CA MONT DE MARSAN AGGLOMERATION,40,LANDES,176,0,176,12,371,3,374,562
2021,42095,FIRMINY,244200770,SAINT-ETIENNE METROPOLE,42,LOIRE,65,16,81,22,140,2,142,244
2021,42186,RIVE DE GIER,244200770,SAINT-ETIENNE METROPOLE,42,LOIRE,58,43,101,4,175,1,176,281
2021,42187,ROANNE,200035731,CA ROANNAIS AGGLOMERATION,42,LOIRE,197,19,216,27,232,9,241,484
2021,44132,PORNICHET,244400644,CA DE LA REGION NAZAIRIENNE ET DE L'ESTUAIRE (CARENE),44,LOIRE ATLANTIQUE,50,11,61,4,109,4,113,178
2021,44020,BOUGUENAIS,244400404,NANTES METROPOLE,44,LOIRE ATLANTIQUE,161,27,188,17,381,16,397,603
2021,44035,LA CHAPELLE SUR ERDRE,244400404,NANTES METROPOLE,44,LOIRE ATLANTIQUE,170,11,181,5,313,12,325,511
2021,44215,VERTOU,244400404,NANTES METROPOLE,44,LOIRE ATLANTIQUE,120,74,194,20,428,29,457,670
2021,44026,CARQUEFOU,244400404,NANTES METROPOLE,44,LOIRE ATLANTIQUE,183,18,201,18,327,20,347,566
2021,44129,PONTCHATEAU,200000438,CC DU PAYS DE PONTCHATEAU ST-GILDAS-DES-BOIS,44,LOIRE ATLANTIQUE,23,7,30,10,260,0,260,301
2021,44204,THOUARE SUR LOIRE,244400404,NANTES METROPOLE,44,LOIRE ATLANTIQUE,50,19,69,0,220,6,226,295
2021,44036,CHATEAUBRIANT,200072726,CC CHATEAUBRIANT-DERVAL,44,LOIRE ATLANTIQUE,56,0,56,18,116,5,121,195
2021,44055,LA BAULE ESCOUBLAC,244400610,CA DE LA PRESQU'ILE DE GUERANDE ATLANTIQUE (CAP ATLANTIQUE),44,LOIRE ATLANTIQUE,60,4,64,13,106,10,116,192
2021,44190,SAINT SEBASTIEN SUR LOIRE,244400404,NANTES METROPOLE,44,LOIRE ATLANTIQUE,156,26,182,4,510,24,534,720
2021,44131,PORNIC,200067346,CA PORNIC AGGLO PAYS DE RETZ,44,LOIRE ATLANTIQUE,35,20,55,8,207,14,221,284
2021,45234,ORLEANS,244500468,ORLEANS METROPOLE,45,LOIRET,1053,148,1201,104,931,94,1025,2330
2021,45232,OLIVET,244500468,ORLEANS METROPOLE,45,LOIRET,226,43,269,12,179,12,191,472
2021,45075,LA CHAPELLE SAINT MESMIN,244500468,ORLEANS METROPOLE,45,LOIRET,59,22,81,0,134,6,140,221
2021,45155,GIEN,244500211,CC GIENNOISES,45,LOIRET,80,5,85,10,133,1,134,228
2021,46042,CAHORS,200023737,CA DU GRAND CAHORS,46,LOT,142,5,147,18,209,3,212,376
2021,47157,MARMANDE,200030674,CA VAL DE GARONNE AGGLOMERATION,47,LOT ET GARONNE,158,0,158,7,162,1,163,328
2021,47001,AGEN,200096956,CA AGGLOMERATION D'AGEN,47,LOT ET GARONNE,229,1,230,66,286,11,297,593
2021,48095,MENDE,244800405,CC COEUR DE LOZERE,48,LOZERE,111,0,111,55,110,1,111,277
2021,49092,CHEMILLE EN ANJOU,200060010,CA MAUGES COMMUNAUTE,49,MAINE ET LOIRE,36,45,81,47,387,2,389,516
2021,49218,MONTREVAULT SUR EVRE,200060010,CA MAUGES COMMUNAUTE,49,MAINE ET LOIRE,36,5,41,35,213,8,221,297
2021,49069,OREE D ANJOU,200060010,CA MAUGES COMMUNAUTE,49,MAINE ET LOIRE,26,0,26,26,296,4,300,352
2021,49125,DOUE EN ANJOU,200071876,CA SAUMUR VAL DE LOIRE,49,MAINE ET LOIRE,20,1,21,2,137,3,140,163
2021,49353,TRELAZE,244900015,CU ANGERS LOIRE METROPOLE,49,MAINE ET LOIRE,84,41,125,66,335,3,338,528
2021,49244,MAUGES SUR LOIRE,200060010,CA MAUGES COMMUNAUTE,49,MAINE ET LOIRE,36,3,39,30,271,7,278,346
2021,49246,LES PONTS DE CE,244900015,CU ANGERS LOIRE METROPOLE,49,MAINE ET LOIRE,40,16,56,10,167,6,173,239
2021,49301,SEVREMOINE,200060010,CA MAUGES COMMUNAUTE,49,MAINE ET LOIRE,36,24,60,61,467,4,471,593
2021,50025,AVRANCHES,200069425,CA MONT-SAINT-MICHEL-NORMANDIE,50,MANCHE,45,0,45,43,104,0,104,192
2021,50502,SAINT LO,200066389,CA SAINT-LO AGGLO,50,MANCHE,90,18,108,37,233,4,237,382
2021,53147,MAYENNE,200055887,CC MAYENNE COMMUNAUTE,53,MAYENNE,80,8,88,26,137,0,137,251
2021,54482,SAINT MAX,245400676,METROPOLE DU GRAND NANCY,54,MEURTHE ET MOSELLE,34,4,38,0,76,9,85,123
2021,54547,VANDOEUVRE LES NANCY,245400676,METROPOLE DU GRAND NANCY,54,MEURTHE ET MOSELLE,284,15,299,71,171,10,181,551
2021,54395,NANCY,245400676,METROPOLE DU GRAND NANCY,54,MEURTHE ET MOSELLE,1004,77,1081,87,378,101,479,1647
2021,55545,VERDUN,200049187,CA DU GRAND VERDUN,55,MEUSE,90,13,103,27,138,2,140,271
2021,56098,LANESTER,200042174,CA LORIENT AGGLOMERATION,56,MORBIHAN,104,14,118,83,282,7,289,490
2021,56078,GUIDEL,200042174,CA LORIENT AGGLOMERATION,56,MORBIHAN,30,7,37,44,145,2,147,228
2021,56083,HENNEBONT,200042174,CA LORIENT AGGLOMERATION,56,MORBIHAN,50,5,55,71,168,5,173,299
2021,57631,SARREGUEMINES,200070746,CA SARREGUEMINES CONFLUENCES,57,MOSELLE,210,0,210,40,53,1,54,304
2021,57221,FLORANGE,245701222,CA DU VAL DE FENSCH,57,MOSELLE,35,16,51,19,84,0,84,154
2021,57630,SARREBOURG,200068146,CC SARREBOURG MOSELLE SUD,57,MOSELLE,50,3,53,13,126,1,127,194
2021,57160,CREUTZWALD,245701164,CC DU WARNDT,57,MOSELLE,58,1,59,24,78,1,79,162
2021,59410,MONS EN BAROEUL,200093201,METROPOLE EUROPEENNE DE LILLE,59,NORD,120,23,143,90,242,11,253,485
2021,59183,DUNKERQUE,245900428,CU DE DUNKERQUE,59,NORD,467,65,532,271,658,20,678,1481
2021,59426,NEUVILLE EN FERRAIN,200093201,METROPOLE EUROPEENNE DE LILLE,59,NORD,77,29,106,50,97,1,98,253
2021,59291,HAUTMONT,200043396,CA MAUBEUGE VAL DE SAMBRE,59,NORD,26,4,30,47,99,0,99,176
2021,59139,CAUDRY,200030633,CA DU CAUDRESIS ET DU CATESIS,59,NORD,45,1,46,30,145,0,145,221
2021,59648,WATTIGNIES,200093201,METROPOLE EUROPEENNE DE LILLE,59,NORD,74,44,118,9,159,10,169,296
2021,59650,WATTRELOS,200093201,METROPOLE EUROPEENNE DE LILLE,59,NORD,184,53,237,146,434,4,438,821
2021,59009,VILLENEUVE D ASCQ,200093201,METROPOLE EUROPEENNE DE LILLE,59,NORD,625,133,758,207,476,47,523,1488
2021,59646,WASQUEHAL,200093201,METROPOLE EUROPEENNE DE LILLE,59,NORD,223,65,288,39,261,19,280,606
2021,59636,WAMBRECHIES,200093201,METROPOLE EUROPEENNE DE LILLE,59,NORD,30,62,92,31,167,9,176,299
2021,59383,MARLY,245901160,CA VALENCIENNES METROPOLE,59,NORD,90,12,102,31,137,0,137,269
2021,59163,CROIX,200093201,METROPOLE EUROPEENNE DE LILLE,59,NORD,119,56,175,75,262,23,285,535
2021,59179,DOUCHY LES MINES,200042190,CA DE LA PORTE DU HAINAUT,59,NORD,20,0,20,66,121,0,121,208
2021,59616,VIEUX CONDE,245901160,CA VALENCIENNES METROPOLE,59,NORD,25,2,27,21,51,2,53,101
2021,59043,BAILLEUL,200040947,CC DE FLANDRE INTERIEURE,59,NORD,75,16,91,40,215,2,217,348
2021,59367,LYS LEZ LANNOY,200093201,METROPOLE EUROPEENNE DE LILLE,59,NORD,44,31,75,61,168,0,168,303
2021,59008,ANICHE,245901152,CC COEUR D'OSTREVENT (CCCO),59,NORD,19,6,25,35,63,0,63,122
2021,59360,LOOS,200093201,METROPOLE EUROPEENNE DE LILLE,59,NORD,135,25,160,33,268,3,271,464
2021,59155,COUDEKERQUE BRANCHE,245900428,CU DE DUNKERQUE,59,NORD,62,9,71,77,278,4,282,431
2021,59574,SOMAIN,245901152,CC COEUR D'OSTREVENT (CCCO),59,NORD,40,3,43,49,107,0,107,200
2021,60175,CREIL,200068047,CA CREIL SUD OISE,60,OISE,230,2,232,75,138,10,148,455
2021,60159,COMPIEGNE,200067965,CA DE LA REGION DE COMPIEGNE ET DE LA BASSE AUTOMNE,60,OISE,408,11,419,60,236,21,257,735
2021,60471,NOYON,246000756,CC DU PAYS NOYONNAIS,60,OISE,122,0,122,54,79,3,82,258
2021,61006,ARGENTAN,200068450,CC ARGENTAN INTERCOM,61,ORNE,92,0,92,36,139,0,139,267
2021,62065,AVION,246200364,CA DE LENS - LIEVIN,62,PAS DE CALAIS,24,26,50,60,135,2,137,247
2021,62215,CARVIN,246200299,CA D'HENIN-CARVIN,62,PAS DE CALAIS,60,19,79,7,254,7,261,347
2021,62318,ETAPLES,200069029,CA DES DEUX BAIES EN MONTREUILLOIS,62,PAS DE CALAIS,33,4,37,67,121,2,123,227
2021,62765,SAINT OMER,200069037,CA DU PAYS DE SAINT-OMER,62,PAS DE CALAIS,25,8,33,73,106,6,112,218
2021,62758,SAINT MARTIN BOULOGNE,246200729,CA DU BOULONNAIS,62,PAS DE CALAIS,50,5,55,36,93,2,95,186
2021,62250,COURRIERES,246200299,CA D'HENIN-CARVIN,62,PAS DE CALAIS,70,13,83,31,97,1,98,212
2021,62643,OUTREAU,246200729,CA DU BOULONNAIS,62,PAS DE CALAIS,60,1,61,38,99,1,100,199
2021,62041,ARRAS,200033579,CU D'ARRAS,62,PAS DE CALAIS,339,84,423,133,266,20,286,842
2021,62108,BERCK,200069029,CA DES DEUX BAIES EN MONTREUILLOIS,62,PAS DE CALAIS,136,6,142,34,60,0,60,237
2021,63014,AUBIERE,246300701,CLERMONT AUVERGNE METROPOLE,63,PUY DE DOME,92,3,95,13,112,3,115,223
2021,63178,ISSOIRE,200070407,CA AGGLO PAYS D'ISSOIRE,63,PUY DE DOME,85,2,87,6,277,1,278,370
2021,63124,COURNON D AUVERGNE,246300701,CLERMONT AUVERGNE METROPOLE,63,PUY DE DOME,111,16,127,15,242,7,249,391
2021,63075,CHAMALIERES,246300701,CLERMONT AUVERGNE METROPOLE,63,PUY DE DOME,168,8,176,0,76,21,97,273
2021,63113,CLERMONT FERRAND,246300701,CLERMONT AUVERGNE METROPOLE,63,PUY DE DOME,995,71,1066,121,1154,79,1233,2420
2021,64422,OLORON SAINTE MARIE,200067262,CC DU HAUT BEARN,64,PYRENEES ATLANTIQUES,91,0,91,19,57,1,58,168
2021,64102,BAYONNE,200067106,CA DU PAYS BASQUE,64,PYRENEES ATLANTIQUES,255,97,352,62,364,30,394,809
2021,64430,ORTHEZ,200039204,CC DE LACQ-ORTHEZ,64,PYRENEES ATLANTIQUES,50,0,50,15,73,3,76,141
2021,64348,LONS,200067254,CA PAU BEARN PYRENEES,64,PYRENEES ATLANTIQUES,74,14,88,0,202,6,208,296
2021,64483,SAINT JEAN DE LUZ,200067106,CA DU PAYS BASQUE,64,PYRENEES ATLANTIQUES,70,14,84,34,63,9,72,190
2021,65286,LOURDES,200069300,CA TARBES-LOURDES-PYRENEES,65,HAUTES PYRENEES,129,0,129,30,40,1,41,200
2021,66172,SAINT ESTEVE,200027183,CU PERPIGNAN MEDITERRANEE METROPOLE,66,PYRENEES ORIENTALES,40,9,49,11,119,2,121,182
2021,66180,SAINT LAURENT DE LA SALANQUE,200027183,CU PERPIGNAN MEDITERRANEE METROPOLE,66,PYRENEES ORIENTALES,50,4,54,2,69,1,70,126
2021,66028,CABESTANY,200027183,CU PERPIGNAN MEDITERRANEE METROPOLE,66,PYRENEES ORIENTALES,75,12,87,13,78,2,80,181
2021,66037,CANET EN ROUSSILLON,200027183,CU PERPIGNAN MEDITERRANEE METROPOLE,66,PYRENEES ORIENTALES,79,12,91,3,50,8,58,153
2021,67348,OBERNAI,246701080,CC DU PAYS DE SAINTE-ODILE,67,BAS RHIN,126,22,148,5,69,1,70,223
2021,67046,BISCHWILLER,200067874,CA DE HAGUENAU,67,BAS RHIN,167,42,209,0,43,0,43,252
2021,67130,ERSTEIN,200067924,CC DU CANTON D'ERSTEIN,67,BAS RHIN,65,29,94,0,119,3,122,217
2021,67043,BISCHHEIM,246700488,EUROMETROPOLE DE STRASBOURG,67,BAS RHIN,206,41,247,26,122,4,126,399
2021,67365,OSTWALD,246700488,EUROMETROPOLE DE STRASBOURG,67,BAS RHIN,150,14,164,0,103,3,106,270
2021,68224,MULHOUSE,200066009,CA MULHOUSE ALSACE AGGLOMERATION,68,HAUT RHIN,1113,28,1141,264,344,19,363,1768
2021,68154,ILLZACH,200066009,CA MULHOUSE ALSACE AGGLOMERATION,68,HAUT RHIN,85,3,88,16,61,4,65,169
2021,68271,RIEDISHEIM,200066009,CA MULHOUSE ALSACE AGGLOMERATION,68,HAUT RHIN,70,3,73,0,62,1,63,136
2021,69034,CALUIRE ET CUIRE,200046977,METROPOLE DE LYON,69,RHONE,339,128,467,35,446,54,500,1002
2021,69199,SAINT FONS,200046977,METROPOLE DE LYON,69,RHONE,157,4,161,77,119,5,124,361
2021,69243,TARARE,200040566,CA DE L'OUEST RHODANIEN,69,RHONE,83,2,85,35,79,4,83,202
2021,69256,VAULX EN VELIN,200046977,METROPOLE DE LYON,69,RHONE,402,26,428,202,304,13,317,947
2021,69264,VILLEFRANCHE SUR SAONE,200040590,CA VILLEFRANCHE BEAUJOLAIS SAONE,69,RHONE,344,21,365,156,230,15,245,766
2021,69266,VILLEURBANNE,200046977,METROPOLE DE LYON,69,RHONE,978,322,1300,424,1789,80,1869,3593
2021,69273,CORBAS,200046977,METROPOLE DE LYON,69,RHONE,84,9,93,0,147,2,149,243
2021,69282,MEYZIEU,200046977,METROPOLE DE LYON,69,RHONE,239,99,338,48,443,15,458,844
2021,69290,SAINT PRIEST,200046977,METROPOLE DE LYON,69,RHONE,529,69,598,21,537,26,563,1183
2021,69382,LYON 2E ARRONDISSEMENT,200046977,METROPOLE DE LYON,69,RHONE,386,109,495,17,237,98,335,847
2021,69387,LYON 7E ARRONDISSEMENT,200046977,METROPOLE DE LYON,69,RHONE,854,191,1045,34,810,177,987,2066
2021,69389,LYON 9E ARRONDISSEMENT,200046977,METROPOLE DE LYON,69,RHONE,683,65,748,137,452,77,529,1414
2021,71153,LE CREUSOT,247100290,CU LE CREUSOT MONTCEAU-LES-MINES,71,SAONE ET LOIRE,68,14,82,48,151,4,155,285
2021,71306,MONTCEAU LES MINES,247100290,CU LE CREUSOT MONTCEAU-LES-MINES,71,SAONE ET LOIRE,55,6,61,65,126,6,132,258
2021,73011,ALBERTVILLE,200068997,CA ARLYSERE,73,SAVOIE,90,3,93,39,212,5,217,349
2021,74225,RUMILLY,247400740,CC RUMILLY TERRE DE SAVOIE,74,HAUTE SAVOIE,170,39,209,3,181,2,183,395
2021,74224,LA ROCHE SUR FORON,247400724,CC DU PAYS ROCHOIS,74,HAUTE SAVOIE,42,1,43,0,124,3,127,170
2021,74281,THONON LES BAINS,200067551,CA THONON AGGLOMERATION,74,HAUTE SAVOIE,165,27,192,0,383,9,392,584
2021,74208,PASSY,200034882,CC PAYS DU MONT-BLANC,74,HAUTE SAVOIE,82,12,94,0,131,1,132,226
2021,74042,BONNEVILLE,200000172,CC FAUCIGNY-GLIERES,74,HAUTE SAVOIE,62,12,74,0,198,1,199,274
2021,74256,SALLANCHES,200034882,CC PAYS DU MONT-BLANC,74,HAUTE SAVOIE,108,5,113,0,167,2,169,282
2021,75102,PARIS 2E ARRONDISSEMENT,200054781,METROPOLE DU GRAND PARIS,75,PARIS,629,17,646,0,17,155,172,819
2021,75103,PARIS 3E ARRONDISSEMENT,200054781,METROPOLE DU GRAND PARIS,75,PARIS,776,22,798,14,68,161,229,1041
2021,75106,PARIS 6E ARRONDISSEMENT,200054781,METROPOLE DU GRAND PARIS,75,PARIS,613,12,625,52,13,203,216,892
2021,75114,PARIS 14E ARRONDISSEMENT,200054781,METROPOLE DU GRAND PARIS,75,PARIS,2329,189,2518,58,279,359,638,3214
2021,76476,PORT JEROME SUR SEINE,200010700,CA CAUX SEINE AGGLO,76,SEINE MARITIME,30,3,33,2,160,2,162,197
2021,76410,MAROMME,200023414,METROPOLE ROUEN NORMANDIE,76,SEINE MARITIME,50,6,56,0,164,1,165,221
2021,76681,SOTTEVILLE LES ROUEN,200023414,METROPOLE ROUEN NORMANDIE,76,SEINE MARITIME,176,22,198,14,393,9,402,614
2021,76108,BOIS GUILLAUME,200023414,METROPOLE ROUEN NORMANDIE,76,SEINE MARITIME,186,23,209,0,98,18,116,325
2021,76114,BOLBEC,200010700,CA CAUX SEINE AGGLO,76,SEINE MARITIME,38,1,39,18,162,0,162,219
2021,77243,LAGNY SUR MARNE,247700594,CA MARNE ET GONDOIRE,77,SEINE ET MARNE,99,25,124,0,268,4,272,396
2021,77122,COMBS LA VILLE,200059228,CA GRAND PARIS SUD SEINE ESSONNE SENART,77,SEINE ET MARNE,163,3,166,19,332,8,340,525
2021,77083,CHAMPS SUR MARNE,200057958,CA PARIS - VALLEE DE LA MARNE,77,SEINE ET MARNE,278,5,283,0,212,4,216,499
2021,77258,LOGNES,200057958,CA PARIS - VALLEE DE LA MARNE,77,SEINE ET MARNE,207,2,209,0,126,4,130,339
2021,77514,VILLEPARISIS,200055655,CA ROISSY PAYS DE FRANCE,77,SEINE ET MARNE,138,11,149,0,394,5,399,548
2021,77152,DAMMARIE LES LYS,247700057,CA MELUN VAL DE SEINE,77,SEINE ET MARNE,220,2,222,1,226,5,231,454
2021,77053,BRIE COMTE ROBERT,247700644,CC L'OREE DE LA BRIE,77,SEINE ET MARNE,139,4,143,8,289,9,298,448
2021,77067,CESSON,200059228,CA GRAND PARIS SUD SEINE ESSONNE SENART,77,SEINE ET MARNE,163,3,166,5,101,8,109,280
2021,77153,DAMMARTIN EN GOELE,200055655,CA ROISSY PAYS DE FRANCE,77,SEINE ET MARNE,40,13,53,0,173,3,176,229
2021,78073,BOIS D ARCY,247800584,CA VERSAILLES GRAND PARC (CAVGP),78,YVELINES,222,4,226,0,148,10,158,384
2021,78423,MONTIGNY LE BRETONNEUX,200058782,CA DE SAINT QUENTIN EN YVELINES,78,YVELINES,526,8,534,4,331,15,346,884
2021,78498,POISSY,200059889,CU GRAND PARIS SEINE ET OISE,78,YVELINES,638,107,745,0,308,27,335,1080
2021,78335,LIMAY,200059889,CU GRAND PARIS SEINE ET OISE,78,YVELINES,135,22,157,0,174,7,181,338
2021,78362,MANTES LA VILLE,200059889,CU GRAND PARIS SEINE ET OISE,78,YVELINES,100,67,167,14,205,9,214,395
2021,78172,CONFLANS SAINTE HONORINE,200059889,CU GRAND PARIS SEINE ET OISE,78,YVELINES,331,46,377,0,392,20,412,789
2021,78643,VERNOUILLET,200059889,CU GRAND PARIS SEINE ET OISE,78,YVELINES,82,22,104,26,91,8,99,229
2021,78624,TRIEL SUR SEINE,200059889,CU GRAND PARIS SEINE ET OISE,78,YVELINES,45,38,83,0,160,8,168,251
2021,78686,VIROFLAY,247800584,CA VERSAILLES GRAND PARC (CAVGP),78,YVELINES,222,30,252,1,88,80,168,421
2021,78311,HOUILLES,200058519,CA SAINT GERMAIN BOUCLES DE SEINE,78,YVELINES,290,109,399,1,449,53,502,902
2021,78674,VILLEPREUX,200058782,CA DE SAINT QUENTIN EN YVELINES,78,YVELINES,95,54,149,0,155,7,162,312
2021,78165,LES CLAYES SOUS BOIS,200058782,CA DE SAINT QUENTIN EN YVELINES,78,YVELINES,163,34,197,2,181,4,185,384
2021,78190,CROISSY SUR SEINE,200058519,CA SAINT GERMAIN BOUCLES DE SEINE,78,YVELINES,124,7,131,0,33,27,60,191
2021,80001,ABBEVILLE,200070993,CA DE LA BAIE DE SOMME,80,SOMME,54,21,75,52,270,3,273,400
2021,81065,CASTRES,248100430,CA DE CASTRES MAZAMET,81,TARN,276,43,319,54,177,19,196,569
2021,81004,ALBI,248100737,CA DE L'ALBIGEOIS (C2A),81,TARN,378,62,440,35,215,19,234,709
2021,82121,MONTAUBAN,248200099,CA GRAND MONTAUBAN,82,TARN ET GARONNE,464,49,513,75,461,21,482,1070
2021,83071,LA LONDE LES MAURES,200027100,CC MEDITERRANEE PORTE DES MAURES,83,VAR,86,2,88,0,43,1,44,132
2021,83107,ROQUEBRUNE SUR ARGENS,200035319,CA ESTEREL COTE D'AZUR AGGLOMERATION,83,VAR,94,3,97,0,133,14,147,244
2021,83129,SIX FOURS LES PLAGES,248300543,METROPOLE TOULON-PROVENCE-MEDITERRANEE,83,VAR,243,73,316,1,232,26,258,575
2021,83126,LA SEYNE SUR MER,248300543,METROPOLE TOULON-PROVENCE-MEDITERRANEE,83,VAR,388,128,516,87,386,28,414,1017
2021,83023,BRIGNOLES,200068104,CA DE LA PROVENCE VERTE,83,VAR,119,5,124,2,172,5,177,303
2021,83148,VIDAUBAN,248300493,CA DRACENIE PROVENCE VERDON AGGLOMERATION,83,VAR,20,4,24,0,120,0,120,144
2021,83116,SAINT MAXIMIN LA SAINTE BAUME,200068104,CA DE LA PROVENCE VERTE,83,VAR,146,20,166,0,180,6,186,352
2021,83115,SAINTE MAXIME,200036077,CC DU GOLFE DE SAINT-TROPEZ,83,VAR,135,0,135,0,48,2,50,185
2021,83050,DRAGUIGNAN,248300493,CA DRACENIE PROVENCE VERDON AGGLOMERATION,83,VAR,236,16,252,19,271,19,290,561
2021,83137,TOULON,248300543,METROPOLE TOULON-PROVENCE-MEDITERRANEE,83,VAR,1224,113,1337,332,941,196,1137,2806
2021,83144,LA VALETTE DU VAR,248300543,METROPOLE TOULON-PROVENCE-MEDITERRANEE,83,VAR,163,27,190,1,173,8,181,372
2021,83118,SAINT RAPHAEL,200035319,CA ESTEREL COTE D'AZUR AGGLOMERATION,83,VAR,227,18,245,21,126,11,137,404
2021,83098,LE PRADET,248300543,METROPOLE TOULON-PROVENCE-MEDITERRANEE,83,VAR,76,12,88,4,101,11,112,204
2021,84003,APT,200040624,CC PAYS D'APT-LUBERON,84,VAUCLUSE,80,0,80,31,72,0,72,183
2021,84092,LE PONTET,248400251,CA DU GRAND AVIGNON (COGA),84,VAUCLUSE,67,16,83,0,134,2,136,219
2021,84054,L'ISLE SUR LA SORGUE,248400319,CC DU PAYS DES SORGUES ET DES MONTS DE VAUCLUSE,84,VAUCLUSE,105,14,119,0,135,3,138,257
2021,84141,VEDENE,248400251,CA DU GRAND AVIGNON (COGA),84,VAUCLUSE,65,25,90,0,147,4,151,241
2021,84129,SORGUES,248400293,CA DES SORGUES DU COMTAT,84,VAUCLUSE,100,45,145,13,143,1,144,302
2021,85191,LA ROCHE SUR YON,248500589,CA LA ROCHE SUR YON - AGGLOMERATION,85,VENDEE,380,52,432,102,538,24,562,1096
2021,85109,LES HERBIERS,248500621,CC DU PAYS DES HERBIERS,85,VENDEE,61,47,108,27,284,6,290,425
2021,85226,SAINT HILAIRE DE RIEZ,200023778,CA DU PAYS DE SAINT-GILLES-CROIX-DE-VIE,85,VENDEE,35,1,36,28,166,1,167,232
2021,85146,MONTAIGU VENDEE,200070233,CA TERRES DE MONTAIGU,85,VENDEE,98,24,122,20,428,5,433,574
2021,86194,POITIERS,200069854,CU DU GRAND POITIERS,86,VIENNE,652,9,661,60,543,47,590,1311
2021,86041,BUXEROLLES,200069854,CU DU GRAND POITIERS,86,VIENNE,30,4,34,0,144,3,147,181
2021,87114,PANAZOL,248719312,CU LIMOGES METROPOLE,87,HAUTE VIENNE,38,13,51,0,139,5,144,195
2021,88160,EPINAL,200068757,CA D'EPINAL,88,VOSGES,225,9,234,64,268,7,275,574
2021,91326,JUVISY SUR ORGE,200054781,METROPOLE DU GRAND PARIS,91,ESSONNE,150,27,177,0,153,13,166,343
2021,91027,ATHIS MONS,200054781,METROPOLE DU GRAND PARIS,91,ESSONNE,298,37,335,59,374,11,385,779
2021,91377,MASSY,200056232,CA COMMUNAUTE PARIS-SACLAY,91,ESSONNE,892,79,971,21,642,29,671,1663
2021,91570,SAINT MICHEL SUR ORGE,200057859,CA COEUR D'ESSONNE AGGLOMERATION,91,ESSONNE,156,18,174,2,242,3,245,421
2021,91086,BONDOUFLE,200059228,CA GRAND PARIS SUD SEINE ESSONNE SENART,91,ESSONNE,110,12,122,0,139,7,146,268
2021,91573,SAINT PIERRE DU PERRAY,200059228,CA GRAND PARIS SUD SEINE ESSONNE SENART,91,ESSONNE,97,7,104,0,225,5,230,334
2021,91589,SAVIGNY SUR ORGE,200054781,METROPOLE DU GRAND PARIS,91,ESSONNE,222,26,248,17,446,17,463,728
2021,91235,FLEURY MEROGIS,200057859,CA COEUR D'ESSONNE AGGLOMERATION,91,ESSONNE,114,10,124,0,117,3,120,245
2021,92072,SEVRES,200054781,METROPOLE DU GRAND PARIS,92,HAUTS DE SEINE,309,28,337,0,173,44,217,554
2021,92048,MEUDON,200054781,METROPOLE DU GRAND PARIS,92,HAUTS DE SEINE,667,32,699,9,267,130,397,1105
2021,92002,ANTONY,200054781,METROPOLE DU GRAND PARIS,92,HAUTS DE SEINE,833,56,889,7,438,147,585,1481
2021,92007,BAGNEUX,200054781,METROPOLE DU GRAND PARIS,92,HAUTS DE SEINE,500,46,546,74,337,42,379,999
2021,92023,CLAMART,200054781,METROPOLE DU GRAND PARIS,92,HAUTS DE SEINE,634,126,760,33,260,151,411,1205
2021,92075,VANVES,200054781,METROPOLE DU GRAND PARIS,92,HAUTS DE SEINE,353,9,362,10,155,59,214,585
2021,92050,NANTERRE,200054781,METROPOLE DU GRAND PARIS,92,HAUTS DE SEINE,1429,57,1486,138,701,140,841,2465
2021,92051,NEUILLY SUR SEINE,200054781,METROPOLE DU GRAND PARIS,92,HAUTS DE SEINE,779,52,831,30,29,659,688,1549
2021,92019,CHATENAY MALABRY,200054781,METROPOLE DU GRAND PARIS,92,HAUTS DE SEINE,416,15,431,45,204,45,249,724
2021,93057,LES PAVILLONS SOUS BOIS,200054781,METROPOLE DU GRAND PARIS,93,SEINE SAINT DENIS,267,15,282,18,119,27,146,445
2021,93050,NEUILLY SUR MARNE,200054781,METROPOLE DU GRAND PARIS,93,SEINE SAINT DENIS,399,20,419,40,309,17,326,785
2021,93031,EPINAY SUR SEINE,200054781,METROPOLE DU GRAND PARIS,93,SEINE SAINT DENIS,459,12,471,92,255,30,285,847
2021,93070,SAINT OUEN SUR SEINE,200054781,METROPOLE DU GRAND PARIS,93,SEINE SAINT DENIS,557,69,626,45,386,175,561,1232
2021,93078,VILLEPINTE,200054781,METROPOLE DU GRAND PARIS,93,SEINE SAINT DENIS,270,5,275,0,180,6,186,461
2021,93072,STAINS,200054781,METROPOLE DU GRAND PARIS,93,SEINE SAINT DENIS,341,15,356,35,118,13,131,522
2021,93053,NOISY LE SEC,200054781,METROPOLE DU GRAND PARIS,93,SEINE SAINT DENIS,315,6,321,12,208,32,240,573
2021,93027,LA COURNEUVE,200054781,METROPOLE DU GRAND PARIS,93,SEINE SAINT DENIS,326,2,328,51,116,18,134,513
2021,93048,MONTREUIL,200054781,METROPOLE DU GRAND PARIS,93,SEINE SAINT DENIS,1223,166,1389,67,675,420,1095,2551
2021,94015,BRY SUR MARNE,200054781,METROPOLE DU GRAND PARIS,94,VAL DE MARNE,299,18,317,3,95,34,129,449
2021,94034,FRESNES,200054781,METROPOLE DU GRAND PARIS,94,VAL DE MARNE,304,31,335,0,214,11,225,560
2021,94071,SUCY EN BRIE,200054781,METROPOLE DU GRAND PARIS,94,VAL DE MARNE,160,21,181,0,211,25,236,417
2021,94069,SAINT MAURICE,200054781,METROPOLE DU GRAND PARIS,94,VAL DE MARNE,232,20,252,0,67,54,121,373
2021,94044,LIMEIL BREVANNES,200054781,METROPOLE DU GRAND PARIS,94,VAL DE MARNE,287,22,309,18,235,15,250,577
2021,94046,MAISONS ALFORT,200054781,METROPOLE DU GRAND PARIS,94,VAL DE MARNE,630,63,693,0,450,143,593,1286
2021,94042,JOINVILLE LE PONT,200054781,METROPOLE DU GRAND PARIS,94,VAL DE MARNE,266,23,289,0,124,45,169,458
2021,94019,CHENNEVIERES SUR MARNE,200054781,METROPOLE DU GRAND PARIS,94,VAL DE MARNE,340,8,348,0,108,16,124,472
2021,94080,VINCENNES,200054781,METROPOLE DU GRAND PARIS,94,VAL DE MARNE,983,93,1076,7,185,322,507,1590
2021,94017,CHAMPIGNY SUR MARNE,200054781,METROPOLE DU GRAND PARIS,94,VAL DE MARNE,599,70,669,90,532,43,575,1334
2021,94037,GENTILLY,200054781,METROPOLE DU GRAND PARIS,94,VAL DE MARNE,261,7,268,62,69,25,94,424
2021,95539,SAINT BRICE SOUS FORET,200056380,CA PLAINE VALLEE,95,VAL D OISE,102,21,123,0,166,26,192,315
2021,95252,FRANCONVILLE,200058485,CA VAL PARISIS,95,VAL D OISE,310,18,328,0,437,23,460,788
2021,95277,GONESSE,200055655,CA ROISSY PAYS DE FRANCE,95,VAL D OISE,319,0,319,28,106,5,111,458
2021,95680,VILLIERS LE BEL,200055655,CA ROISSY PAYS DE FRANCE,95,VAL D OISE,185,2,187,24,136,4,140,352
2021,95572,SAINT OUEN L AUMONE,249500109,CA DE CERGY-PONTOISE,95,VAL D OISE,236,35,271,25,257,7,264,560
2021,95199,DOMONT,200056380,CA PLAINE VALLEE,95,VAL D OISE,120,28,148,0,168,6,174,322
2021,95197,DEUIL LA BARRE,200056380,CA PLAINE VALLEE,95,VAL D OISE,80,38,118,0,299,13,312,429
2021,95598,SOISY SOUS MONTMORENCY,200056380,CA PLAINE VALLEE,95,VAL D OISE,92,25,117,9,181,13,194,320
2021,95555,SAINT GRATIEN,200056380,CA PLAINE VALLEE,95,VAL D OISE,178,9,187,0,190,18,208,395
2021,95019,ARNOUVILLE,200055655,CA ROISSY PAYS DE FRANCE,95,VAL D OISE,110,2,112,3,59,2,61,176
2021,95476,OSNY,249500109,CA DE CERGY-PONTOISE,95,VAL D OISE,152,34,186,5,162,2,164,355
2021,95313,L'ISLE ADAM,249500455,CC DE LA VALLEE DE L'OISE ET DES TROIS FORETS,95,VAL D OISE,64,33,97,4,108,8,116,218
2021,95351,LOUVRES,200055655,CA ROISSY PAYS DE FRANCE,95,VAL D OISE,104,1,105,0,88,5,93,198
2021,95203,EAUBONNE,200058485,CA VAL PARISIS,95,VAL D OISE,362,10,372,1,345,22,367,741
2021,95218,ERAGNY,249500109,CA DE CERGY-PONTOISE,95,VAL D OISE,101,39,140,0,265,9,274,414
2021,97115,LAMENTIN,249710062,CA DU NORD BASSE-TERRE,971,GUADELOUPE,56,22,78,42,114,10,124,244
2021,97120,POINTE A PITRE,200018653,CA CAP EXCELLENCE,971,GUADELOUPE,190,6,196,28,37,1,38,261
2021,97103,BAIE MAHAULT,200018653,CA CAP EXCELLENCE,971,GUADELOUPE,167,85,252,63,255,12,267,582
2021,97113,LE GOSIER,200041507,CA LA RIVIERA DU LEVANT,971,GUADELOUPE,175,63,238,80,129,13,142,460
2021,97124,SAINT CLAUDE,249710070,CA GRAND SUD CARAIBE,971,GUADELOUPE,40,14,54,20,42,1,43,116
2021,97229,SCHOELCHER,249720061,CA DU CENTRE DE LA MARTINIQUE,972,MARTINIQUE,172,9,181,46,68,9,77,304
2021,97228,SAINTE MARIE,200041788,CA DU PAYS NORD MARTINIQUE,972,MARTINIQUE,42,28,70,37,40,4,44,151
2021,97220,RIVIERE PILOTE,249720053,CA DE L'ESPACE SUD DE LA MARTINIQUE,972,MARTINIQUE,35,13,48,35,27,5,32,115
2021,97230,LA TRINITE,200041788,CA DU PAYS NORD MARTINIQUE,972,MARTINIQUE,100,13,113,21,33,6,39,173
2021,97307,MATOURY,249730045,CA DU CENTRE LITTORAL,973,GUYANE,396,3,399,4,48,10,58,461
2021,97305,MACOURIA,249730045,CA DU CENTRE LITTORAL,973,GUYANE,80,2,82,2,31,11,42,126
2021,97302,CAYENNE,249730045,CA DU CENTRE LITTORAL,973,GUYANE,616,33,649,12,137,17,154,815
2021,97414,SAINT LOUIS,249740077,CA CIVIS (COMMUNAUTE INTERCOMMUNALE DES VILLES SOLIDAIRES),974,LA REUNION,250,97,347,123,249,68,317,786
2021,97412,SAINT JOSEPH,249740085,CA DU SUD,974,LA REUNION,157,139,296,18,86,22,108,422
2021,97418,SAINTE MARIE,249740119,CA INTERCOMMUNALE DU NORD DE LA REUNION (CINOR),974,LA REUNION,420,227,647,5,163,25,188,840
2021,97404,L'ETANG SALE,249740077,CA CIVIS (COMMUNAUTE INTERCOMMUNALE DES VILLES SOLIDAIRES),974,LA REUNION,60,68,128,0,149,22,171,300
2021,97415,SAINT PAUL,249740101,CA TERRITOIRE DE LA COTE OUEST (TCO),974,LA REUNION,445,541,986,273,433,89,522,1781
2021,97420,SAINTE SUZANNE,249740119,CA INTERCOMMUNALE DU NORD DE LA REUNION (CINOR),974,LA REUNION,221,104,325,15,102,16,118,458
2021,97801,SAINT-MARTIN,XX,XX,978,COLLECTIVITE D'OUTRE MER SAINT MARTIN,96,0,96,149,95,8,103,348
2022,01004,AMBERIEU EN BUGEY,240100883,CC DE LA PLAINE DE L'AIN,01,AIN,98,5,103,0,280,2,282,386
2022,01249,MIRIBEL,240100800,CC DE MIRIBEL ET DU PLATEAU,01,AIN,102,13,115,10,146,5,151,276
2022,01283,OYONNAX,200042935,CA HAUT - BUGEY AGGLOMERATION,01,AIN,54,18,72,87,155,1,156,315
2022,02168,CHATEAU THIERRY,200072031,CA DE LA REGION DE CHATEAU-THIERRY,02,AISNE,102,11,113,27,167,6,173,312
2022,02722,SOISSONS,240200477,CA GRANDSOISSONS AGGLOMERATION,02,AISNE,139,42,181,47,218,7,225,453
2022,03185,MONTLUCON,200071082,CA MONTLUCON COMMUNAUTE,03,ALLIER,135,0,135,59,329,9,338,532
2022,03310,VICHY,200071363,CA VICHY COMMUNAUTE,03,ALLIER,165,0,165,51,171,7,178,394
2022,03321,YZEURE,200071140,CA MOULINS COMMUNAUTE,03,ALLIER,100,0,100,7,105,5,110,217
2022,05023,BRIANCON,240500439,CC DU BRIANCONNAIS,05,HAUTES ALPES,105,3,108,7,52,4,56,171
2022,05061,GAP,200067825,CA GAP-TALLARD-DURANCE,05,HAUTES ALPES,322,15,337,17,256,6,262,616
2022,06004,ANTIBES,240600585,CA DE SOPHIA ANTIPOLIS,06,ALPES MARITIMES,450,108,558,10,717,51,768,1336
2022,06027,CAGNES SUR MER,200030195,METROPOLE NICE COTE D'AZUR,06,ALPES MARITIMES,390,47,437,0,399,22,421,858
2022,06030,LE CANNET,200039915,CA CANNES PAYS DE LERINS,06,ALPES MARITIMES,276,60,336,14,256,17,273,623
2022,06069,GRASSE,200039857,CA DU PAYS DE GRASSE,06,ALPES MARITIMES,448,28,476,5,413,15,428,909
2022,06088,NICE,200030195,METROPOLE NICE COTE D'AZUR,06,ALPES MARITIMES,3045,188,3233,312,1693,256,1949,5495
2022,06104,ROQUEBRUNE CAP MARTIN,240600551,CA DE LA RIVIERA FRANCAISE,06,ALPES MARITIMES,134,5,139,10,64,2,66,215
2022,06161,VILLENEUVE LOUBET,240600585,CA DE SOPHIA ANTIPOLIS,06,ALPES MARITIMES,142,9,151,0,132,9,141,292
2022,07010,ANNONAY,200072015,CA ANNONAY RHONE AGGLO,07,ARDECHE,152,19,171,38,74,3,77,287
2022,07102,GUILHERAND GRANGES,200041366,CC RHONE CRUSSOL,07,ARDECHE,73,27,100,10,135,2,137,247
2022,08409,SEDAN,200041630,CA ARDENNE METROPOLE,08,ARDENNES,62,34,96,57,58,1,59,211
2022,10387,TROYES,200069250,CA TROYES CHAMPAGNE METROPOLE,10,AUBE,473,4,477,115,285,33,318,910
2022,11262,NARBONNE,241100593,CA LE GRAND NARBONNE,11,AUDE,273,46,319,91,289,24,313,723
2022,12145,MILLAU,241200567,CC DE MILLAU GRANDS CAUSSES,12,AVEYRON,121,0,121,58,175,2,177,356
2022,13005,AUBAGNE,200054807,METROPOLE D'AIX-MARSEILLE-PROVENCE,13,BOUCHES DU RHONE,307,57,364,30,355,23,378,772
2022,13007,AURIOL,200054807,METROPOLE D'AIX-MARSEILLE-PROVENCE,13,BOUCHES DU RHONE,59,11,70,0,105,4,109,179
2022,13014,BERRE L ETANG,200054807,METROPOLE D'AIX-MARSEILLE-PROVENCE,13,BOUCHES DU RHONE,68,14,82,15,54,0,54,151
2022,13015,BOUC BEL AIR,200054807,METROPOLE D'AIX-MARSEILLE-PROVENCE,13,BOUCHES DU RHONE,129,42,171,0,134,14,148,320
2022,13039,FOS SUR MER,200054807,METROPOLE D'AIX-MARSEILLE-PROVENCE,13,BOUCHES DU RHONE,150,4,154,0,89,4,93,247
2022,13040,FUVEAU,200054807,METROPOLE D'AIX-MARSEILLE-PROVENCE,13,BOUCHES DU RHONE,75,21,96,0,118,2,120,216
2022,13047,ISTRES,200054807,METROPOLE D'AIX-MARSEILLE-PROVENCE,13,BOUCHES DU RHONE,491,29,520,5,294,13,307,832
2022,13071,LES PENNES MIRABEAU,200054807,METROPOLE D'AIX-MARSEILLE-PROVENCE,13,BOUCHES DU RHONE,149,57,206,14,117,5,122,341
2022,13075,PLAN DE CUQUES,200054807,METROPOLE D'AIX-MARSEILLE-PROVENCE,13,BOUCHES DU RHONE,102,18,120,0,74,4,78,199
2022,13077,PORT DE BOUC,200054807,METROPOLE D'AIX-MARSEILLE-PROVENCE,13,BOUCHES DU RHONE,148,4,152,67,76,1,77,297
2022,13108,TARASCON,241300417,CA D'ARLES-CRAU-CAMARGUE-MONTAGNETTE,13,BOUCHES DU RHONE,85,3,88,8,44,2,46,142
2022,13110,TRETS,200054807,METROPOLE D'AIX-MARSEILLE-PROVENCE,13,BOUCHES DU RHONE,103,24,127,0,87,4,91,217
2022,13203,MARSEILLE 3E ARRONDISSEMENT,200054807,METROPOLE D'AIX-MARSEILLE-PROVENCE,13,BOUCHES DU RHONE,401,36,437,90,104,18,122,648
2022,13208,MARSEILLE 8E ARRONDISSEMENT,200054807,METROPOLE D'AIX-MARSEILLE-PROVENCE,13,BOUCHES DU RHONE,777,257,1034,0,596,230,826,1860
2022,13209,MARSEILLE 9E ARRONDISSEMENT,200054807,METROPOLE D'AIX-MARSEILLE-PROVENCE,13,BOUCHES DU RHONE,927,136,1063,24,459,91,550,1637
2022,13214,MARSEILLE 14E ARRONDISSEMENT,200054807,METROPOLE D'AIX-MARSEILLE-PROVENCE,13,BOUCHES DU RHONE,430,22,452,115,151,22,173,741
2022,13215,MARSEILLE 15E ARRONDISSEMENT,200054807,METROPOLE D'AIX-MARSEILLE-PROVENCE,13,BOUCHES DU RHONE,732,32,764,249,182,24,206,1219
2022,13216,MARSEILLE 16E ARRONDISSEMENT,200054807,METROPOLE D'AIX-MARSEILLE-PROVENCE,13,BOUCHES DU RHONE,227,15,242,34,37,5,42,318
2022,14762,VIRE NORMANDIE,200068799,CC INTERCOM DE LA VIRE AU NOIREAU,14,CALVADOS,44,0,44,29,227,2,229,302
2022,16102,COGNAC,200070514,CA DU GRAND COGNAC,16,CHARENTE,127,2,129,46,123,16,139,314
2022,17415,SAINTES,200036473,CA DE SAINTES,17,CHARENTE MARITIME,162,0,162,12,257,14,271,445
2022,19031,BRIVE LA GAILLARDE,200043172,CA DU BASSIN DE BRIVE,19,CORREZE,350,15,365,96,281,38,319,780
2022,19272,TULLE,241927201,CA TULLE AGGLO,19,CORREZE,136,0,136,37,79,4,83,257
2022,21171,CHEVIGNY SAINT SAUVEUR,242100410,DIJON METROPOLE,21,COTE D OR,36,10,46,9,169,4,173,228
2022,21231,DIJON,242100410,DIJON METROPOLE,21,COTE D OR,1570,271,1841,153,879,125,1004,2997
2022,22050,DINAN,200068989,CA DINAN AGGLOMERATION,22,COTES D ARMOR,65,6,71,27,77,4,81,179
2022,22215,PLOUFRAGAN,200069409,CA SAINT-BRIEUC ARMOR AGGLOMERATION,22,COTES D ARMOR,70,2,72,21,173,8,181,274
2022,24037,BERGERAC,200070647,CA BERGERACOISE,24,DORDOGNE,155,0,155,58,149,12,161,374
2022,24053,BOULAZAC ISLE MANOIRE,200040392,CA LE GRAND PERIGUEUX,24,DORDOGNE,83,2,85,15,112,8,120,220
2022,25462,PONTARLIER,242500338,CC DU GRAND PONTARLIER,25,DOUBS,123,14,137,0,173,3,176,314
2022,26198,MONTELIMAR,200040459,CA MONTELIMAR AGGLOMERATION,26,DROME,157,69,226,23,347,10,357,605
2022,26281,ROMANS SUR ISERE,200068781,CA VALENCE ROMANS AGGLO,26,DROME,193,14,207,43,298,13,311,561
2022,27701,VAL DE REUIL,200089456,CA SEINE-EURE,27,EURE,150,0,150,47,94,3,97,294
2022,28218,LUCE,200033181,CA CHARTRES METROPOLE,28,EURE ET LOIR,88,7,95,1,173,5,178,274
2022,28229,MAINVILLIERS,200033181,CA CHARTRES METROPOLE,28,EURE ET LOIR,84,4,88,35,122,2,124,247
2022,29103,LANDERNEAU,242900801,CA DU PAYS DE LANDERNEAU-DAOULAS,29,FINISTERE,60,0,60,59,265,7,272,391
2022,29189,PLOUGASTEL DAOULAS,242900314,BREST METROPOLE,29,FINISTERE,56,1,57,44,254,14,268,369
2022,29212,PLOUZANE,242900314,BREST METROPOLE,29,FINISTERE,48,1,49,40,248,3,251,340
2022,29232,QUIMPER,200068120,CA QUIMPER BRETAGNE OCCIDENTALE,29,FINISTERE,285,17,302,191,708,23,731,1223
2022,29233,QUIMPERLE,242900694,CA QUIMPERLE COMMUNAUTE,29,FINISTERE,43,9,52,32,179,4,183,266
2022,30007,ALES,200066918,CA ALES AGGLOMERATION,30,GARD,181,5,186,93,227,15,242,521
2022,30028,BAGNOLS SUR CEZE,200034692,CA DU GARD RHODANIEN,30,GARD,120,6,126,12,86,3,89,226
2022,30032,BEAUCAIRE,243000585,CC BEAUCAIRE TERRE D'ARGENCE,30,GARD,120,2,122,20,100,4,104,246
2022,30189,NIMES,243000643,CA DE NIMES METROPOLE,30,GARD,1170,15,1185,137,601,98,699,2020
2022,30202,PONT SAINT ESPRIT,200034692,CA DU GARD RHODANIEN,30,GARD,60,9,69,15,83,0,83,166
2022,31483,SAINT GAUDENS,200072643,CC COEUR ET COTEAUX DU COMMINGES,31,HAUTE GARONNE,106,0,106,14,68,0,68,188
2022,31557,TOURNEFEUILLE,243100518,TOULOUSE METROPOLE,31,HAUTE GARONNE,229,26,255,0,301,24,325,580
2022,31561,L'UNION,243100518,TOULOUSE METROPOLE,31,HAUTE GARONNE,107,8,115,0,146,7,153,268
2022,33003,AMBARES ET LAGRAVE,243300316,BORDEAUX METROPOLE,33,GIRONDE,102,32,134,6,275,3,278,418
2022,33039,BEGLES,243300316,BORDEAUX METROPOLE,33,GIRONDE,218,51,269,5,393,23,416,690
2022,33063,BORDEAUX,243300316,BORDEAUX METROPOLE,33,GIRONDE,3266,476,3742,118,1962,599,2561,6421
2022,33069,LE BOUSCAT,243300316,BORDEAUX METROPOLE,33,GIRONDE,237,68,305,0,235,51,286,591
2022,33119,CENON,243300316,BORDEAUX METROPOLE,33,GIRONDE,58,57,115,49,296,13,309,473
2022,33122,CESTAS,243301165,CC JALLE-EAU-BOURDE,33,GIRONDE,90,9,99,0,206,3,209,308
2022,33192,GRADIGNAN,243300316,BORDEAUX METROPOLE,33,GIRONDE,221,14,235,12,195,16,211,458
2022,33249,LORMONT,243300316,BORDEAUX METROPOLE,33,GIRONDE,188,36,224,29,257,11,268,521
2022,33281,MERIGNAC,243300316,BORDEAUX METROPOLE,33,GIRONDE,600,163,763,0,992,72,1064,1828
2022,33318,PESSAC,243300316,BORDEAUX METROPOLE,33,GIRONDE,523,105,628,26,796,30,826,1480
2022,33519,LE TAILLAN MEDOC,243300316,BORDEAUX METROPOLE,33,GIRONDE,41,39,80,0,184,4,188,267
2022,34032,BEZIERS,243400769,CA DE BEZIERS-MEDITERRANEE,34,HERAULT,337,46,383,96,407,22,429,909
2022,34108,FRONTIGNAN,200066355,CA SETE AGGLOPOLE MEDITERRANEE,34,HERAULT,112,27,139,20,163,8,171,330
2022,34123,JUVIGNAC,243400017,MONTPELLIER MEDITERRANEE METROPOLE,34,HERAULT,100,16,116,0,126,15,141,258
2022,34154,MAUGUIO,243400470,CA DU PAYS DE L'OR,34,HERAULT,175,5,180,6,205,4,209,395
2022,34301,SETE,200066355,CA SETE AGGLOPOLE MEDITERRANEE,34,HERAULT,214,54,268,51,167,21,188,506
2022,35051,CESSON SEVIGNE,243500139,RENNES METROPOLE,35,ILLE ET VILAINE,250,37,287,20,168,13,181,488
2022,35069,CHATEAUGIRON,243500659,CC PAYS DE CHATEAUGIRON COMMUNAUTE,35,ILLE ET VILAINE,35,25,60,45,263,2,265,370
2022,35115,FOUGERES,200072452,CA FOUGERES AGGLOMERATION,35,ILLE ET VILAINE,72,26,98,67,168,7,175,340
2022,35210,PACE,243500139,RENNES METROPOLE,35,ILLE ET VILAINE,60,10,70,6,151,4,155,232
2022,36044,CHATEAUROUX,243600327,CA CHATEAUROUX METROPOLE,36,INDRE,273,28,301,54,446,6,452,807
2022,37109,FONDETTES,243700754,TOURS METROPOLE VAL DE LOIRE,37,INDRE ET LOIRE,70,4,74,0,171,7,178,252
2022,37214,SAINT CYR SUR LOIRE,243700754,TOURS METROPOLE VAL DE LOIRE,37,INDRE ET LOIRE,85,26,111,3,172,11,183,297
2022,38085,CHARVIEU CHAVAGNEUX,243800935,CC LYON-SAINT-EXUPERY EN DAUPHINE,38,ISERE,20,49,69,0,204,2,206,275
2022,38382,SAINT EGREVE,200040715,GRENOBLE-ALPES-METROPOLE,38,ISERE,209,12,221,0,239,6,245,466
2022,39198,DOLE,200010650,CA DU GRAND DOLE,39,JURA,173,0,173,42,181,10,191,406
2022,39300,LONS LE SAUNIER,200071116,CA ECLA  (ESPACE COMMUNAUTAIRE LONS AGGLOMERATION),39,JURA,160,13,173,24,103,5,108,305
2022,40088,DAX,244000675,CA DU GRAND DAX,40,LANDES,202,3,205,35,114,20,134,374
2022,41018,BLOIS,200030385,CA DE BLOIS ''AGGLOPOLYS'',41,LOIR ET CHER,340,42,382,90,424,7,431,903
2022,41269,VENDOME,200072072,CA TERRITOIRES VENDOMOIS,41,LOIR ET CHER,120,1,121,11,173,2,175,308
2022,42279,SAINT JUST SAINT RAMBERT,200065886,CA LOIRE FOREZ AGGLOMERATION (LFA),42,LOIRE,111,6,117,0,176,6,182,299
2022,44003,ANCENIS SAINT GEREON,244400552,CC DU PAYS D'ANCENIS,44,LOIRE ATLANTIQUE,40,10,50,11,196,6,202,263
2022,44035,LA CHAPELLE SUR ERDRE,244400404,NANTES METROPOLE,44,LOIRE ATLANTIQUE,168,21,189,0,278,13,291,480
2022,44143,REZE,244400404,NANTES METROPOLE,44,LOIRE ATLANTIQUE,227,82,309,16,723,39,762,1086
2022,44215,VERTOU,244400404,NANTES METROPOLE,44,LOIRE ATLANTIQUE,120,93,213,1,412,18,430,644
2022,45075,LA CHAPELLE SAINT MESMIN,244500468,ORLEANS METROPOLE,45,LOIRET,59,24,83,0,128,2,130,213
2022,45234,ORLEANS,244500468,ORLEANS METROPOLE,45,LOIRET,1050,153,1203,124,878,92,970,2297
2022,49015,AVRILLE,244900015,CU ANGERS LOIRE METROPOLE,49,MAINE ET LOIRE,57,46,103,15,214,13,227,345
2022,49125,DOUE EN ANJOU,200071876,CA SAUMUR VAL DE LOIRE,49,MAINE ET LOIRE,20,7,27,6,138,1,139,171
2022,49307,LOIRE AUTHION,244900015,CU ANGERS LOIRE METROPOLE,49,MAINE ET LOIRE,30,38,68,21,237,4,241,330
2022,51573,TINQUEUX,200067213,CU DU GRAND REIMS,51,MARNE,81,42,123,1,151,5,156,280
2022,52121,CHAUMONT,200068658,CA DE CHAUMONT,52,HAUTE MARNE,112,12,124,59,270,0,270,453
2022,54323,LONGWY,245400262,CA GRAND LONGWY AGGLOMERATION,54,MEURTHE ET MOSELLE,85,0,85,22,54,0,54,161
2022,54482,SAINT MAX,245400676,METROPOLE DU GRAND NANCY,54,MEURTHE ET MOSELLE,54,8,62,0,85,11,96,158
2022,54580,VILLERUPT,245701404,CC DU PAYS HAUT VAL D'ALZETTE,54,MEURTHE ET MOSELLE,30,1,31,0,18,1,19,50
2022,57019,AMNEVILLE,245701271,CC DU PAYS ORNE MOSELLE,57,MOSELLE,60,19,79,16,143,2,145,239
2022,57606,SAINT AVOLD,200067502,CA SAINT-AVOLD SYNERGIE,57,MOSELLE,44,5,49,4,125,0,125,178
2022,57631,SARREGUEMINES,200070746,CA SARREGUEMINES CONFLUENCES,57,MOSELLE,210,0,210,23,58,2,60,293
2022,57660,STIRING WENDEL,245700372,CA DE FORBACH PORTE DE FRANCE,57,MOSELLE,40,0,40,19,37,1,38,97
2022,59008,ANICHE,245901152,CC COEUR D'OSTREVENT (CCCO),59,NORD,19,5,24,22,52,2,54,100
2022,59152,COMINES,200093201,METROPOLE EUROPEENNE DE LILLE,59,NORD,42,18,60,31,137,2,139,231
2022,59179,DOUCHY LES MINES,200042190,CA DE LA PORTE DU HAINAUT,59,NORD,20,3,23,71,130,0,130,225
2022,59249,FOURMIES,200043404,CC DU SUD AVESNOIS,59,NORD,24,3,27,30,72,2,74,130
2022,59291,HAUTMONT,200043396,CA MAUBEUGE VAL DE SAMBRE,59,NORD,26,7,33,67,102,1,103,203
2022,59324,JEUMONT,200043396,CA MAUBEUGE VAL DE SAMBRE,59,NORD,20,1,21,69,75,1,76,166
2022,59360,LOOS,200093201,METROPOLE EUROPEENNE DE LILLE,59,NORD,135,30,165,28,263,9,272,464
2022,59386,MARQUETTE LEZ LILLE,200093201,METROPOLE EUROPEENNE DE LILLE,59,NORD,115,35,150,16,193,2,195,362
2022,59491,RAISMES,200042190,CA DE LA PORTE DU HAINAUT,59,NORD,51,3,54,53,97,0,97,203
2022,59569,SIN LE NOBLE,200044618,CA DOUAISIS AGGLO,59,NORD,60,12,72,48,146,2,148,269
2022,59574,SOMAIN,245901152,CC COEUR D'OSTREVENT (CCCO),59,NORD,40,4,44,50,123,1,124,219
2022,59606,VALENCIENNES,245901160,CA VALENCIENNES METROPOLE,59,NORD,282,36,318,146,250,12,262,726
2022,60057,BEAUVAIS,200067999,CA DU BEAUVAISIS,60,OISE,530,18,548,79,343,16,359,986
2022,60139,CHAMBLY,200067973,CC THELLOISE,60,OISE,40,3,43,0,163,6,169,213
2022,60157,CLERMONT,246000376,CC DU CLERMONTOIS,60,OISE,65,3,68,16,106,2,108,192
2022,60159,COMPIEGNE,200067965,CA DE LA REGION DE COMPIEGNE ET DE LA BASSE AUTOMNE,60,OISE,408,23,431,48,237,21,258,737
2022,60612,SENLIS,200066975,CC SENLIS SUD OISE,60,OISE,160,6,166,1,175,15,190,357
2022,61001,ALENCON,246100663,CU D'ALENCON,61,ORNE,162,3,165,73,198,7,205,443
2022,62108,BERCK,200069029,CA DES DEUX BAIES EN MONTREUILLOIS,62,PAS DE CALAIS,136,8,144,34,54,1,55,233
2022,62250,COURRIERES,246200299,CA D'HENIN-CARVIN,62,PAS DE CALAIS,70,16,86,43,95,1,96,225
2022,62318,ETAPLES,200069029,CA DES DEUX BAIES EN MONTREUILLOIS,62,PAS DE CALAIS,33,14,47,65,110,3,113,225
2022,62427,HENIN BEAUMONT,246200299,CA D'HENIN-CARVIN,62,PAS DE CALAIS,70,85,155,51,198,2,200,405
2022,62525,LONGUENESSE,200069037,CA DU PAYS DE SAINT-OMER,62,PAS DE CALAIS,45,6,51,28,107,3,110,189
2022,62570,MERICOURT,246200364,CA DE LENS - LIEVIN,62,PAS DE CALAIS,10,25,35,19,102,1,103,157
2022,62758,SAINT MARTIN BOULOGNE,246200729,CA DU BOULONNAIS,62,PAS DE CALAIS,54,10,64,47,77,3,80,191
2022,62765,SAINT OMER,200069037,CA DU PAYS DE SAINT-OMER,62,PAS DE CALAIS,25,8,33,52,104,7,111,197
2022,63014,AUBIERE,246300701,CLERMONT AUVERGNE METROPOLE,63,PUY DE DOME,92,7,99,12,107,4,111,222
2022,63164,GERZAT,246300701,CLERMONT AUVERGNE METROPOLE,63,PUY DE DOME,40,5,45,0,188,1,189,234
2022,63300,RIOM,200070753,CA RIOM LIMAGNE ET VOLCANS,63,PUY DE DOME,83,12,95,27,181,8,189,311
2022,64102,BAYONNE,200067106,CA DU PAYS BASQUE,64,PYRENEES ATLANTIQUES,255,106,361,56,403,31,434,851
2022,64122,BIARRITZ,200067106,CA DU PAYS BASQUE,64,PYRENEES ATLANTIQUES,184,51,235,24,96,22,118,378
2022,64260,HENDAYE,200067106,CA DU PAYS BASQUE,64,PYRENEES ATLANTIQUES,86,11,97,19,90,3,93,209
2022,64348,LONS,200067254,CA PAU BEARN PYRENEES,64,PYRENEES ATLANTIQUES,74,8,82,1,235,7,242,326
2022,64445,PAU,200067254,CA PAU BEARN PYRENEES,64,PYRENEES ATLANTIQUES,432,69,501,56,536,48,584,1141
2022,64483,SAINT JEAN DE LUZ,200067106,CA DU PAYS BASQUE,64,PYRENEES ATLANTIQUES,70,12,82,40,75,7,82,204
2022,65286,LOURDES,200069300,CA TARBES-LOURDES-PYRENEES,65,HAUTES PYRENEES,129,0,129,46,54,4,58,233
2022,66028,CABESTANY,200027183,CU PERPIGNAN MEDITERRANEE METROPOLE,66,PYRENEES ORIENTALES,75,18,93,7,73,4,77,177
2022,67043,BISCHHEIM,246700488,EUROMETROPOLE DE STRASBOURG,67,BAS RHIN,174,58,232,31,95,5,100,364
2022,67046,BISCHWILLER,200067874,CA DE HAGUENAU,67,BAS RHIN,167,44,211,0,50,0,50,261
2022,67130,ERSTEIN,200067924,CC DU CANTON D'ERSTEIN,67,BAS RHIN,65,38,103,0,125,1,126,229
2022,67348,OBERNAI,246701080,CC DU PAYS DE SAINTE-ODILE,67,BAS RHIN,126,23,149,5,79,1,80,234
2022,67365,OSTWALD,246700488,EUROMETROPOLE DE STRASBOURG,67,BAS RHIN,150,34,184,0,103,4,107,292
2022,67437,SAVERNE,200068112,CC DU PAYS DE SAVERNE,67,BAS RHIN,111,12,123,14,73,1,74,211
2022,67482,STRASBOURG,246700488,EUROMETROPOLE DE STRASBOURG,67,BAS RHIN,3352,954,4306,360,1350,182,1532,6198
2022,68063,CERNAY,200036465,CC DE THANN-CERNAY,68,HAUT RHIN,63,12,75,6,119,1,120,201
2022,68224,MULHOUSE,200066009,CA MULHOUSE ALSACE AGGLOMERATION,68,HAUT RHIN,1113,38,1151,228,342,20,362,1741
2022,68375,WITTELSHEIM,200066009,CA MULHOUSE ALSACE AGGLOMERATION,68,HAUT RHIN,40,13,53,0,113,0,113,166
2022,68376,WITTENHEIM,200066009,CA MULHOUSE ALSACE AGGLOMERATION,68,HAUT RHIN,88,17,105,0,132,2,134,239
2022,69019,BELLEVILLE EN BEAUJOLAIS,200067817,CC SAONE-BEAUJOLAIS,69D,RHONE,40,18,58,31,149,3,152,242
2022,69027,BRIGNAIS,246900757,CC DE LA VALLEE DU GARON (CCVG),69D,RHONE,88,25,113,12,153,6,159,284
2022,69243,TARARE,200040566,CA DE L'OUEST RHODANIEN,69D,RHONE,83,3,86,36,82,2,84,206
2022,69034,CALUIRE ET CUIRE,200046977,METROPOLE DE LYON,69M,RHONE,339,129,468,48,431,45,476,991
2022,69069,CRAPONNE,200046977,METROPOLE DE LYON,69M,RHONE,112,49,161,1,146,9,155,317
2022,69081,ECULLY,200046977,METROPOLE DE LYON,69M,RHONE,180,17,197,14,165,19,184,394
2022,69091,GIVORS,200046977,METROPOLE DE LYON,69M,RHONE,142,15,157,95,151,7,158,410
2022,69152,PIERRE BENITE,200046977,METROPOLE DE LYON,69M,RHONE,180,9,189,40,108,6,114,343
2022,69199,SAINT FONS,200046977,METROPOLE DE LYON,69M,RHONE,162,4,166,76,88,9,97,338
2022,69202,SAINTE FOY LES LYON,200046977,METROPOLE DE LYON,69M,RHONE,174,68,242,0,216,17,233,475
2022,69204,SAINT GENIS LAVAL,200046977,METROPOLE DE LYON,69M,RHONE,181,34,215,15,203,19,222,452
2022,69273,CORBAS,200046977,METROPOLE DE LYON,69M,RHONE,84,11,95,0,137,3,140,235
2022,69387,LYON 7E ARRONDISSEMENT,200046977,METROPOLE DE LYON,69M,RHONE,878,212,1090,33,800,174,974,2096
2022,70550,VESOUL,247000011,CA DE VESOUL,70,HAUTE SAONE,83,7,90,26,142,2,144,259
2022,71014,AUTUN,200070530,CC DU GRAND AUTUNOIS MORVAN,71,SAONE ET LOIRE,91,0,91,29,97,2,99,219
2022,71153,LE CREUSOT,247100290,CU LE CREUSOT MONTCEAU-LES-MINES,71,SAONE ET LOIRE,64,21,85,57,139,5,144,286
2022,71306,MONTCEAU LES MINES,247100290,CU LE CREUSOT MONTCEAU-LES-MINES,71,SAONE ET LOIRE,55,8,63,58,129,3,132,253
2022,72154,LA FLECHE,247200348,CC DU PAYS FLECHOIS,72,SARTHE,80,0,80,18,163,3,166,264
2022,73011,ALBERTVILLE,200068997,CA ARLYSERE,73,SAVOIE,90,3,93,27,194,4,198,318
2022,74010,ANNECY,200066793,CA DU GRAND ANNECY,74,HAUTE SAVOIE,1277,152,1429,37,1084,114,1198,2665
2022,74042,BONNEVILLE,200000172,CC FAUCIGNY-GLIERES,74,HAUTE SAVOIE,62,15,77,0,182,4,186,263
2022,74081,CLUSES,200033116,CC CLUSES-ARVE ET MONTAGNES,74,HAUTE SAVOIE,84,11,95,44,109,3,112,251
2022,74133,GAILLARD,200011773,CA ANNEMASSE-LES VOIRONS-AGGLOMERATION,74,HAUTE SAVOIE,101,1,102,18,94,1,95,214
2022,74208,PASSY,200034882,CC PAYS DU MONT-BLANC,74,HAUTE SAVOIE,79,14,93,0,141,3,144,237
2022,74256,SALLANCHES,200034882,CC PAYS DU MONT-BLANC,74,HAUTE SAVOIE,101,14,115,0,156,1,157,272
2022,75105,PARIS 5E ARRONDISSEMENT,200054781,METROPOLE DU GRAND PARIS,75,PARIS,1015,19,1034,41,17,174,191,1266
2022,75106,PARIS 6E ARRONDISSEMENT,200054781,METROPOLE DU GRAND PARIS,75,PARIS,689,11,700,43,12,206,218,961
2022,75107,PARIS 7E ARRONDISSEMENT,200054781,METROPOLE DU GRAND PARIS,75,PARIS,641,48,689,53,10,277,287,1028
2022,75108,PARIS 8E ARRONDISSEMENT,200054781,METROPOLE DU GRAND PARIS,75,PARIS,603,56,659,98,33,316,349,1106
2022,75113,PARIS 13E ARRONDISSEMENT,200054781,METROPOLE DU GRAND PARIS,75,PARIS,3659,162,3821,35,318,310,628,4483
2022,75119,PARIS 19E ARRONDISSEMENT,200054781,METROPOLE DU GRAND PARIS,75,PARIS,4468,37,4505,146,280,718,998,5649
2022,75120,PARIS 20E ARRONDISSEMENT,200054781,METROPOLE DU GRAND PARIS,75,PARIS,4038,151,4189,105,439,421,860,5154
2022,76108,BOIS GUILLAUME,200023414,METROPOLE ROUEN NORMANDIE,76,SEINE MARITIME,214,28,242,1,98,18,116,359
2022,76410,MAROMME,200023414,METROPOLE ROUEN NORMANDIE,76,SEINE MARITIME,65,4,69,8,167,2,169,246
2022,76476,PORT JEROME SUR SEINE,200010700,CA CAUX SEINE AGGLO,76,SEINE MARITIME,30,3,33,0,143,4,147,180
2022,76484,OISSEL,200023414,METROPOLE ROUEN NORMANDIE,76,SEINE MARITIME,12,2,14,27,190,2,192,233
2022,77108,CHELLES,200057958,CA PARIS - VALLEE DE LA MARNE,77,SEINE ET MARNE,329,79,408,53,545,30,575,1036
2022,77152,DAMMARIE LES LYS,247700057,CA MELUN VAL DE SEINE,77,SEINE ET MARNE,220,6,226,0,247,10,257,483
2022,77153,DAMMARTIN EN GOELE,200055655,CA ROISSY PAYS DE FRANCE,77,SEINE ET MARNE,40,30,70,0,152,7,159,229
2022,77294,MITRY MORY,200055655,CA ROISSY PAYS DE FRANCE,77,SEINE ET MARNE,87,3,90,0,268,6,274,364
2022,77296,MOISSY CRAMAYEL,200059228,CA GRAND PARIS SUD SEINE ESSONNE SENART,77,SEINE ET MARNE,143,12,155,18,255,5,260,434
2022,77445,SAVIGNY LE TEMPLE,200059228,CA GRAND PARIS SUD SEINE ESSONNE SENART,77,SEINE ET MARNE,230,7,237,40,321,7,328,605
2022,77464,THORIGNY SUR MARNE,247700594,CA MARNE ET GONDOIRE,77,SEINE ET MARNE,70,5,75,0,109,7,116,192
2022,77487,VAUX LE PENIL,247700057,CA MELUN VAL DE SEINE,77,SEINE ET MARNE,90,2,92,0,164,2,166,258
2022,77514,VILLEPARISIS,200055655,CA ROISSY PAYS DE FRANCE,77,SEINE ET MARNE,123,14,137,0,365,5,370,507
2022,78005,ACHERES,200059889,CU GRAND PARIS SEINE ET OISE,78,YVELINES,222,56,278,17,238,15,253,549
2022,78015,ANDRESY,200059889,CU GRAND PARIS SEINE ET OISE,78,YVELINES,35,36,71,9,202,1,203,283
2022,78124,CARRIERES SUR SEINE,200058519,CA SAINT GERMAIN BOUCLES DE SEINE,78,YVELINES,220,14,234,9,111,22,133,376
2022,78138,CHANTELOUP LES VIGNES,200059889,CU GRAND PARIS SEINE ET OISE,78,YVELINES,113,6,119,0,100,6,106,225
2022,78158,LE CHESNAY ROCQUENCOURT,247800584,CA VERSAILLES GRAND PARC (CAVGP),78,YVELINES,451,19,470,0,118,45,163,633
2022,78208,ELANCOURT,200058782,CA DE SAINT QUENTIN EN YVELINES,78,YVELINES,290,22,312,13,326,10,336,660
2022,78297,GUYANCOURT,200058782,CA DE SAINT QUENTIN EN YVELINES,78,YVELINES,486,14,500,173,340,9,349,1022
2022,78361,MANTES LA JOLIE,200059889,CU GRAND PARIS SEINE ET OISE,78,YVELINES,346,72,418,55,116,31,147,620
2022,78362,MANTES LA VILLE,200059889,CU GRAND PARIS SEINE ET OISE,78,YVELINES,90,72,162,0,178,18,196,358
2022,78372,MARLY LE ROI,200058519,CA SAINT GERMAIN BOUCLES DE SEINE,78,YVELINES,240,36,276,2,132,13,145,422
2022,78383,MAUREPAS,200058782,CA DE SAINT QUENTIN EN YVELINES,78,YVELINES,194,15,209,20,195,12,207,435
2022,78423,MONTIGNY LE BRETONNEUX,200058782,CA DE SAINT QUENTIN EN YVELINES,78,YVELINES,470,8,478,4,302,14,316,798
2022,78498,POISSY,200059889,CU GRAND PARIS SEINE ET OISE,78,YVELINES,638,114,752,7,294,39,333,1092
2022,78517,RAMBOUILLET,200073344,CA RAMBOUILLET TERRITOIRES,78,YVELINES,282,26,308,0,278,31,309,617
2022,78551,SAINT GERMAIN EN LAYE,200058519,CA SAINT GERMAIN BOUCLES DE SEINE,78,YVELINES,578,150,728,14,218,101,319,1061
2022,78586,SARTROUVILLE,200058519,CA SAINT GERMAIN BOUCLES DE SEINE,78,YVELINES,352,308,660,53,559,82,641,1354
2022,78624,TRIEL SUR SEINE,200059889,CU GRAND PARIS SEINE ET OISE,78,YVELINES,45,50,95,0,172,4,176,270
2022,78640,VELIZY VILLACOUBLAY,247800584,CA VERSAILLES GRAND PARC (CAVGP),78,YVELINES,462,8,470,0,226,8,234,704
2022,78643,VERNOUILLET,200059889,CU GRAND PARIS SEINE ET OISE,78,YVELINES,82,31,113,12,95,11,106,231
2022,78674,VILLEPREUX,200058782,CA DE SAINT QUENTIN EN YVELINES,78,YVELINES,95,64,159,0,146,7,153,312
2022,79329,THOUARS,247900798,CC DU THOUARSAIS,79,DEUX SEVRES,91,0,91,15,123,3,126,232
2022,80001,ABBEVILLE,200070993,CA DE LA BAIE DE SOMME,80,SOMME,54,21,75,47,231,1,232,354
2022,80021,AMIENS,248000531,CA AMIENS METROPOLE,80,SOMME,1018,124,1142,349,942,71,1013,2504
2022,81065,CASTRES,248100430,CA DE CASTRES MAZAMET,81,TARN,276,49,325,57,169,25,194,576
2022,82112,MOISSAC,200066322,CC TERRES DES CONFLUENCES,82,TARN ET GARONNE,55,11,66,31,80,3,83,179
2022,83042,COGOLIN,200036077,CC DU GOLFE DE SAINT-TROPEZ,83,VAR,108,3,111,1,82,2,84,196
2022,83071,LA LONDE LES MAURES,200027100,CC MEDITERRANEE PORTE DES MAURES,83,VAR,83,2,85,0,54,2,56,141
2022,83073,LE LUC,248300550,CC COEUR DU VAR,83,VAR,90,5,95,0,84,4,88,183
2022,83090,OLLIOULES,248300543,METROPOLE TOULON-PROVENCE-MEDITERRANEE,83,VAR,99,28,127,3,110,10,120,250
2022,83107,ROQUEBRUNE SUR ARGENS,200035319,CA ESTEREL COTE D'AZUR AGGLOMERATION,83,VAR,94,6,100,0,139,15,154,254
2022,83112,SAINT CYR SUR MER,248300394,CA SUD SAINTE BAUME,83,VAR,60,8,68,0,125,9,134,202
2022,83126,LA SEYNE SUR MER,248300543,METROPOLE TOULON-PROVENCE-MEDITERRANEE,83,VAR,415,143,558,73,391,27,418,1048
2022,83130,SOLLIES PONT,248300410,CC DE LA VALLEE DU GAPEAU,83,VAR,75,20,95,5,152,4,156,256
2022,83144,LA VALETTE DU VAR,248300543,METROPOLE TOULON-PROVENCE-MEDITERRANEE,83,VAR,163,36,199,6,194,12,206,411
2022,84035,CAVAILLON,200040442,CA LUBERON MONTS DE VAUCLUSE,84,VAUCLUSE,227,8,235,0,123,11,134,369
2022,84080,MONTEUX,248400293,CA DES SORGUES DU COMTAT,84,VAUCLUSE,71,19,90,0,138,4,142,232
2022,84092,LE PONTET,248400251,CA DU GRAND AVIGNON (COGA),84,VAUCLUSE,67,28,95,1,133,1,134,230
2022,84129,SORGUES,248400293,CA DES SORGUES DU COMTAT,84,VAUCLUSE,100,53,153,6,128,6,134,293
2022,85092,FONTENAY LE COMTE,200071934,CC DU PAYS DE FONTENAY-VENDEE,85,VENDEE,24,5,29,34,134,3,137,200
2022,85146,MONTAIGU VENDEE,200070233,CA TERRES DE MONTAIGU,85,VENDEE,123,23,146,22,407,3,410,578
2022,86041,BUXEROLLES,200069854,CU DU GRAND POITIERS,86,VIENNE,30,5,35,0,130,2,132,167
2022,87154,SAINT JUNIEN,200059400,CC PORTE OCEANE DU LIMOUSIN,87,HAUTE VIENNE,40,3,43,0,121,3,124,167
2022,88413,SAINT DIE DES VOSGES,200071066,CA DE SAINT-DIE-DES-VOSGES,88,VOSGES,126,0,126,45,143,5,148,319
2022,91021,ARPAJON,200057859,CA COEUR D'ESSONNE AGGLOMERATION,91,ESSONNE,91,13,104,0,117,0,117,221
2022,91201,DRAVEIL,200058477,CA VAL D'YERRES VAL DE SEINE,91,ESSONNE,455,20,475,4,300,8,308,787
2022,91216,EPINAY SUR ORGE,200056232,CA COMMUNAUTE PARIS-SACLAY,91,ESSONNE,95,9,104,0,109,3,112,216
2022,91228,EVRY COURCOURONNES,200059228,CA GRAND PARIS SUD SEINE ESSONNE SENART,91,ESSONNE,581,20,601,114,679,25,704,1419
2022,91235,FLEURY MEROGIS,200057859,CA COEUR D'ESSONNE AGGLOMERATION,91,ESSONNE,114,10,124,0,120,3,123,247
2022,91272,GIF SUR YVETTE,200056232,CA COMMUNAUTE PARIS-SACLAY,91,ESSONNE,260,5,265,7,200,12,212,484
2022,91326,JUVISY SUR ORGE,200054781,METROPOLE DU GRAND PARIS,91,ESSONNE,150,22,172,0,144,25,169,342
2022,91434,MORSANG SUR ORGE,200057859,CA COEUR D'ESSONNE AGGLOMERATION,91,ESSONNE,200,18,218,0,270,5,275,492
2022,91477,PALAISEAU,200056232,CA COMMUNAUTE PARIS-SACLAY,91,ESSONNE,451,69,520,5,422,22,444,969
2022,91549,SAINTE GENEVIEVE DES BOIS,200057859,CA COEUR D'ESSONNE AGGLOMERATION,91,ESSONNE,183,62,245,33,416,16,432,710
2022,91552,SAINT GERMAIN LES ARPAJON,200057859,CA COEUR D'ESSONNE AGGLOMERATION,91,ESSONNE,54,21,75,0,170,5,175,251
2022,91573,SAINT PIERRE DU PERRAY,200059228,CA GRAND PARIS SUD SEINE ESSONNE SENART,91,ESSONNE,97,8,105,0,240,5,245,349
2022,91645,VERRIERES LE BUISSON,200056232,CA COMMUNAUTE PARIS-SACLAY,91,ESSONNE,168,10,178,0,88,10,98,277
2022,91687,VIRY CHATILLON,200054781,METROPOLE DU GRAND PARIS,91,ESSONNE,197,45,242,0,369,15,384,626
2022,92004,ASNIERES SUR SEINE,200054781,METROPOLE DU GRAND PARIS,92,HAUTS DE SEINE,1245,295,1540,32,434,674,1108,2681
2022,92007,BAGNEUX,200054781,METROPOLE DU GRAND PARIS,92,HAUTS DE SEINE,459,56,515,78,350,37,387,980
2022,92012,BOULOGNE BILLANCOURT,200054781,METROPOLE DU GRAND PARIS,92,HAUTS DE SEINE,2375,281,2656,48,473,778,1251,3955
2022,92019,CHATENAY MALABRY,200054781,METROPOLE DU GRAND PARIS,92,HAUTS DE SEINE,414,21,435,51,196,43,239,725
2022,92023,CLAMART,200054781,METROPOLE DU GRAND PARIS,92,HAUTS DE SEINE,722,157,879,33,239,172,411,1323
2022,92035,LA GARENNE COLOMBES,200054781,METROPOLE DU GRAND PARIS,92,HAUTS DE SEINE,685,64,749,8,97,110,207,964
2022,92063,RUEIL MALMAISON,200054781,METROPOLE DU GRAND PARIS,92,HAUTS DE SEINE,1215,168,1383,34,316,302,618,2035
2022,92072,SEVRES,200054781,METROPOLE DU GRAND PARIS,92,HAUTS DE SEINE,320,29,349,0,164,58,222,571
2022,92077,VILLE D AVRAY,200054781,METROPOLE DU GRAND PARIS,92,HAUTS DE SEINE,146,5,151,0,88,37,125,276
2022,93008,BOBIGNY,200054781,METROPOLE DU GRAND PARIS,93,SEINE SAINT DENIS,629,4,633,75,132,9,141,849
2022,93029,DRANCY,200054781,METROPOLE DU GRAND PARIS,93,SEINE SAINT DENIS,520,10,530,0,268,20,288,818
2022,93032,GAGNY,200054781,METROPOLE DU GRAND PARIS,93,SEINE SAINT DENIS,330,33,363,0,269,67,336,699
2022,93047,MONTFERMEIL,200054781,METROPOLE DU GRAND PARIS,93,SEINE SAINT DENIS,247,13,260,16,151,6,157,433
2022,93049,NEUILLY PLAISANCE,200054781,METROPOLE DU GRAND PARIS,93,SEINE SAINT DENIS,162,30,192,0,142,22,164,356
2022,93051,NOISY LE GRAND,200054781,METROPOLE DU GRAND PARIS,93,SEINE SAINT DENIS,702,58,760,62,557,62,619,1441
2022,93055,PANTIN,200054781,METROPOLE DU GRAND PARIS,93,SEINE SAINT DENIS,690,71,761,67,290,185,475,1303
2022,93061,LE PRE SAINT GERVAIS,200054781,METROPOLE DU GRAND PARIS,93,SEINE SAINT DENIS,194,5,199,2,122,33,155,356
2022,93064,ROSNY SOUS BOIS,200054781,METROPOLE DU GRAND PARIS,93,SEINE SAINT DENIS,525,42,567,5,334,59,393,964
2022,93066,SAINT DENIS,200054781,METROPOLE DU GRAND PARIS,93,SEINE SAINT DENIS,1117,84,1201,157,583,49,632,1990
2022,93079,VILLETANEUSE,200054781,METROPOLE DU GRAND PARIS,93,SEINE SAINT DENIS,65,0,65,45,35,5,40,151
2022,94003,ARCUEIL,200054781,METROPOLE DU GRAND PARIS,94,VAL DE MARNE,279,25,304,16,157,22,179,499
2022,94017,CHAMPIGNY SUR MARNE,200054781,METROPOLE DU GRAND PARIS,94,VAL DE MARNE,599,89,688,88,538,51,589,1366
2022,94018,CHARENTON LE PONT,200054781,METROPOLE DU GRAND PARIS,94,VAL DE MARNE,557,34,591,0,155,147,302,893
2022,94019,CHENNEVIERES SUR MARNE,200054781,METROPOLE DU GRAND PARIS,94,VAL DE MARNE,200,19,219,0,111,14,125,344
2022,94028,CRETEIL,200054781,METROPOLE DU GRAND PARIS,94,VAL DE MARNE,1585,40,1625,120,354,95,449,2194
2022,94037,GENTILLY,200054781,METROPOLE DU GRAND PARIS,94,VAL DE MARNE,269,21,290,66,71,20,91,447
2022,94054,ORLY,200054781,METROPOLE DU GRAND PARIS,94,VAL DE MARNE,271,14,285,78,135,11,146,508
2022,94060,LA QUEUE EN BRIE,200054781,METROPOLE DU GRAND PARIS,94,VAL DE MARNE,40,2,42,0,89,1,90,132
2022,94077,VILLENEUVE LE ROI,200054781,METROPOLE DU GRAND PARIS,94,VAL DE MARNE,214,11,225,4,120,9,129,358
2022,94078,VILLENEUVE SAINT GEORGES,200054781,METROPOLE DU GRAND PARIS,94,VAL DE MARNE,210,9,219,15,152,8,160,394
2022,94081,VITRY SUR SEINE,200054781,METROPOLE DU GRAND PARIS,94,VAL DE MARNE,778,123,901,53,317,37,354,1308
2022,95127,CERGY,249500109,CA DE CERGY-PONTOISE,95,VAL D OISE,691,44,735,71,664,38,702,1508
2022,95219,ERMONT,200058485,CA VAL PARISIS,95,VAL D OISE,257,17,274,0,335,23,358,632
2022,95323,JOUY LE MOUTIER,249500109,CA DE CERGY-PONTOISE,95,VAL D OISE,132,15,147,0,232,3,235,383
2022,95427,MONTMAGNY,200056380,CA PLAINE VALLEE,95,VAL D OISE,82,6,88,1,136,5,141,230
2022,95476,OSNY,249500109,CA DE CERGY-PONTOISE,95,VAL D OISE,144,39,183,3,192,6,198,384
2022,95539,SAINT BRICE SOUS FORET,200056380,CA PLAINE VALLEE,95,VAL D OISE,102,28,130,0,170,27,197,327
2022,95563,SAINT LEU LA FORET,200058485,CA VAL PARISIS,95,VAL D OISE,94,15,109,0,147,19,166,275
2022,95585,SARCELLES,200055655,CA ROISSY PAYS DE FRANCE,95,VAL D OISE,358,45,403,268,235,61,296,967
2022,95598,SOISY SOUS MONTMORENCY,200056380,CA PLAINE VALLEE,95,VAL D OISE,90,39,129,3,179,17,196,328
2022,95680,VILLIERS LE BEL,200055655,CA ROISSY PAYS DE FRANCE,95,VAL D OISE,185,0,185,35,134,6,140,360
2022,97103,BAIE MAHAULT,200018653,CA CAP EXCELLENCE,971,GUADELOUPE,167,78,245,68,253,22,275,587
2022,97129,SAINTE ROSE,249710062,CA DU NORD BASSE-TERRE,971,GUADELOUPE,148,18,166,45,57,9,66,277
2022,97207,DUCOS,249720053,CA DE L'ESPACE SUD DE LA MARTINIQUE,972,MARTINIQUE,26,48,74,31,148,4,152,257
2022,97209,FORT DE FRANCE,249720061,CA DU CENTRE DE LA MARTINIQUE,972,MARTINIQUE,815,36,851,269,205,36,241,1361
2022,97213,LE LAMENTIN,249720061,CA DU CENTRE DE LA MARTINIQUE,972,MARTINIQUE,669,56,725,53,154,19,173,951
2022,97222,LE ROBERT,200041788,CA DU PAYS NORD MARTINIQUE,972,MARTINIQUE,205,76,281,67,78,5,83,431
2022,97224,SAINT JOSEPH,249720061,CA DU CENTRE DE LA MARTINIQUE,972,MARTINIQUE,124,58,182,72,40,3,43,296
2022,97302,CAYENNE,249730045,CA DU CENTRE LITTORAL,973,GUYANE,646,38,684,0,127,34,161,845
2022,97305,MACOURIA,249730045,CA DU CENTRE LITTORAL,973,GUYANE,170,5,175,2,34,17,51,228
2022,97306,MANA,249730037,CC DE L'OUEST GUYANAIS,973,GUYANE,12,0,12,25,3,1,4,41
2022,97307,MATOURY,249730045,CA DU CENTRE LITTORAL,973,GUYANE,396,9,405,0,48,9,57,462
2022,97353,MARIPASOULA,249730037,CC DE L'OUEST GUYANAIS,973,GUYANE,0,0,0,0,0,7,7,7
2022,97401,LES AVIRONS,249740077,CA CIVIS (COMMUNAUTE INTERCOMMUNALE DES VILLES SOLIDAIRES),974,LA REUNION,0,77,77,17,115,13,128,221
2022,97410,SAINT BENOIT,249740093,CA INTERCOMMUNALE DE LA REUNION EST (CIREST),974,LA REUNION,215,193,408,39,107,25,132,579
2022,97701,SAINT-BARTHELEMY,XX,XX,977,COLLECTIVITE D'OUTRE MER SAINT BARTHELEMY,0,0,0,20,127,8,135,155
2022,97801,SAINT-MARTIN,XX,XX,978,COLLECTIVITE D'OUTRE MER SAINT MARTIN,116,0,116,165,110,16,126,407
2018,59574,SOMAIN,245901152,CC COEUR D'OSTREVENT (CCCO),59,NORD,40,5,45,43,122,1,123,211
2018,59648,WATTIGNIES,245900410,METROPOLE EUROPEENNE DE LILLE,59,NORD,74,31,105,15,152,5,157,277
2018,60057,BEAUVAIS,200067999,CA DU BEAUVAISIS,60,OISE,525,1,526,153,465,9,474,1153
2018,60157,CLERMONT,246000376,CC DU CLERMONTOIS,60,OISE,65,1,66,12,127,2,129,206
2018,60471,NOYON,246000756,CC DU PAYS NOYONNAIS,60,OISE,111,0,111,44,100,2,102,257
2018,62041,ARRAS,200033579,CU D'ARRAS,62,PAS DE CALAIS,314,49,363,150,323,22,345,858
2018,62065,AVION,246200364,CA DE LENS - LIEVIN,62,PAS DE CALAIS,24,14,38,69,127,1,128,235
2018,62186,BULLY LES MINES,246200364,CA DE LENS - LIEVIN,62,PAS DE CALAIS,30,4,34,45,131,1,132,212
2018,62318,ETAPLES,200069029,CA DES DEUX BAIES EN MONTREUILLOIS,62,PAS DE CALAIS,33,1,34,83,126,1,127,244
2018,62413,HARNES,246200364,CA DE LENS - LIEVIN,62,PAS DE CALAIS,0,19,19,45,124,1,125,189
2018,62587,MONTIGNY EN GOHELLE,246200299,CA D'HENIN-CARVIN,62,PAS DE CALAIS,30,6,36,54,73,1,74,164
2018,62643,OUTREAU,246200729,CA DU BOULONNAIS,62,PAS DE CALAIS,60,1,61,69,99,4,103,233
2018,63178,ISSOIRE,200070407,CA AGGLO PAYS D'ISSOIRE,63,PUY DE DOME,91,3,94,7,242,2,244,345
2018,64024,ANGLET,200067106,CA DU PAYS BASQUE,64,PYRENEES ATLANTIQUES,145,83,228,21,385,27,412,661
2018,66028,CABESTANY,200027183,CU PERPIGNAN MEDITERRANEE METROPOLE,66,PYRENEES ORIENTALES,75,12,87,19,75,3,78,183
2018,68112,GUEBWILLER,246800569,CC DE LA REGION DE GUEBWILLER,68,HAUT RHIN,110,7,117,0,54,5,59,175
2018,68154,ILLZACH,200066009,CA MULHOUSE ALSACE AGGLOMERATION,68,HAUT RHIN,85,1,86,18,69,2,71,175
2018,68271,RIEDISHEIM,200066009,CA MULHOUSE ALSACE AGGLOMERATION,68,HAUT RHIN,58,1,59,0,65,4,69,128
2018,68278,RIXHEIM,200066009,CA MULHOUSE ALSACE AGGLOMERATION,68,HAUT RHIN,130,1,131,16,132,5,137,284
2018,69069,CRAPONNE,200046977,METROPOLE DE LYON,69,RHONE,112,18,130,0,162,17,179,309
2018,69091,GIVORS,200046977,METROPOLE DE LYON,69,RHONE,126,11,137,108,183,4,187,432
2018,69243,TARARE,200040566,CA DE L'OUEST RHODANIEN,69,RHONE,98,1,99,36,126,2,128,263
2018,69259,VENISSIEUX,200046977,METROPOLE DE LYON,69,RHONE,414,17,431,605,460,17,477,1513
2018,69277,GENAS,246900575,CC DE L'EST LYONNAIS (CCEL),69,RHONE,96,22,118,1,265,10,275,394
2018,69286,RILLIEUX LA PAPE,200046977,METROPOLE DE LYON,69,RHONE,216,40,256,82,277,15,292,629
2018,70550,VESOUL,247000011,CA DE VESOUL,70,HAUTE SAONE,98,5,103,33,148,3,151,287
2018,71153,LE CREUSOT,247100290,CU LE CREUSOT MONTCEAU-LES-MINES,71,SAONE ET LOIRE,73,14,87,46,196,2,198,331
2018,73008,AIX LES BAINS,200068674,CA GRAND LAC,73,SAVOIE,155,27,182,31,368,7,375,587
2018,74225,RUMILLY,247400740,CC RUMILLY TERRE DE SAVOIE,74,HAUTE SAVOIE,215,25,240,0,171,7,178,418
2018,74243,SAINT JULIEN EN GENEVOIS,247400690,CC DU GENEVOIS,74,HAUTE SAVOIE,101,11,112,0,169,2,171,283
2018,75107,PARIS 7E ARRONDISSEMENT,200054781,METROPOLE DU GRAND PARIS,75,PARIS,636,38,674,77,15,334,349,1100
2018,75111,PARIS 11E ARRONDISSEMENT,200054781,METROPOLE DU GRAND PARIS,75,PARIS,2553,204,2757,64,224,834,1058,3879
2018,75119,PARIS 19E ARRONDISSEMENT,200054781,METROPOLE DU GRAND PARIS,75,PARIS,4520,11,4531,168,346,542,888,5588
2018,76108,BOIS GUILLAUME,200023414,METROPOLE ROUEN NORMANDIE,76,SEINE MARITIME,186,15,201,0,104,24,128,329
2018,76165,CAUDEBEC LES ELBEUF,200023414,METROPOLE ROUEN NORMANDIE,76,SEINE MARITIME,30,0,30,0,151,2,153,183
2018,76217,DIEPPE,247600786,CA DE LA REGION DIEPPOISE,76,SEINE MARITIME,204,1,205,107,205,7,212,524
2018,76351,LE HAVRE,200084952,CU LE HAVRE SEINE METROPOLE,76,SEINE MARITIME,869,137,1006,251,2153,69,2222,3479
2018,76447,MONTIVILLIERS,200084952,CU LE HAVRE SEINE METROPOLE,76,SEINE MARITIME,40,20,60,0,307,5,312,373
2018,76484,OISSEL,200023414,METROPOLE ROUEN NORMANDIE,76,SEINE MARITIME,12,0,12,19,206,4,210,242
2018,76540,ROUEN,200023414,METROPOLE ROUEN NORMANDIE,76,SEINE MARITIME,1017,145,1162,90,953,85,1038,2291
2018,76681,SOTTEVILLE LES ROUEN,200023414,METROPOLE ROUEN NORMANDIE,76,SEINE MARITIME,195,23,218,16,462,2,464,698
2018,76758,YVETOT,247600620,CC YVETOT NORMANDIE,76,SEINE MARITIME,62,5,67,10,225,5,230,307
2018,77083,CHAMPS SUR MARNE,200057958,CA PARIS - VALLEE DE LA MARNE,77,SEINE ET MARNE,281,2,283,2,260,11,271,557
2018,77118,CLAYE SOUILLY,200055655,CA ROISSY PAYS DE FRANCE,77,SEINE ET MARNE,30,1,31,11,182,4,186,229
2018,77152,DAMMARIE LES LYS,247700057,CA MELUN VAL DE SEINE,77,SEINE ET MARNE,220,0,220,4,298,6,304,528
2018,77153,DAMMARTIN EN GOELE,200055655,CA ROISSY PAYS DE FRANCE,77,SEINE ET MARNE,40,1,41,0,162,2,164,204
2018,77251,LIEUSAINT,200059228,CA GRAND PARIS SUD SEINE ESSONNE SENART,77,SEINE ET MARNE,135,5,140,0,269,2,271,411
2018,77258,LOGNES,200057958,CA PARIS - VALLEE DE LA MARNE,77,SEINE ET MARNE,207,3,210,0,147,5,152,362
2018,77305,MONTEREAU FAULT YONNE,247700107,CC PAYS DE MONTEREAU,77,SEINE ET MARNE,100,4,104,32,171,5,176,312
2018,77337,NOISIEL,200057958,CA PARIS - VALLEE DE LA MARNE,77,SEINE ET MARNE,218,3,221,21,108,12,120,362
2018,77379,PROVINS,200037133,CC DU PROVINOIS,77,SEINE ET MARNE,100,8,108,38,75,4,79,225
2018,77390,ROISSY EN BRIE,200057958,CA PARIS - VALLEE DE LA MARNE,77,SEINE ET MARNE,150,6,156,21,288,9,297,473
2018,77407,SAINT FARGEAU PONTHIERRY,247700057,CA MELUN VAL DE SEINE,77,SEINE ET MARNE,104,3,107,0,246,7,253,360
2018,77487,VAUX LE PENIL,247700057,CA MELUN VAL DE SEINE,77,SEINE ET MARNE,137,0,137,0,142,2,144,281
2018,78005,ACHERES,200059889,CU GRAND PARIS SEINE ET OISE,78,YVELINES,187,28,215,12,270,16,286,513
2018,78029,AUBERGENVILLE,200059889,CU GRAND PARIS SEINE ET OISE,78,YVELINES,97,16,113,0,121,3,124,237
2018,78123,CARRIERES SOUS POISSY,200059889,CU GRAND PARIS SEINE ET OISE,78,YVELINES,176,6,182,17,218,12,230,430
2018,78124,CARRIERES SUR SEINE,200058519,CA SAINT GERMAIN BOUCLES DE SEINE,78,YVELINES,220,12,232,14,130,24,154,399
2018,78138,CHANTELOUP LES VIGNES,200059889,CU GRAND PARIS SEINE ET OISE,78,YVELINES,108,1,109,7,98,3,101,217
2018,78172,CONFLANS SAINTE HONORINE,200059889,CU GRAND PARIS SEINE ET OISE,78,YVELINES,371,14,385,5,477,21,498,888
2018,78208,ELANCOURT,200058782,CA DE SAINT QUENTIN EN YVELINES,78,YVELINES,335,5,340,12,403,7,410,761
2018,78361,MANTES LA JOLIE,200059889,CU GRAND PARIS SEINE ET OISE,78,YVELINES,304,45,349,49,184,13,197,595
2018,78440,LES MUREAUX,200059889,CU GRAND PARIS SEINE ET OISE,78,YVELINES,258,33,291,80,177,5,182,553
2018,78481,LE PECQ,200058519,CA SAINT GERMAIN BOUCLES DE SEINE,78,YVELINES,167,17,184,5,157,26,183,372
2018,78551,SAINT GERMAIN EN LAYE,200058519,CA SAINT GERMAIN BOUCLES DE SEINE,78,YVELINES,479,99,578,11,246,98,344,933
2018,78621,TRAPPES,200058782,CA DE SAINT QUENTIN EN YVELINES,78,YVELINES,293,10,303,121,292,7,299,723
2018,78624,TRIEL SUR SEINE,200059889,CU GRAND PARIS SEINE ET OISE,78,YVELINES,45,27,72,0,165,7,172,244
2018,78642,VERNEUIL SUR SEINE,200059889,CU GRAND PARIS SEINE ET OISE,78,YVELINES,76,28,104,0,221,9,230,334
2018,78674,VILLEPREUX,200058782,CA DE SAINT QUENTIN EN YVELINES,78,YVELINES,65,29,94,0,165,6,171,266
2018,80021,AMIENS,248000531,CA AMIENS METROPOLE,80,SOMME,1118,62,1180,454,1231,56,1287,2921
2018,81105,GRAULHET,200066124,CA GAILLAC-GRAULHET,81,TARN,91,0,91,56,60,1,61,208
2018,81140,LAVAUR,200034023,CC TARN-AGOUT,81,TARN,125,0,125,13,133,4,137,275
2018,82112,MOISSAC,200066322,CC TERRES DES CONFLUENCES,82,TARN ET GARONNE,55,0,55,46,101,1,102,203
2018,82121,MONTAUBAN,248200099,CA GRAND MONTAUBAN,82,TARN ET GARONNE,459,65,524,135,504,23,527,1185
2018,83023,BRIGNOLES,200068104,CA DE LA PROVENCE VERTE,83,VAR,110,6,116,4,196,3,199,320
2018,83042,COGOLIN,200036077,CC DU GOLFE DE SAINT-TROPEZ,83,VAR,108,0,108,0,91,0,91,199
2018,83050,DRAGUIGNAN,248300493,CA DRACENIE PROVENCE VERDON AGGLOMERATION,83,VAR,240,14,254,14,300,22,322,591
2018,83073,LE LUC,248300550,CC COEUR DU VAR,83,VAR,90,1,91,0,86,3,89,180
2018,83098,LE PRADET,248300543,METROPOLE TOULON-PROVENCE-MEDITERRANEE,83,VAR,76,2,78,0,71,2,73,151
2018,83107,ROQUEBRUNE SUR ARGENS,200035319,CA VAR ESTEREL MEDITERRANEE (CAVEM),83,VAR,94,0,94,0,105,5,110,205
2018,83118,SAINT RAPHAEL,200035319,CA VAR ESTEREL MEDITERRANEE (CAVEM),83,VAR,213,19,232,17,156,10,166,414
2018,83123,SANARY SUR MER,248300394,CA SUD SAINTE BAUME,83,VAR,111,14,125,0,69,4,73,197
2018,83126,LA SEYNE SUR MER,248300543,METROPOLE TOULON-PROVENCE-MEDITERRANEE,83,VAR,378,123,501,109,413,30,443,1053
2018,83130,SOLLIES PONT,248300410,CC DE LA VALLEE DU GAPEAU,83,VAR,75,6,81,16,122,2,124,221
2018,83144,LA VALETTE DU VAR,248300543,METROPOLE TOULON-PROVENCE-MEDITERRANEE,83,VAR,155,9,164,0,222,14,236,400
2018,84003,APT,200040624,CC PAYS D'APT-LUBERON,84,VAUCLUSE,80,0,80,30,77,2,79,189
2018,84031,CARPENTRAS,248400053,CA VENTOUX-COMTAT-VENAISSIN (COVE),84,VAUCLUSE,198,3,201,9,164,8,172,382
2018,84087,ORANGE,248400236,CC DU PAYS REUNI D'ORANGE,84,VAUCLUSE,172,5,177,1,243,7,250,429
2018,84129,SORGUES,248400293,CC DES SORGUES DU COMTAT,84,VAUCLUSE,100,21,121,0,146,3,149,270
2018,85047,CHALLANS,200071629,CC CHALLANS-GOIS COMMUNAUTE,85,VENDEE,60,13,73,28,389,3,392,493
2018,86041,BUXEROLLES,200069854,CU DU GRAND POITIERS,86,VIENNE,30,0,30,0,179,3,182,212
2018,86194,POITIERS,200069854,CU DU GRAND POITIERS,86,VIENNE,709,0,709,87,672,49,721,1517
2018,87154,SAINT JUNIEN,200059400,CC PORTE OCEANE DU LIMOUSIN,87,HAUTE VIENNE,40,1,41,0,147,1,148,189
2018,89387,SENS,248900334,CA DU GRAND SENONAIS,89,YONNE,252,0,252,0,242,16,258,510
2018,91103,BRETIGNY SUR ORGE,200057859,CA COEUR D'ESSONNE AGGLOMERATION,91,ESSONNE,253,21,274,0,452,9,461,734
2018,91174,CORBEIL ESSONNES,200059228,CA GRAND PARIS SUD SEINE ESSONNE SENART,91,ESSONNE,346,5,351,110,376,12,388,849
2018,91201,DRAVEIL,200058477,CA VAL D'YERRES VAL DE SEINE,91,ESSONNE,411,1,412,12,302,5,307,731
2018,91286,GRIGNY,200059228,CA GRAND PARIS SUD SEINE ESSONNE SENART,91,ESSONNE,177,0,177,183,149,1,150,510
2018,91345,LONGJUMEAU,200056232,CA COMMUNAUTE PARIS-SACLAY,91,ESSONNE,225,2,227,7,262,7,269,502
2018,91421,MONTGERON,200058477,CA VAL D'YERRES VAL DE SEINE,91,ESSONNE,210,1,211,15,282,11,293,518
2018,91549,SAINTE GENEVIEVE DES BOIS,200057859,CA COEUR D'ESSONNE AGGLOMERATION,91,ESSONNE,260,20,280,34,412,7,419,734
2018,91552,SAINT GERMAIN LES ARPAJON,200057859,CA COEUR D'ESSONNE AGGLOMERATION,91,ESSONNE,14,5,19,0,181,1,182,201
2018,91645,VERRIERES LE BUISSON,200056232,CA COMMUNAUTE PARIS-SACLAY,91,ESSONNE,147,3,150,2,92,11,103,255
2018,91687,VIRY CHATILLON,200054781,METROPOLE DU GRAND PARIS,91,ESSONNE,356,13,369,17,346,13,359,744
2018,91691,YERRES,200058477,CA VAL D'YERRES VAL DE SEINE,91,ESSONNE,415,8,423,19,338,9,347,789
2018,91692,LES ULIS,200056232,CA COMMUNAUTE PARIS-SACLAY,91,ESSONNE,314,2,316,19,323,9,332,667
2018,92002,ANTONY,200054781,METROPOLE DU GRAND PARIS,92,HAUTS DE SEINE,869,37,906,16,449,145,594,1516
2018,92004,ASNIERES SUR SEINE,200054781,METROPOLE DU GRAND PARIS,92,HAUTS DE SEINE,1229,138,1367,17,503,765,1268,2652
2018,92007,BAGNEUX,200054781,METROPOLE DU GRAND PARIS,92,HAUTS DE SEINE,405,27,432,96,420,44,464,991
2018,92014,BOURG LA REINE,200054781,METROPOLE DU GRAND PARIS,92,HAUTS DE SEINE,327,5,332,1,94,69,163,496
2018,92019,CHATENAY MALABRY,200054781,METROPOLE DU GRAND PARIS,92,HAUTS DE SEINE,404,4,408,41,244,38,282,731
2018,92020,CHATILLON,200054781,METROPOLE DU GRAND PARIS,92,HAUTS DE SEINE,513,52,565,0,318,140,458,1023
2018,92022,CHAVILLE,200054781,METROPOLE DU GRAND PARIS,92,HAUTS DE SEINE,248,28,276,1,152,76,228,505
2018,92026,COURBEVOIE,200054781,METROPOLE DU GRAND PARIS,92,HAUTS DE SEINE,2048,71,2119,22,683,317,1000,3140
2018,92032,FONTENAY AUX ROSES,200054781,METROPOLE DU GRAND PARIS,92,HAUTS DE SEINE,289,17,306,0,186,17,203,509
2018,92044,LEVALLOIS PERRET,200054781,METROPOLE DU GRAND PARIS,92,HAUTS DE SEINE,1180,175,1355,40,261,695,956,2351
2018,92046,MALAKOFF,200054781,METROPOLE DU GRAND PARIS,92,HAUTS DE SEINE,407,5,412,4,222,59,281,697
2018,92048,MEUDON,200054781,METROPOLE DU GRAND PARIS,92,HAUTS DE SEINE,668,16,684,13,307,151,458,1155
2018,92064,SAINT CLOUD,200054781,METROPOLE DU GRAND PARIS,92,HAUTS DE SEINE,485,27,512,5,140,170,310,827
2018,93001,AUBERVILLIERS,200054781,METROPOLE DU GRAND PARIS,93,SEINE SAINT DENIS,655,18,673,64,238,46,284,1020
2018,93010,BONDY,200054781,METROPOLE DU GRAND PARIS,93,SEINE SAINT DENIS,611,5,616,65,321,16,337,1018
2018,93032,GAGNY,200054781,METROPOLE DU GRAND PARIS,93,SEINE SAINT DENIS,285,10,295,0,316,21,337,632
2018,93046,LIVRY GARGAN,200054781,METROPOLE DU GRAND PARIS,93,SEINE SAINT DENIS,315,30,345,0,321,13,334,679
2018,93047,MONTFERMEIL,200054781,METROPOLE DU GRAND PARIS,93,SEINE SAINT DENIS,227,0,227,20,141,6,147,394
2018,93053,NOISY LE SEC,200054781,METROPOLE DU GRAND PARIS,93,SEINE SAINT DENIS,330,3,333,0,258,17,275,608
2018,93057,LES PAVILLONS SOUS BOIS,200054781,METROPOLE DU GRAND PARIS,93,SEINE SAINT DENIS,222,16,238,24,147,14,161,423
2018,93061,LE PRE SAINT GERVAIS,200054781,METROPOLE DU GRAND PARIS,93,SEINE SAINT DENIS,193,2,195,16,128,13,141,352
2018,93063,ROMAINVILLE,200054781,METROPOLE DU GRAND PARIS,93,SEINE SAINT DENIS,403,9,412,0,274,30,304,716
2018,93071,SEVRAN,200054781,METROPOLE DU GRAND PARIS,93,SEINE SAINT DENIS,327,2,329,96,223,9,232,657
2018,94003,ARCUEIL,200054781,METROPOLE DU GRAND PARIS,94,VAL DE MARNE,248,26,274,18,137,34,171,463
2018,94004,BOISSY SAINT LEGER,200054781,METROPOLE DU GRAND PARIS,94,VAL DE MARNE,140,13,153,0,166,6,172,324
2018,94017,CHAMPIGNY SUR MARNE,200054781,METROPOLE DU GRAND PARIS,94,VAL DE MARNE,539,14,553,94,673,51,724,1371
2018,94018,CHARENTON LE PONT,200054781,METROPOLE DU GRAND PARIS,94,VAL DE MARNE,495,21,516,0,173,118,291,807
2018,94052,NOGENT SUR MARNE,200054781,METROPOLE DU GRAND PARIS,94,VAL DE MARNE,504,44,548,20,164,171,335,904
2018,94055,ORMESSON SUR MARNE,200054781,METROPOLE DU GRAND PARIS,94,VAL DE MARNE,105,1,106,0,83,6,89,195
2018,94068,SAINT MAUR DES FOSSES,200054781,METROPOLE DU GRAND PARIS,94,VAL DE MARNE,749,96,845,42,524,148,672,1558
2018,94069,SAINT MAURICE,200054781,METROPOLE DU GRAND PARIS,94,VAL DE MARNE,232,6,238,0,86,39,125,364
2018,94074,VALENTON,200054781,METROPOLE DU GRAND PARIS,94,VAL DE MARNE,122,1,123,60,62,7,69,252
2018,94079,VILLIERS SUR MARNE,200054781,METROPOLE DU GRAND PARIS,94,VAL DE MARNE,254,24,278,0,258,22,280,559
2018,95019,ARNOUVILLE,200055655,CA ROISSY PAYS DE FRANCE,95,VAL D OISE,90,0,90,8,73,6,79,177
2018,95197,DEUIL LA BARRE,200056380,CA PLAINE VALLEE,95,VAL D OISE,80,33,113,21,319,9,328,462
2018,95219,ERMONT,200058485,CA VAL PARISIS,95,VAL D OISE,168,12,180,0,378,31,409,589
2018,95351,LOUVRES,200055655,CA ROISSY PAYS DE FRANCE,95,VAL D OISE,68,0,68,0,88,0,88,156
2018,95428,MONTMORENCY,200056380,CA PLAINE VALLEE,95,VAL D OISE,100,21,121,10,221,26,247,378
2018,95539,SAINT BRICE SOUS FORET,200056380,CA PLAINE VALLEE,95,VAL D OISE,105,8,113,0,194,13,207,321
2018,95680,VILLIERS LE BEL,200055655,CA ROISSY PAYS DE FRANCE,95,VAL D OISE,200,0,200,6,172,8,180,386
2018,97117,LE MOULE,200044691,CA DU NORD GRANDE TERRE,971,GUADELOUPE,68,44,112,56,79,9,88,256
2018,97209,FORT DE FRANCE,249720061,CA DU CENTRE DE LA MARTINIQUE,972,MARTINIQUE,829,25,854,299,204,19,223,1376
2018,97230,LA TRINITE,200041788,CA DU PAYS NORD MARTINIQUE,972,MARTINIQUE,100,13,113,19,47,6,53,185
2018,97306,MANA,249730037,CC DE L'OUEST GUYANAIS,973,GUYANE,0,0,0,22,0,4,4,26
2018,97311,SAINT LAURENT DU MARONI,249730037,CC DE L'OUEST GUYANAIS,973,GUYANE,99,0,99,0,59,6,65,164
2018,97407,LE PORT,249740101,CA TERRITOIRE DE LA COTE OUEST (TCO),974,LA REUNION,265,28,293,108,66,9,75,476
2018,97416,SAINT PIERRE,249740077,CA CIVIS (COMMUNAUTE INTERCOMMUNALE DES VILLES SOLIDAIRES),974,LA REUNION,502,321,823,135,348,70,418,1376
2019,01004,AMBERIEU EN BUGEY,240100883,CC DE LA PLAINE DE L'AIN,01,AIN,98,8,106,0,307,4,311,417
2019,01173,GEX,240100750,CA DU PAYS DE GEX,01,AIN,78,8,86,0,178,6,184,270
2019,01320,REPLONGES,200071371,CC BRESSE ET SAONE,01,AIN,18,0,18,0,116,1,117,135
2019,01321,REVONNAS,200071751,CA DU BASSIN DE BOURG-EN-BRESSE,01,AIN,0,2,2,0,12,0,12,14
2019,01325,RIGNIEUX LE FRANC,240100883,CC DE LA PLAINE DE L'AIN,01,AIN,0,0,0,0,27,0,27,28
2019,01328,ROMANS,200069193,CC DE LA DOMBES,01,AIN,0,0,0,0,3,0,3,3
2019,02168,CHATEAU THIERRY,200072031,CA DE LA REGION DE CHATEAU-THIERRY,02,AISNE,102,4,106,48,214,5,219,373
2019,02810,VILLERS COTTERETS,200071991,CC RETZ EN VALOIS,02,AISNE,24,10,34,0,167,0,167,201
2019,06012,BEAUSOLEIL,240600551,CA DE LA RIVIERA FRANCAISE,06,ALPES MARITIMES,47,0,47,11,59,2,61,119
2019,06069,GRASSE,200039857,CA DU PAYS DE GRASSE,06,ALPES MARITIMES,440,30,470,31,432,18,450,951
2019,06152,VALBONNE,240600585,CA DE SOPHIA ANTIPOLIS,06,ALPES MARITIMES,206,0,206,0,165,6,171,377
2019,07010,ANNONAY,200072015,CA ANNONAY RHONE AGGLO,07,ARDECHE,122,15,137,57,99,2,101,295
2019,08409,SEDAN,200041630,CA ARDENNE METROPOLE,08,ARDENNES,65,22,87,60,81,3,84,231
2019,10081,LA CHAPELLE SAINT LUC,200069250,CA TROYES CHAMPAGNE METROPOLE,10,AUBE,78,0,78,71,81,6,87,236
2019,11069,CARCASSONNE,200035715,CA CARCASSONNE AGGLO,11,AUDE,216,1,217,101,289,22,311,629
2019,11262,NARBONNE,241100593,CA LE GRAND NARBONNE,11,AUDE,258,14,272,81,345,20,365,718
2019,13007,AURIOL,200054807,METROPOLE D'AIX-MARSEILLE-PROVENCE,13,BOUCHES DU RHONE,72,1,73,0,131,2,133,205
2019,13077,PORT DE BOUC,200054807,METROPOLE D'AIX-MARSEILLE-PROVENCE,13,BOUCHES DU RHONE,113,1,114,69,86,1,87,270
2019,13108,TARASCON,241300417,CA D'ARLES-CRAU-CAMARGUE-MONTAGNETTE,13,BOUCHES DU RHONE,85,1,86,9,68,0,68,163
2019,13117,VITROLLES,200054807,METROPOLE D'AIX-MARSEILLE-PROVENCE,13,BOUCHES DU RHONE,364,17,381,56,264,10,274,711
2019,13207,MARSEILLE 7E ARRONDISSEMENT,200054807,METROPOLE D'AIX-MARSEILLE-PROVENCE,13,BOUCHES DU RHONE,350,77,427,20,269,72,341,789
2019,21166,CHENOVE,242100410,DIJON METROPOLE,21,COTE D OR,96,5,101,80,115,2,117,298
2019,22093,LAMBALLE ARMOR,200069391,CA LAMBALLE TERRE ET MER,22,COTES D ARMOR,46,4,50,35,348,3,351,436
2019,23096,GUERET,200034825,CA DU GRAND GUERET,23,CREUSE,82,0,82,25,148,1,149,256
2019,25580,VALENTIGNEY,200065647,CA PAYS DE MONTBELIARD AGGLOMERATION,25,DOUBS,37,0,37,37,74,1,75,149
2019,26252,PORTES LES VALENCE,200068781,CA VALENCE ROMANS AGGLO,26,DROME,40,1,41,9,161,3,164,214
2019,27375,LOUVIERS,200089456,CA SEINE-EURE,27,EURE,213,0,213,32,205,4,209,454
2019,28218,LUCE,200033181,CA CHARTRES METROPOLE,28,EURE ET LOIR,140,3,143,0,195,6,201,344
2019,28404,VERNOUILLET,200040277,CA AGGLO DU PAYS DE DREUX,28,EURE ET LOIR,98,4,102,8,153,10,163,273
2019,29046,DOUARNENEZ,242900645,CC DOUARNENEZ COMMUNAUTE,29,FINISTERE,48,1,49,49,124,5,129,227
2019,29235,LE RELECQ KERHUON,242900314,BREST METROPOLE,29,FINISTERE,42,2,44,29,195,14,209,281
2019,30032,BEAUCAIRE,243000585,CC BEAUCAIRE TERRE D'ARGENCE,30,GARD,105,0,105,36,93,3,96,238
2019,30351,VILLENEUVE LES AVIGNON,248400251,CA DU GRAND AVIGNON (COGA),30,GARD,89,9,98,11,66,5,71,181
2019,31424,PLAISANCE DU TOUCH,243100781,CC DE LA SAVE AU TOUCH,31,HAUTE GARONNE,102,7,109,5,296,8,304,419
2019,31557,TOURNEFEUILLE,243100518,TOULOUSE METROPOLE,31,HAUTE GARONNE,258,13,271,0,280,35,315,586
2019,33039,BEGLES,243300316,BORDEAUX METROPOLE,33,GIRONDE,178,29,207,7,423,15,438,651
2019,33243,LIBOURNE,200070092,CA DU LIBOURNAIS,33,GIRONDE,222,7,229,0,222,9,231,460
2019,34129,LATTES,243400017,MONTPELLIER MEDITERRANEE METROPOLE,34,HERAULT,228,6,234,0,128,12,140,375
2019,34172,MONTPELLIER,243400017,MONTPELLIER MEDITERRANEE METROPOLE,34,HERAULT,2634,143,2777,262,1690,262,1952,4990
2019,34301,SETE,200066355,CA SETE AGGLOPOLE MEDITERRANEE,34,HERAULT,225,49,274,38,154,12,166,478
2019,35051,CESSON SEVIGNE,243500139,RENNES METROPOLE,35,ILLE ET VILAINE,222,16,238,25,224,15,239,502
2019,35210,PACE,243500139,RENNES METROPOLE,35,ILLE ET VILAINE,60,5,65,26,178,9,187,278
2019,35238,RENNES,243500139,RENNES METROPOLE,35,ILLE ET VILAINE,1829,195,2024,688,2008,229,2237,4949
2019,37003,AMBOISE,200043065,CC DU VAL D AMBOISE,37,INDRE ET LOIRE,60,0,60,8,192,2,194,262
2019,37195,LA RICHE,243700754,TOURS METROPOLE VAL DE LOIRE,37,INDRE ET LOIRE,70,17,87,12,157,1,158,257
2019,38151,ECHIROLLES,200040715,GRENOBLE-ALPES-METROPOLE,38,ISERE,285,26,311,105,383,11,394,811
2019,38553,VILLEFONTAINE,243800604,CA PORTE DE L'ISERE (CAPI),38,ISERE,168,20,188,34,263,7,270,492
2019,40088,DAX,244000675,CA DU GRAND DAX,40,LANDES,202,2,204,45,115,12,127,376
2019,42184,RIORGES,200035731,CA ROANNAIS AGGLOMERATION,42,LOIRE,42,1,43,8,151,1,152,203
2019,44003,ANCENIS SAINT GEREON,244400552,CC DU PAYS D'ANCENIS,44,LOIRE ATLANTIQUE,40,2,42,19,232,3,235,296
2019,44069,GUERANDE,244400610,CA DE LA PRESQU'ILE DE GUERANDE ATLANTIQUE (CAP ATLANTIQUE),44,LOIRE ATLANTIQUE,70,1,71,29,245,7,252,352
2019,44154,SAINT BREVIN LES PINS,244400586,CC DU SUD ESTUAIRE,44,LOIRE ATLANTIQUE,42,14,56,6,190,5,195,257
2019,45004,AMILLY,244500203,CA MONTARGOISE ET RIVES DU LOING (AME),45,LOIRET,110,2,112,0,175,2,177,288
2019,45068,CHALETTE SUR LOING,244500203,CA MONTARGOISE ET RIVES DU LOING (AME),45,LOIRET,100,4,104,59,105,0,105,268
2019,45075,LA CHAPELLE SAINT MESMIN,244500468,ORLEANS METROPOLE,45,LOIRET,59,11,70,0,158,4,162,232
2019,45147,FLEURY LES AUBRAIS,244500468,ORLEANS METROPOLE,45,LOIRET,141,19,160,0,289,12,301,461
2019,45285,SAINT JEAN DE LA RUELLE,244500468,ORLEANS METROPOLE,45,LOIRET,170,9,179,37,206,5,211,427
2019,46042,CAHORS,200023737,CA DU GRAND CAHORS,46,LOT,149,0,149,28,216,3,219,396
2019,48095,MENDE,244800405,CC COEUR DE LOZERE,48,LOZERE,109,0,109,60,126,2,128,297
2019,49015,AVRILLE,244900015,CU ANGERS LOIRE METROPOLE,49,MAINE ET LOIRE,79,34,113,7,236,12,248,367
2019,49218,MONTREVAULT SUR EVRE,200060010,CA MAUGES COMMUNAUTE,49,MAINE ET LOIRE,36,4,40,25,282,8,290,354
2019,49307,LOIRE AUTHION,244900015,CU ANGERS LOIRE METROPOLE,49,MAINE ET LOIRE,30,14,44,40,319,6,325,409
2019,49328,SAUMUR,200071876,CA SAUMUR VAL DE LOIRE,49,MAINE ET LOIRE,160,27,187,104,263,15,278,568
2019,49353,TRELAZE,244900015,CU ANGERS LOIRE METROPOLE,49,MAINE ET LOIRE,84,37,121,86,319,18,337,544
2019,50041,LA HAGUE,200067205,CA DU COTENTIN,50,MANCHE,22,0,22,19,231,4,235,276
2019,50218,GRANVILLE,200042604,CC DE GRANVILLE,50,MANCHE,135,0,135,34,81,5,86,255
2019,52448,SAINT DIZIER,200068666,CA DE SAINT-DIZIER DER ET BLAISE,52,HAUTE MARNE,137,0,137,82,209,3,212,431
2019,54323,LONGWY,245400262,CA DE LONGWY,54,MEURTHE ET MOSELLE,85,0,85,26,70,2,72,183
2019,54329,LUNEVILLE,200070324,CC DU TERRITOIRE DE LUNEVILLE A BACCARAT,54,MEURTHE ET MOSELLE,96,0,96,51,190,2,192,339
2019,54431,PONT A MOUSSON,200041515,CC DU BASSIN DE PONT-A-MOUSSON,54,MEURTHE ET MOSELLE,50,0,50,19,153,4,157,226
2019,54580,VILLERUPT,245701404,CC DU PAYS HAUT VAL D'ALZETTE,54,MEURTHE ET MOSELLE,30,1,31,0,25,0,25,56
2019,56007,AURAY,200043123,CC AURAY QUIBERON TERRE ATLANTIQUE,56,MORBIHAN,45,1,46,66,138,6,144,256
2019,56098,LANESTER,200042174,CA LORIENT AGGLOMERATION,56,MORBIHAN,104,7,111,93,300,5,305,509
2019,56178,PONTIVY,245614433,CC PONTIVY COMMUNAUTE,56,MORBIHAN,45,0,45,69,181,3,184,298
2019,56206,SAINT AVE,200067932,CA GOLFE DU MORBIHAN - VANNES AGGLOMERATION,56,MORBIHAN,45,3,48,54,208,12,220,321
2019,57019,AMNEVILLE,245701271,CC DU PAYS ORNE MOSELLE,57,MOSELLE,60,1,61,19,180,1,181,260
2019,57206,FAMECK,245701222,CA DU VAL DE FENSCH,57,MOSELLE,50,8,58,51,110,0,110,219
2017,62525,LONGUENESSE,200069037,CA DU PAYS DE SAINT-OMER,62,PAS DE CALAIS,45,1,46,39,137,0,137,222
2017,62548,MARCK,246201149,CA DU CALAISIS,62,PAS DE CALAIS,47,1,48,18,120,1,121,187
2017,62570,MERICOURT,246200364,CA DE LENS - LIEVIN,62,PAS DE CALAIS,10,12,22,42,75,0,75,139
2017,63032,BEAUMONT,246300701,CLERMONT AUVERGNE METROPOLE,63,PUY DE DOME,61,18,79,0,167,7,174,253
2017,63284,PONT DU CHATEAU,246300701,CLERMONT AUVERGNE METROPOLE,63,PUY DE DOME,30,15,45,1,251,4,255,301
2017,63300,RIOM,200070753,CA RIOM LIMAGNE ET VOLCANS,63,PUY DE DOME,123,16,139,29,211,6,217,385
2017,64260,HENDAYE,200067106,CA DU PAYS BASQUE,64,PYRENEES ATLANTIQUES,86,13,99,17,96,4,100,216
2017,64545,URRUGNE,200067106,CA DU PAYS BASQUE,64,PYRENEES ATLANTIQUES,81,16,97,5,52,3,55,157
2017,65440,TARBES,200069300,CA TARBES-LOURDES-PYRENEES,65,HAUTES PYRENEES,360,6,366,129,238,8,246,742
2017,66136,PERPIGNAN,200027183,CU PERPIGNAN MEDITERRANEE METROPOLE,66,PYRENEES ORIENTALES,792,76,868,319,514,24,538,1725
2017,66171,SAINT CYPRIEN,246600282,CC SUD-ROUSSILLON,66,PYRENEES ORIENTALES,55,5,60,7,54,1,55,122
2017,67046,BISCHWILLER,200067874,CA DE HAGUENAU,67,BAS RHIN,167,18,185,0,53,3,56,242
2017,67180,HAGUENAU,200067874,CA DE HAGUENAU,67,BAS RHIN,351,65,416,0,241,7,248,665
2017,67204,HOENHEIM,246700488,EUROMETROPOLE DE STRASBOURG,67,BAS RHIN,120,15,135,0,104,6,110,245
2017,67218,ILLKIRCH GRAFFENSTADEN,246700488,EUROMETROPOLE DE STRASBOURG,67,BAS RHIN,380,29,409,0,273,9,282,691
2017,67365,OSTWALD,246700488,EUROMETROPOLE DE STRASBOURG,67,BAS RHIN,130,9,139,0,105,5,110,249
2017,68166,KINGERSHEIM,200066009,CA MULHOUSE ALSACE AGGLOMERATION,68,HAUT RHIN,75,1,76,0,122,3,125,200
2017,69027,BRIGNAIS,246900757,CC DE LA VALLEE DU GARON (CCVG),69,RHONE,85,11,96,17,245,9,254,366
2017,69029,BRON,200046977,METROPOLE DE LYON,69,RHONE,381,21,402,118,354,20,374,894
2017,69091,GIVORS,200046977,METROPOLE DE LYON,69,RHONE,126,9,135,111,165,5,170,416
2017,69244,TASSIN LA DEMI LUNE,200046977,METROPOLE DE LYON,69,RHONE,158,73,231,4,287,24,311,546
2017,69273,CORBAS,200046977,METROPOLE DE LYON,69,RHONE,84,5,89,0,140,2,142,231
2017,69275,DECINES CHARPIEU,200046977,METROPOLE DE LYON,69,RHONE,154,36,190,54,393,7,400,644
2017,69381,LYON 1ER ARRONDISSEMENT,200046977,METROPOLE DE LYON,69,RHONE,280,60,340,8,217,86,303,650
2017,69382,LYON 2E ARRONDISSEMENT,200046977,METROPOLE DE LYON,69,RHONE,406,78,484,5,250,129,379,868
2017,69386,LYON 6E ARRONDISSEMENT,200046977,METROPOLE DE LYON,69,RHONE,568,148,716,49,409,231,640,1405
2017,69387,LYON 7E ARRONDISSEMENT,200046977,METROPOLE DE LYON,69,RHONE,788,168,956,17,892,189,1081,2053
2017,70285,HERICOURT,247000722,CC DU PAYS D'HERICOURT,70,HAUTE SAONE,30,1,31,27,120,2,122,180
2017,71270,MACON,200070308,CA MACONNAIS BEAUJOLAIS AGGLOMERATION,71,SAONE ET LOIRE,250,8,258,55,306,13,319,632
2017,71306,MONTCEAU LES MINES,247100290,CU LE CREUSOT MONTCEAU-LES-MINES,71,SAONE ET LOIRE,66,0,66,59,181,1,182,307
2017,72154,LA FLECHE,247200348,CC DU PAYS FLECHOIS,72,SARTHE,80,0,80,36,217,5,222,338
2017,72181,LE MANS,247200132,CU LE MANS METROPOLE,72,SARTHE,599,16,615,310,2318,98,2416,3341
2017,73011,ALBERTVILLE,200068997,CA ARLYSERE,73,SAVOIE,69,8,77,27,206,0,206,310
2017,73179,LA MOTTE SERVOLEX,200069110,CA DU GRAND CHAMBERY,73,SAVOIE,50,6,56,2,169,5,174,232
2017,74010,ANNECY,200066793,CA DU GRAND ANNECY,74,HAUTE SAVOIE,1251,58,1309,47,1409,74,1483,2839
2017,74012,ANNEMASSE,200011773,CA ANNEMASSE-LES VOIRONS-AGGLOMERATION,74,HAUTE SAVOIE,204,2,206,32,417,6,423,661
2017,74133,GAILLARD,200011773,CA ANNEMASSE-LES VOIRONS-AGGLOMERATION,74,HAUTE SAVOIE,101,0,101,22,97,2,99,222
2017,74224,LA ROCHE SUR FORON,247400724,CC DU PAYS ROCHOIS,74,HAUTE SAVOIE,42,2,44,0,140,2,142,186
2017,74225,RUMILLY,247400740,CC RUMILLY TERRE DE SAVOIE,74,HAUTE SAVOIE,215,21,236,1,179,1,180,417
2017,74281,THONON LES BAINS,200067551,CA THONON AGGLOMERATION,74,HAUTE SAVOIE,165,18,183,1,418,10,428,612
2017,75102,PARIS 2E ARRONDISSEMENT,200054781,METROPOLE DU GRAND PARIS,75,PARIS,375,15,390,15,17,182,199,604
2017,75104,PARIS 4E ARRONDISSEMENT,200054781,METROPOLE DU GRAND PARIS,75,PARIS,602,2,604,24,34,124,158,787
2017,75105,PARIS 5E ARRONDISSEMENT,200054781,METROPOLE DU GRAND PARIS,75,PARIS,1027,2,1029,29,29,203,232,1290
2017,75107,PARIS 7E ARRONDISSEMENT,200054781,METROPOLE DU GRAND PARIS,75,PARIS,578,29,607,68,17,335,352,1027
2017,75111,PARIS 11E ARRONDISSEMENT,200054781,METROPOLE DU GRAND PARIS,75,PARIS,2413,207,2620,80,236,884,1120,3821
2017,75115,PARIS 15E ARRONDISSEMENT,200054781,METROPOLE DU GRAND PARIS,75,PARIS,3962,281,4243,81,447,1491,1938,6262
2017,75119,PARIS 19E ARRONDISSEMENT,200054781,METROPOLE DU GRAND PARIS,75,PARIS,4547,12,4559,198,398,491,889,5647
2017,76217,DIEPPE,247600786,CA DE LA REGION DIEPPOISE,76,SEINE MARITIME,216,0,216,101,222,4,226,544
2017,76231,ELBEUF,200023414,METROPOLE ROUEN NORMANDIE,76,SEINE MARITIME,74,5,79,44,122,1,123,245
2017,76410,MAROMME,200023414,METROPOLE ROUEN NORMANDIE,76,SEINE MARITIME,37,11,48,12,193,2,195,255
2017,76447,MONTIVILLIERS,200084952,CU LE HAVRE SEINE METROPOLE,76,SEINE MARITIME,40,17,57,0,304,2,306,363
2017,77014,AVON,200072346,CA DU PAYS DE FONTAINEBLEAU,77,SEINE ET MARNE,78,4,82,4,196,10,206,292
2017,77058,BUSSY SAINT GEORGES,247700594,CA MARNE ET GONDOIRE,77,SEINE ET MARNE,370,26,396,13,271,14,285,693
2017,77067,CESSON,200059228,CA GRAND PARIS SUD SEINE ESSONNE SENART,77,SEINE ET MARNE,163,1,164,7,91,3,94,265
2017,77108,CHELLES,200057958,CA PARIS - VALLEE DE LA MARNE,77,SEINE ET MARNE,359,22,381,49,747,19,766,1197
2017,77131,COULOMMIERS,200077055,CA COULOMMIERS PAYS DE BRIE,77,SEINE ET MARNE,147,7,154,23,176,2,178,355
2017,77152,DAMMARIE LES LYS,247700057,CA MELUN VAL DE SEINE,77,SEINE ET MARNE,180,0,180,5,352,8,360,545
2017,77186,FONTAINEBLEAU,200072346,CA DU PAYS DE FONTAINEBLEAU,77,SEINE ET MARNE,99,9,108,13,116,14,130,251
2017,77251,LIEUSAINT,200059228,CA GRAND PARIS SUD SEINE ESSONNE SENART,77,SEINE ET MARNE,135,2,137,0,258,4,262,399
2017,77284,MEAUX,200072130,CA DU PAYS DE MEAUX,77,SEINE ET MARNE,498,10,508,44,639,7,646,1198
2017,77294,MITRY MORY,200055655,CA ROISSY PAYS DE FRANCE,77,SEINE ET MARNE,91,0,91,2,331,2,333,427
2017,77407,SAINT FARGEAU PONTHIERRY,247700057,CA MELUN VAL DE SEINE,77,SEINE ET MARNE,104,0,104,0,243,4,247,351
2017,77445,SAVIGNY LE TEMPLE,200059228,CA GRAND PARIS SUD SEINE ESSONNE SENART,77,SEINE ET MARNE,250,1,251,61,374,7,381,694
2017,77468,TORCY,200057958,CA PARIS - VALLEE DE LA MARNE,77,SEINE ET MARNE,294,30,324,19,249,12,261,603
2017,78015,ANDRESY,200059889,CU GRAND PARIS SEINE ET OISE,78,YVELINES,95,4,99,13,204,9,213,324
2017,78073,BOIS D ARCY,247800584,CA VERSAILLES GRAND PARC (CAVGP),78,YVELINES,222,6,228,14,172,17,189,431
2017,78126,LA CELLE SAINT CLOUD,247800584,CA VERSAILLES GRAND PARC (CAVGP),78,YVELINES,258,11,269,12,157,40,197,478
2017,78146,CHATOU,200058519,CA SAINT GERMAIN BOUCLES DE SEINE,78,YVELINES,453,14,467,11,257,119,376,854
2017,78361,MANTES LA JOLIE,200059889,CU GRAND PARIS SEINE ET OISE,78,YVELINES,368,35,403,55,189,15,204,662
2017,78372,MARLY LE ROI,200058519,CA SAINT GERMAIN BOUCLES DE SEINE,78,YVELINES,232,11,243,0,204,20,224,467
2017,78423,MONTIGNY LE BRETONNEUX,200058782,CA DE SAINT QUENTIN EN YVELINES,78,YVELINES,541,3,544,41,426,25,451,1036
2017,78490,PLAISIR,200058782,CA DE SAINT QUENTIN EN YVELINES,78,YVELINES,236,43,279,41,363,13,376,696
2017,78498,POISSY,200059889,CU GRAND PARIS SEINE ET OISE,78,YVELINES,651,26,677,1,341,23,364,1042
2017,78640,VELIZY VILLACOUBLAY,247800584,CA VERSAILLES GRAND PARC (CAVGP),78,YVELINES,555,8,563,1,215,10,225,790
2017,78650,LE VESINET,200058519,CA SAINT GERMAIN BOUCLES DE SEINE,78,YVELINES,233,6,239,24,47,53,100,363
2017,78686,VIROFLAY,247800584,CA VERSAILLES GRAND PARC (CAVGP),78,YVELINES,204,16,220,0,78,86,164,384
2017,78688,VOISINS LE BRETONNEUX,200058782,CA DE SAINT QUENTIN EN YVELINES,78,YVELINES,110,2,112,4,122,7,129,246
2017,79191,NIORT,200041317,CA DU NIORTAIS,79,DEUX SEVRES,373,0,373,93,648,30,678,1144
2017,81140,LAVAUR,200034023,CC TARN-AGOUT,81,TARN,125,0,125,11,128,2,130,266
2017,82033,CASTELSARRASIN,200066322,CC TERRES DES CONFLUENCES,82,TARN ET GARONNE,90,0,90,2,130,2,132,225
2017,82112,MOISSAC,200066322,CC TERRES DES CONFLUENCES,82,TARN ET GARONNE,55,0,55,64,106,0,106,225
2017,82121,MONTAUBAN,248200099,CA GRAND MONTAUBAN,82,TARN ET GARONNE,459,60,519,103,535,27,562,1184
2017,83049,CUERS,200027100,CC MEDITERRANEE PORTE DES MAURES,83,VAR,50,1,51,4,163,2,165,220
2017,83050,DRAGUIGNAN,248300493,CA DRACENOISE,83,VAR,240,12,252,15,295,23,318,585
2017,83098,LE PRADET,248300543,METROPOLE TOULON-PROVENCE-MEDITERRANEE,83,VAR,76,2,78,7,79,1,80,165
2017,83123,SANARY SUR MER,248300394,CA SUD SAINTE BAUME,83,VAR,111,13,124,12,70,5,75,211
2017,83148,VIDAUBAN,248300493,CA DRACENOISE,83,VAR,20,3,23,0,129,9,138,162
2017,84054,L'ISLE SUR LA SORGUE,248400319,CC DU PAYS DES SORGUES ET DES MONTS DE VAUCLUSE,84,VAUCLUSE,95,8,103,0,145,9,154,257
2017,84080,MONTEUX,248400293,CC DES SORGUES DU COMTAT,84,VAUCLUSE,71,1,72,0,183,0,183,255
2017,84092,LE PONTET,248400251,CA DU GRAND AVIGNON (COGA),84,VAUCLUSE,67,13,80,0,161,3,164,243
2017,84129,SORGUES,248400293,CC DES SORGUES DU COMTAT,84,VAUCLUSE,100,19,119,7,134,1,135,261
2017,85109,LES HERBIERS,248500621,CC DU PAYS DES HERBIERS,85,VENDEE,81,30,111,38,304,10,314,463
2017,85194,LES SABLES D OLONNE,200071165,CA LES SABLES D'OLONNE AGGLOMERATION,85,VENDEE,100,26,126,59,403,7,410,595
2017,86066,CHATELLERAULT,248600413,CA GRAND CHATELLERAULT,86,VIENNE,160,0,160,91,293,3,296,547
2017,88160,EPINAL,200068757,CA D'EPINAL,88,VOSGES,224,0,224,91,246,8,254,569
2017,91021,ARPAJON,200057859,CA COEUR D'ESSONNE AGGLOMERATION,91,ESSONNE,90,2,92,8,113,3,116,216
2017,91114,BRUNOY,200058477,CA VAL D'YERRES VAL DE SEINE,91,ESSONNE,270,4,274,10,265,7,272,557
2017,91174,CORBEIL ESSONNES,200059228,CA GRAND PARIS SUD SEINE ESSONNE SENART,91,ESSONNE,346,4,350,108,400,6,406,864
2017,91201,DRAVEIL,200058477,CA VAL D'YERRES VAL DE SEINE,91,ESSONNE,411,0,411,12,310,7,317,740
2017,91286,GRIGNY,200059228,CA GRAND PARIS SUD SEINE ESSONNE SENART,91,ESSONNE,222,0,222,157,167,3,170,549
2017,91549,SAINTE GENEVIEVE DES BOIS,200057859,CA COEUR D'ESSONNE AGGLOMERATION,91,ESSONNE,260,6,266,37,430,14,444,747
2017,91645,VERRIERES LE BUISSON,200056232,CA COMMUNAUTE PARIS-SACLAY,91,ESSONNE,147,1,148,0,118,15,133,281
2017,91692,LES ULIS,200056232,CA COMMUNAUTE PARIS-SACLAY,91,ESSONNE,314,0,314,21,288,9,297,632
2017,92020,CHATILLON,200054781,METROPOLE DU GRAND PARIS,92,HAUTS DE SEINE,465,15,480,0,304,127,431,911
2017,92026,COURBEVOIE,200054781,METROPOLE DU GRAND PARIS,92,HAUTS DE SEINE,1963,51,2014,23,742,359,1101,3138
2017,92063,RUEIL MALMAISON,200054781,METROPOLE DU GRAND PARIS,92,HAUTS DE SEINE,1364,45,1409,36,371,271,642,2088
2017,92071,SCEAUX,200054781,METROPOLE DU GRAND PARIS,92,HAUTS DE SEINE,300,2,302,0,70,64,134,437
2017,92073,SURESNES,200054781,METROPOLE DU GRAND PARIS,92,HAUTS DE SEINE,832,40,872,1,555,240,795,1669
2017,92075,VANVES,200054781,METROPOLE DU GRAND PARIS,92,HAUTS DE SEINE,305,2,307,5,173,78,251,563
2017,92077,VILLE D AVRAY,200054781,METROPOLE DU GRAND PARIS,92,HAUTS DE SEINE,171,1,172,0,72,31,103,275
2017,93001,AUBERVILLIERS,200054781,METROPOLE DU GRAND PARIS,93,SEINE SAINT DENIS,665,20,685,56,259,27,286,1027
2017,93005,AULNAY SOUS BOIS,200054781,METROPOLE DU GRAND PARIS,93,SEINE SAINT DENIS,792,12,804,118,370,14,384,1307
2017,93006,BAGNOLET,200054781,METROPOLE DU GRAND PARIS,93,SEINE SAINT DENIS,361,13,374,29,183,39,222,625
2017,93010,BONDY,200054781,METROPOLE DU GRAND PARIS,93,SEINE SAINT DENIS,611,3,614,63,359,17,376,1052
2017,93027,LA COURNEUVE,200054781,METROPOLE DU GRAND PARIS,93,SEINE SAINT DENIS,336,0,336,54,134,11,145,535
2017,93032,GAGNY,200054781,METROPOLE DU GRAND PARIS,93,SEINE SAINT DENIS,285,4,289,0,333,18,351,640
2017,93047,MONTFERMEIL,200054781,METROPOLE DU GRAND PARIS,93,SEINE SAINT DENIS,227,1,228,17,142,7,149,394
2017,93048,MONTREUIL,200054781,METROPOLE DU GRAND PARIS,93,SEINE SAINT DENIS,1170,54,1224,64,664,418,1082,2369
2017,93051,NOISY LE GRAND,200054781,METROPOLE DU GRAND PARIS,93,SEINE SAINT DENIS,633,9,642,71,632,33,665,1386
2017,93059,PIERREFITTE SUR SEINE,200054781,METROPOLE DU GRAND PARIS,93,SEINE SAINT DENIS,220,4,224,19,112,5,117,360
2017,93062,LE RAINCY,200054781,METROPOLE DU GRAND PARIS,93,SEINE SAINT DENIS,173,4,177,0,121,22,143,320
2017,93063,ROMAINVILLE,200054781,METROPOLE DU GRAND PARIS,93,SEINE SAINT DENIS,403,4,407,0,254,20,274,681
2017,93070,SAINT OUEN SUR SEINE,200054781,METROPOLE DU GRAND PARIS,93,SEINE SAINT DENIS,592,31,623,23,377,114,491,1137
2017,93072,STAINS,200054781,METROPOLE DU GRAND PARIS,93,SEINE SAINT DENIS,331,9,340,32,99,8,107,479
2017,94004,BOISSY SAINT LEGER,200054781,METROPOLE DU GRAND PARIS,94,VAL DE MARNE,142,13,155,0,154,5,159,314
2017,94019,CHENNEVIERES SUR MARNE,200054781,METROPOLE DU GRAND PARIS,94,VAL DE MARNE,200,4,204,5,125,10,135,344
2017,94037,GENTILLY,200054781,METROPOLE DU GRAND PARIS,94,VAL DE MARNE,261,6,267,71,113,24,137,474
2017,94038,L'HAY LES ROSES,200054781,METROPOLE DU GRAND PARIS,94,VAL DE MARNE,314,35,349,20,263,21,284,653
2017,94043,LE KREMLIN BICETRE,200054781,METROPOLE DU GRAND PARIS,94,VAL DE MARNE,492,3,495,1,203,25,228,724
2017,94046,MAISONS ALFORT,200054781,METROPOLE DU GRAND PARIS,94,VAL DE MARNE,616,14,630,0,523,122,645,1275
2017,94054,ORLY,200054781,METROPOLE DU GRAND PARIS,94,VAL DE MARNE,210,2,212,77,151,5,156,445
2017,94055,ORMESSON SUR MARNE,200054781,METROPOLE DU GRAND PARIS,94,VAL DE MARNE,105,1,106,0,84,9,93,199
2017,94058,LE PERREUX SUR MARNE,200054781,METROPOLE DU GRAND PARIS,94,VAL DE MARNE,397,12,409,0,264,101,365,774
2017,94074,VALENTON,200054781,METROPOLE DU GRAND PARIS,94,VAL DE MARNE,122,2,124,59,66,4,70,253
2017,94076,VILLEJUIF,200054781,METROPOLE DU GRAND PARIS,94,VAL DE MARNE,552,14,566,99,408,36,444,1109
2017,94077,VILLENEUVE LE ROI,200054781,METROPOLE DU GRAND PARIS,94,VAL DE MARNE,194,0,194,0,127,7,134,328
2017,94079,VILLIERS SUR MARNE,200054781,METROPOLE DU GRAND PARIS,94,VAL DE MARNE,254,10,264,0,262,23,285,550
2017,94081,VITRY SUR SEINE,200054781,METROPOLE DU GRAND PARIS,94,VAL DE MARNE,741,50,791,111,428,59,487,1389
2017,95063,BEZONS,200058519,CA SAINT GERMAIN BOUCLES DE SEINE,95,VAL D OISE,225,42,267,33,305,22,327,626
2017,95199,DOMONT,200056380,CA PLAINE VALLEE,95,VAL D OISE,122,24,146,0,193,7,200,346
2017,95219,ERMONT,200058485,CA VAL PARISIS,95,VAL D OISE,168,5,173,0,341,32,373,547
2017,95306,HERBLAY SUR SEINE,200058485,CA VAL PARISIS,95,VAL D OISE,204,4,208,6,428,19,447,661
2017,95351,LOUVRES,200055655,CA ROISSY PAYS DE FRANCE,95,VAL D OISE,68,0,68,2,90,1,91,161
2017,95424,MONTIGNY LES CORMEILLES,200058485,CA VAL PARISIS,95,VAL D OISE,143,7,150,32,247,10,257,439
2017,95476,OSNY,249500109,CA DE CERGY-PONTOISE,95,VAL D OISE,167,19,186,0,201,3,204,390
2017,95487,PERSAN,249500489,CC DU HAUT VAL D'OISE,95,VAL D OISE,57,1,58,19,182,2,184,261
2017,95572,SAINT OUEN L AUMONE,249500109,CA DE CERGY-PONTOISE,95,VAL D OISE,236,13,249,30,286,7,293,572
2017,95582,SANNOIS,200058485,CA VAL PARISIS,95,VAL D OISE,235,4,239,1,380,11,391,630
2017,95680,VILLIERS LE BEL,200055655,CA ROISSY PAYS DE FRANCE,95,VAL D OISE,165,0,165,1,179,8,187,353
2017,97101,LES ABYMES,200018653,CA CAP EXCELLENCE,971,GUADELOUPE,493,26,519,98,274,9,283,901
2017,97113,LE GOSIER,200041507,CA LA RIVIERA DU LEVANT,971,GUADELOUPE,280,28,308,52,134,31,165,525
2017,97115,LAMENTIN,249710062,CA DU NORD BASSE-TERRE,971,GUADELOUPE,66,5,71,34,105,10,115,220
2017,97118,PETIT BOURG,249710062,CA DU NORD BASSE-TERRE,971,GUADELOUPE,25,24,49,61,137,27,164,274
2017,97120,POINTE PITRE,200018653,CA CAP EXCELLENCE,971,GUADELOUPE,180,5,185,70,51,4,55,309
2017,97209,FORT DE FRANCE,249720061,CA DU CENTRE DE LA MARTINIQUE,972,MARTINIQUE,883,18,901,320,209,16,225,1446
2017,97210,LE FRANCOIS,249720053,CA DE L'ESPACE SUD DE LA MARTINIQUE,972,MARTINIQUE,123,17,140,45,50,4,54,239
2017,97213,LE LAMENTIN,249720061,CA DU CENTRE DE LA MARTINIQUE,972,MARTINIQUE,717,51,768,37,140,9,149,954
2017,97224,SAINT JOSEPH,249720061,CA DU CENTRE DE LA MARTINIQUE,972,MARTINIQUE,112,36,148,98,28,5,33,279
2017,97228,SAINTE MARIE,200041788,CA DU PAYS NORD MARTINIQUE,972,MARTINIQUE,40,29,69,53,53,3,56,178
2017,97230,LA TRINITE,200041788,CA DU PAYS NORD MARTINIQUE,972,MARTINIQUE,100,14,114,31,37,7,44,189
2017,97311,SAINT LAURENT DU MARONI,249730037,CC DE L'OUEST GUYANAIS,973,GUYANE,99,0,99,1,53,5,58,158
2017,97353,MARIPASOULA,249730037,CC DE L'OUEST GUYANAIS,973,GUYANE,0,0,0,11,0,0,0,11
2017,97401,LES AVIRONS,249740077,CA CIVIS (COMMUNAUTE INTERCOMMUNALE DES VILLES SOLIDAIRES),974,LA REUNION,0,67,67,9,72,5,77,153
2017,97405,PETITE ILE,249740077,CA CIVIS (COMMUNAUTE INTERCOMMUNALE DES VILLES SOLIDAIRES),974,LA REUNION,55,24,79,18,42,7,49,147
2017,97409,SAINT ANDRE,249740093,CA INTERCOMMUNALE DE LA REUNION EST (CIREST),974,LA REUNION,340,126,466,62,183,30,213,742
2017,97412,SAINT JOSEPH,249740085,CA DU SUD,974,LA REUNION,65,148,213,107,73,23,96,416
2017,97415,SAINT PAUL,249740101,CA TERRITOIRE DE LA COTE OUEST (TCO),974,LA REUNION,365,545,910,295,402,104,506,1710
2017,97418,SAINTE MARIE,249740119,CA INTERCOMMUNALE DU NORD DE LA REUNION (CINOR),974,LA REUNION,360,173,533,8,147,25,172,713
2017,97420,SAINTE SUZANNE,249740119,CA INTERCOMMUNALE DU NORD DE LA REUNION (CINOR),974,LA REUNION,183,72,255,33,102,17,119,406
2018,02173,CHAUNY,200071785,CA CHAUNY TERGNIER LA FERE,02,AISNE,68,13,81,17,158,2,160,258
2018,02738,TERGNIER,200071785,CA CHAUNY TERGNIER LA FERE,02,AISNE,30,14,44,43,186,5,191,278
2018,03321,YZEURE,200071140,CA MOULINS COMMUNAUTE,03,ALLIER,116,0,116,29,127,5,132,277
2018,05023,BRIANCON,240500439,CC DU BRIANCONNAIS,05,HAUTES ALPES,105,2,107,8,76,2,78,193
2018,06027,CAGNES SUR MER,200030195,METROPOLE NICE COTE D'AZUR,06,ALPES MARITIMES,399,39,438,22,413,17,430,890
2018,06030,LE CANNET,200039915,CA CANNES PAYS DE LERINS,06,ALPES MARITIMES,302,30,332,11,250,13,263,606
2018,06033,CARROS,200030195,METROPOLE NICE COTE D'AZUR,06,ALPES MARITIMES,90,17,107,12,148,4,152,271
2018,06069,GRASSE,200039857,CA DU PAYS DE GRASSE,06,ALPES MARITIMES,405,26,431,10,447,13,460,901
2018,06085,MOUGINS,200039915,CA CANNES PAYS DE LERINS,06,ALPES MARITIMES,230,19,249,0,136,14,150,399
2018,06157,VENCE,200030195,METROPOLE NICE COTE D'AZUR,06,ALPES MARITIMES,159,1,160,10,85,4,89,259
2018,10323,ROMILLY SUR SEINE,200000545,CC DES PORTES DE ROMILLY SUR SEINE,10,AUBE,55,0,55,44,144,3,147,246
2018,10387,TROYES,200069250,CA TROYES CHAMPAGNE METROPOLE,10,AUBE,457,0,457,136,303,29,332,925
2018,11076,CASTELNAUDARY,200035855,CC CASTELNAUDARY LAURAGAIS AUDOIS,11,AUDE,40,13,53,34,102,4,106,193
2018,13001,AIX EN PROVENCE,200054807,METROPOLE D'AIX-MARSEILLE-PROVENCE,13,BOUCHES DU RHONE,1338,165,1503,74,972,154,1126,2704
2018,13005,AUBAGNE,200054807,METROPOLE D'AIX-MARSEILLE-PROVENCE,13,BOUCHES DU RHONE,330,13,343,1,388,11,399,743
2018,13007,AURIOL,200054807,METROPOLE D'AIX-MARSEILLE-PROVENCE,13,BOUCHES DU RHONE,72,2,74,0,114,1,115,189
2018,13014,BERRE L ETANG,200054807,METROPOLE D'AIX-MARSEILLE-PROVENCE,13,BOUCHES DU RHONE,72,1,73,11,56,3,59,143
2018,13039,FOS SUR MER,200054807,METROPOLE D'AIX-MARSEILLE-PROVENCE,13,BOUCHES DU RHONE,150,0,150,0,97,4,101,251
2018,13040,FUVEAU,200054807,METROPOLE D'AIX-MARSEILLE-PROVENCE,13,BOUCHES DU RHONE,75,9,84,0,134,2,136,220
2018,13056,MARTIGUES,200054807,METROPOLE D'AIX-MARSEILLE-PROVENCE,13,BOUCHES DU RHONE,569,3,572,24,230,12,242,838
2018,13063,MIRAMAS,200054807,METROPOLE D'AIX-MARSEILLE-PROVENCE,13,BOUCHES DU RHONE,162,2,164,41,126,1,127,332
2018,13081,ROGNAC,200054807,METROPOLE D'AIX-MARSEILLE-PROVENCE,13,BOUCHES DU RHONE,81,5,86,0,145,0,145,231
2018,13097,SAINT MARTIN DE CRAU,241300417,CA D'ARLES-CRAU-CAMARGUE-MONTAGNETTE,13,BOUCHES DU RHONE,112,1,113,6,135,4,139,258
2018,13103,SALON DE PROVENCE,200054807,METROPOLE D'AIX-MARSEILLE-PROVENCE,13,BOUCHES DU RHONE,355,31,386,0,405,29,434,820
2018,13106,SEPTEMES LES VALLONS,200054807,METROPOLE D'AIX-MARSEILLE-PROVENCE,13,BOUCHES DU RHONE,110,5,115,19,72,1,73,207
2018,13108,TARASCON,241300417,CA D'ARLES-CRAU-CAMARGUE-MONTAGNETTE,13,BOUCHES DU RHONE,85,1,86,8,76,0,76,169
2018,13201,MARSEILLE 1ER ARRONDISSEMENT,200054807,METROPOLE D'AIX-MARSEILLE-PROVENCE,13,BOUCHES DU RHONE,249,46,295,14,149,30,179,488
2018,13202,MARSEILLE 2E ARRONDISSEMENT,200054807,METROPOLE D'AIX-MARSEILLE-PROVENCE,13,BOUCHES DU RHONE,316,14,330,67,73,15,88,485
2018,13215,MARSEILLE 15E ARRONDISSEMENT,200054807,METROPOLE D'AIX-MARSEILLE-PROVENCE,13,BOUCHES DU RHONE,478,20,498,316,175,22,197,1011
2018,14366,LISIEUX,200069532,CA LISIEUX NORMANDIE,14,CALVADOS,102,0,102,72,291,2,293,467
2018,16015,ANGOULEME,200071827,CA DU GRAND ANGOULEME,16,CHARENTE,348,13,361,77,201,18,219,657
2018,22113,LANNION,200065928,CA LANNION-TREGOR COMMUNAUTE,22,COTES D ARMOR,130,0,130,34,218,7,225,389
2018,22187,PLERIN,200069409,CA SAINT-BRIEUC ARMOR AGGLOMERATION,22,COTES D ARMOR,99,1,100,38,208,5,213,351
2018,25056,BESANCON,242500361,CU GRAND BESANCON METROPOLE,25,DOUBS,791,128,919,184,1206,53,1259,2361
2018,26057,BOURG DE PEAGE,200068781,CA VALENCE ROMANS AGGLO,26,DROME,20,8,28,8,129,8,137,173
2018,26058,BOURG LES VALENCE,200068781,CA VALENCE ROMANS AGGLO,26,DROME,71,11,82,6,217,9,226,314
2018,26362,VALENCE,200068781,CA VALENCE ROMANS AGGLO,26,DROME,707,22,729,163,483,38,521,1414
2018,27467,PONT AUDEMER,200065787,CC DE PONT-AUDEMER / VAL DE RISLE,27,EURE,20,1,21,31,198,2,200,252
2018,27701,VAL DE REUIL,200089456,CA SEINE-EURE,27,EURE,145,1,146,58,111,1,112,316
2018,28085,CHARTRES,200033181,CA CHARTRES METROPOLE,28,EURE ET LOIR,365,9,374,45,381,24,405,824
2018,29046,DOUARNENEZ,242900645,CC DOUARNENEZ COMMUNAUTE,29,FINISTERE,48,0,48,65,135,6,141,254
2018,29103,LANDERNEAU,242900801,CC DU PAYS DE LANDERNEAU-DAOULAS,29,FINISTERE,60,0,60,79,295,5,300,439
2018,29232,QUIMPER,200068120,CA QUIMPER BRETAGNE OCCIDENTALE,29,FINISTERE,285,14,299,212,764,16,780,1292
2018,29235,LE RELECQ KERHUON,242900314,BREST METROPOLE,29,FINISTERE,42,0,42,49,205,12,217,309
2018,2B033,BASTIA,242000354,CA DE BASTIA,2B,HAUTE CORSE,278,22,300,33,152,8,160,494
2018,31044,BALMA,243100518,TOULOUSE METROPOLE,31,HAUTE GARONNE,184,17,201,0,203,18,221,422
2018,31113,CASTANET TOLOSAN,243100633,CA DU SICOVAL,31,HAUTE GARONNE,139,7,146,4,193,2,195,345
2018,31149,COLOMIERS,243100518,TOULOUSE METROPOLE,31,HAUTE GARONNE,450,3,453,24,436,18,454,931
2018,31446,RAMONVILLE SAINT AGNE,243100633,CA DU SICOVAL,31,HAUTE GARONNE,201,3,204,0,137,6,143,347
2018,31506,SAINT ORENS DE GAMEVILLE,243100518,TOULOUSE METROPOLE,31,HAUTE GARONNE,101,11,112,0,136,8,144,256
2018,31557,TOURNEFEUILLE,243100518,TOULOUSE METROPOLE,31,HAUTE GARONNE,263,9,272,15,317,32,349,636
2018,33005,ANDERNOS LES BAINS,243301504,CA DU BASSIN D'ARCACHON NORD,33,GIRONDE,42,0,42,4,102,2,104,150
2018,33051,BIGANOS,243301504,CA DU BASSIN D'ARCACHON NORD,33,GIRONDE,50,13,63,0,174,2,176,238
2018,33056,BLANQUEFORT,243300316,BORDEAUX METROPOLE,33,GIRONDE,122,12,134,1,254,5,259,394
2018,33063,BORDEAUX,243300316,BORDEAUX METROPOLE,33,GIRONDE,3121,210,3331,140,2192,441,2633,6104
2018,33069,LE BOUSCAT,243300316,BORDEAUX METROPOLE,33,GIRONDE,264,35,299,0,227,36,263,562
2018,33162,EYSINES,243300316,BORDEAUX METROPOLE,33,GIRONDE,168,26,194,0,385,11,396,590
2018,33192,GRADIGNAN,243300316,BORDEAUX METROPOLE,33,GIRONDE,244,14,258,26,206,26,232,516
2018,33199,GUJAN MESTRAS,243300563,CA BASSIN D'ARCACHON SUD-POLE ATLANTIQUE (COBAS),33,GIRONDE,108,6,114,1,223,12,235,350
2018,33281,MERIGNAC,243300316,BORDEAUX METROPOLE,33,GIRONDE,579,36,615,2,997,55,1052,1669
2018,33449,SAINT MEDARD EN JALLES,243300316,BORDEAUX METROPOLE,33,GIRONDE,222,3,225,0,536,12,548,773
2018,34123,JUVIGNAC,243400017,MONTPELLIER MEDITERRANEE METROPOLE,34,HERAULT,70,8,78,0,149,5,154,232
2018,35093,DINARD,243500725,CC COTE D'EMERAUDE,35,ILLE ET VILAINE,45,2,47,26,69,1,70,142
2018,35360,VITRE,200039022,CA VITRE COMMUNAUTE,35,ILLE ET VILAINE,105,3,108,57,320,11,331,497
2018,36044,CHATEAUROUX,243600327,CA CHATEAUROUX METROPOLE,36,INDRE,273,8,281,79,527,10,537,897
2018,37195,LA RICHE,243700754,TOURS METROPOLE VAL DE LOIRE,37,INDRE ET LOIRE,70,7,77,16,156,5,161,254
2018,38053,BOURGOIN JALLIEU,243800604,CA PORTE DE L'ISERE (CAPI),38,ISERE,88,51,139,35,324,10,334,507
2018,38544,VIENNE,200077014,CA VIENNE CONDRIEU,38,ISERE,183,19,202,52,434,4,438,692
2018,40088,DAX,244000675,CA DU GRAND DAX,40,LANDES,202,3,205,52,109,12,121,378
2018,40279,SAINT PAUL LES DAX,244000675,CA DU GRAND DAX,40,LANDES,60,6,66,0,128,8,136,203
2018,41194,ROMORANTIN LANTHENAY,200018406,CC DU ROMORANTINAIS ET DU MONESTOIS,41,LOIR ET CHER,85,0,85,22,198,1,199,306
2018,42187,ROANNE,200035731,CA ROANNAIS AGGLOMERATION,42,LOIRE,207,11,218,87,260,5,265,570
2018,42218,SAINT ETIENNE,244200770,SAINT-ETIENNE METROPOLE,42,LOIRE,999,60,1059,356,1260,58,1318,2732
2018,44003,ANCENIS SAINT GEREON,244400552,CC DU PAYS D'ANCENIS,44,LOIRE ATLANTIQUE,40,4,44,16,245,2,247,307
2018,44026,CARQUEFOU,244400404,NANTES METROPOLE,44,LOIRE ATLANTIQUE,158,1,159,16,344,12,356,531
2018,44047,COUERON,244400404,NANTES METROPOLE,44,LOIRE ATLANTIQUE,104,35,139,0,548,16,564,703
2018,44069,GUERANDE,244400610,CA DE LA PRESQU'ILE DE GUERANDE ATLANTIQUE (CAP ATLANTIQUE),44,LOIRE ATLANTIQUE,70,1,71,30,244,1,245,347
2018,44109,NANTES,244400404,NANTES METROPOLE,44,LOIRE ATLANTIQUE,3181,264,3445,411,3441,696,4137,7993
2018,44131,PORNIC,200067346,CA PORNIC AGGLO PAYS DE RETZ,44,LOIRE ATLANTIQUE,35,4,39,12,202,5,207,258
2018,44143,REZE,244400404,NANTES METROPOLE,44,LOIRE ATLANTIQUE,163,38,201,22,772,35,807,1030
2018,44190,SAINT SEBASTIEN SUR LOIRE,244400404,NANTES METROPOLE,44,LOIRE ATLANTIQUE,142,24,166,7,504,25,529,702
2018,45068,CHALETTE SUR LOING,244500203,CA MONTARGOISE ET RIVES DU LOING (AME),45,LOIRET,100,4,104,53,107,3,110,267
2018,45155,GIEN,244500211,CC GIENNOISES,45,LOIRET,80,5,85,23,124,0,124,232
2018,45284,SAINT JEAN DE BRAYE,244500468,ORLEANS METROPOLE,45,LOIRET,198,28,226,0,283,13,296,522
2018,45285,SAINT JEAN DE LA RUELLE,244500468,ORLEANS METROPOLE,45,LOIRET,165,4,169,18,189,10,199,386
2018,46042,CAHORS,200023737,CA DU GRAND CAHORS,46,LOT,149,0,149,30,242,5,247,426
2018,47323,VILLENEUVE SUR LOT,200023307,CA DU GRAND VILLENEUVOIS,47,LOT ET GARONNE,147,0,147,59,167,5,172,378
2018,49007,ANGERS,244900015,CU ANGERS LOIRE METROPOLE,49,MAINE ET LOIRE,1220,121,1341,309,1483,113,1596,3246
2018,49244,MAUGES SUR LOIRE,200060010,CA MAUGES COMMUNAUTE,49,MAINE ET LOIRE,36,2,38,48,390,5,395,481
2018,49246,LES PONTS DE CE,244900015,CU ANGERS LOIRE METROPOLE,49,MAINE ET LOIRE,40,4,44,9,185,7,192,245
2018,49301,SEVREMOINE,200060010,CA MAUGES COMMUNAUTE,49,MAINE ET LOIRE,50,22,72,56,614,3,617,744
2018,49328,SAUMUR,200071876,CA SAUMUR VAL DE LOIRE,49,MAINE ET LOIRE,170,16,186,98,273,9,282,566
2018,49353,TRELAZE,244900015,CU ANGERS LOIRE METROPOLE,49,MAINE ET LOIRE,84,27,111,85,319,14,333,529
2018,50041,LA HAGUE,200067205,CA DU COTENTIN,50,MANCHE,22,0,22,20,245,3,248,290
2018,51108,CHALONS EN CHAMPAGNE,200066876,CA DE CHALONS-EN-CHAMPAGNE,51,MARNE,476,35,511,54,370,9,379,944
2018,51573,TINQUEUX,200067213,CU DU GRAND REIMS,51,MARNE,58,16,74,4,165,3,168,246
2018,52448,SAINT DIZIER,200068666,CA DE SAINT-DIZIER DER ET BLAISE,52,HAUTE MARNE,137,0,137,104,225,4,229,470
2018,54304,LAXOU,245400676,METROPOLE DU GRAND NANCY,54,MEURTHE ET MOSELLE,189,3,192,18,70,6,76,286
2018,56078,GUIDEL,200042174,CA LORIENT AGGLOMERATION,56,MORBIHAN,30,4,34,49,172,6,178,261
2018,56083,HENNEBONT,200042174,CA LORIENT AGGLOMERATION,56,MORBIHAN,50,2,52,65,220,2,222,339
2018,56121,LORIENT,200042174,CA LORIENT AGGLOMERATION,56,MORBIHAN,291,10,301,270,548,27,575,1146
2018,56162,PLOEMEUR,200042174,CA LORIENT AGGLOMERATION,56,MORBIHAN,100,9,109,42,160,7,167,317
2018,56178,PONTIVY,245614433,CC PONTIVY COMMUNAUTE,56,MORBIHAN,45,0,45,73,187,2,189,307
2018,57019,AMNEVILLE,245701271,CC DU PAYS ORNE MOSELLE,57,MOSELLE,60,1,61,12,190,0,190,263
2018,57206,FAMECK,245701222,CA DU VAL DE FENSCH,57,MOSELLE,50,3,53,43,113,1,114,210
2018,57240,FREYMING MERLEBACH,245700398,CC DE FREYMING-MERLEBACH,57,MOSELLE,0,0,0,23,112,1,113,136
2018,57480,MONTIGNY LES METZ,200039865,METZ METROPOLE,57,MOSELLE,90,9,99,0,274,7,281,380
2018,57660,STIRING WENDEL,245700372,CA DE FORBACH PORTE DE FRANCE,57,MOSELLE,40,0,40,5,50,0,50,95
2018,57672,THIONVILLE,245701362,CA PORTES DE FRANCE-THIONVILLE,57,MOSELLE,238,46,284,4,386,15,401,689
2018,58194,NEVERS,245804406,CA DE NEVERS,58,NIEVRE,258,6,264,54,195,16,211,529
2018,59014,ANZIN,245901160,CA VALENCIENNES METROPOLE,59,NORD,37,1,38,79,103,4,107,223
2018,59152,COMINES,245900410,METROPOLE EUROPEENNE DE LILLE,59,NORD,42,5,47,35,159,1,160,242
2018,59155,COUDEKERQUE BRANCHE,245900428,CU DE DUNKERQUE,59,NORD,62,6,68,86,270,3,273,427
2018,59178,DOUAI,200044618,CA DOUAISIS AGGLO,59,NORD,206,10,216,203,234,7,241,660
2018,59220,FACHES THUMESNIL,245900410,METROPOLE EUROPEENNE DE LILLE,59,NORD,148,22,170,42,326,6,332,544
2018,59271,GRANDE SYNTHE,245900428,CU DE DUNKERQUE,59,NORD,158,4,162,150,141,5,146,459
2018,59299,HEM,245900410,METROPOLE EUROPEENNE DE LILLE,59,NORD,114,55,169,90,253,19,272,531
2018,59328,LAMBERSART,245900410,METROPOLE EUROPEENNE DE LILLE,59,NORD,210,75,285,135,330,38,368,788
2018,59350,LILLE,245900410,METROPOLE EUROPEENNE DE LILLE,59,NORD,1992,340,2332,687,1871,183,2054,5073
2018,59410,MONS EN BAROEUL,245900410,METROPOLE EUROPEENNE DE LILLE,59,NORD,95,14,109,109,254,8,262,480
2018,59426,NEUVILLE EN FERRAIN,245900410,METROPOLE EUROPEENNE DE LILLE,59,NORD,90,7,97,63,122,2,124,284
2018,59491,RAISMES,200042190,CA DE LA PORTE DU HAINAUT,59,NORD,58,0,58,60,119,3,122,240
2018,59526,SAINT AMAND LES EAUX,200042190,CA DE LA PORTE DU HAINAUT,59,NORD,85,0,85,36,221,3,224,345
2018,59544,SAINT SAULVE,245901160,CA VALENCIENNES METROPOLE,59,NORD,150,1,151,38,111,5,116,305
2018,59560,SECLIN,245900410,METROPOLE EUROPEENNE DE LILLE,59,NORD,118,16,134,33,183,1,184,351
2018,59636,WAMBRECHIES,245900410,METROPOLE EUROPEENNE DE LILLE,59,NORD,30,36,66,45,200,9,209,320
2018,59650,WATTRELOS,245900410,METROPOLE EUROPEENNE DE LILLE,59,NORD,205,42,247,173,451,4,455,875
2018,60139,CHAMBLY,200067973,CC THELLOISE,60,OISE,40,0,40,0,205,2,207,247
2018,61006,ARGENTAN,200068450,CC ARGENTAN INTERCOM,61,ORNE,76,0,76,36,197,0,197,309
2018,62193,CALAIS,200090751,CA GRAND CALAIS TERRES ET MERS,62,PAS DE CALAIS,384,11,395,244,426,14,440,1079
2018,63164,GERZAT,246300701,CLERMONT AUVERGNE METROPOLE,63,PUY DE DOME,40,1,41,0,217,3,220,261
2018,64545,URRUGNE,200067106,CA DU PAYS BASQUE,64,PYRENEES ATLANTIQUES,81,16,97,4,59,4,63,165
2018,68063,CERNAY,200036465,CC DE THANN-CERNAY,68,HAUT RHIN,33,9,42,9,135,1,136,188
2018,69089,FRANCHEVILLE,200046977,METROPOLE DE LYON,69,RHONE,89,51,140,0,173,12,185,325
2018,69204,SAINT GENIS LAVAL,200046977,METROPOLE DE LYON,69,RHONE,181,24,205,25,239,21,260,491
2018,69256,VAULX EN VELIN,200046977,METROPOLE DE LYON,69,RHONE,340,7,347,233,370,16,386,966
2018,69273,CORBAS,200046977,METROPOLE DE LYON,69,RHONE,84,3,87,0,146,4,150,237
2018,69282,MEYZIEU,200046977,METROPOLE DE LYON,69,RHONE,225,73,298,72,476,19,495,865
2018,69290,SAINT PRIEST,200046977,METROPOLE DE LYON,69,RHONE,517,42,559,72,540,15,555,1186
2018,71014,AUTUN,200070530,CC DU GRAND AUTUNOIS MORVAN,71,SAONE ET LOIRE,91,0,91,24,117,3,120,236
2018,72181,LE MANS,247200132,CU LE MANS METROPOLE,72,SARTHE,601,27,628,317,2201,84,2285,3230
2018,73065,CHAMBERY,200069110,CA DU GRAND CHAMBERY,73,SAVOIE,485,16,501,114,577,29,606,1221
2018,75102,PARIS 2E ARRONDISSEMENT,200054781,METROPOLE DU GRAND PARIS,75,PARIS,378,14,392,22,21,166,187,601
2018,75110,PARIS 10E ARRONDISSEMENT,200054781,METROPOLE DU GRAND PARIS,75,PARIS,1830,105,1935,18,216,676,892,2845
2018,75115,PARIS 15E ARRONDISSEMENT,200054781,METROPOLE DU GRAND PARIS,75,PARIS,4020,293,4313,66,431,1461,1892,6271
2018,76057,BARENTIN,247600646,CC CAUX - AUSTREBERTHE,76,SEINE MARITIME,72,0,72,2,248,1,249,323
2018,76157,CANTELEU,200023414,METROPOLE ROUEN NORMANDIE,76,SEINE MARITIME,157,3,160,52,141,0,141,353
2018,76216,DEVILLE LES ROUEN,200023414,METROPOLE ROUEN NORMANDIE,76,SEINE MARITIME,40,8,48,4,200,1,201,253
2018,76322,LE GRAND QUEVILLY,200023414,METROPOLE ROUEN NORMANDIE,76,SEINE MARITIME,127,9,136,18,423,6,429,583
2018,94078,VILLENEUVE SAINT GEORGES,200054781,METROPOLE DU GRAND PARIS,94,VAL DE MARNE,210,1,211,36,187,7,194,441
2018,94081,VITRY SUR SEINE,200054781,METROPOLE DU GRAND PARIS,94,VAL DE MARNE,741,66,807,92,382,44,426,1325
2018,95018,ARGENTEUIL,200054781,METROPOLE DU GRAND PARIS,95,VAL D OISE,1006,40,1046,74,950,79,1029,2149
2018,95127,CERGY,249500109,CA DE CERGY-PONTOISE,95,VAL D OISE,629,30,659,93,789,29,818,1570
2018,95199,DOMONT,200056380,CA PLAINE VALLEE,95,VAL D OISE,107,24,131,0,180,5,185,316
2018,95277,GONESSE,200055655,CA ROISSY PAYS DE FRANCE,95,VAL D OISE,274,1,275,32,160,7,167,474
2018,95424,MONTIGNY LES CORMEILLES,200058485,CA VAL PARISIS,95,VAL D OISE,143,8,151,33,249,14,263,447
2018,95500,PONTOISE,249500109,CA DE CERGY-PONTOISE,95,VAL D OISE,335,34,369,18,305,8,313,701
2018,95563,SAINT LEU LA FORET,200058485,CA VAL PARISIS,95,VAL D OISE,97,12,109,0,195,8,203,312
2018,97107,CAPESTERRE BELLE EAU,249710070,CA GRAND SUD CARAIBE,971,GUADELOUPE,25,4,29,57,38,1,39,125
2018,97128,SAINTE ANNE,200041507,CA LA RIVIERA DU LEVANT,971,GUADELOUPE,90,52,142,31,122,3,125,298
2018,97221,RIVIERE SALEE,249720053,CA DE L'ESPACE SUD DE LA MARTINIQUE,972,MARTINIQUE,0,6,6,72,51,5,56,134
2018,97222,LE ROBERT,200041788,CA DU PAYS NORD MARTINIQUE,972,MARTINIQUE,195,53,248,69,68,4,72,389
2018,97302,CAYENNE,249730045,CA DU CENTRE LITTORAL,973,GUYANE,466,9,475,0,137,13,150,625
2018,97307,MATOURY,249730045,CA DU CENTRE LITTORAL,973,GUYANE,296,0,296,1,57,4,61,358
2018,97353,MARIPASOULA,249730037,CC DE L'OUEST GUYANAIS,973,GUYANE,0,0,0,16,0,0,0,16
2018,97415,SAINT PAUL,249740101,CA TERRITOIRE DE LA COTE OUEST (TCO),974,LA REUNION,370,558,928,341,403,93,496,1765
2018,97418,SAINTE MARIE,249740119,CA INTERCOMMUNALE DU NORD DE LA REUNION (CINOR),974,LA REUNION,360,189,549,13,140,23,163,726
2018,97701,SAINT-BARTHELEMY,XX,XX,977,COLLECTIVITE D'OUTRE MER SAINT BARTHELEMY,0,0,0,17,0,2,2,19
2019,01053,BOURG EN BRESSE,200071751,CA DU BASSIN DE BOURG-EN-BRESSE,01,AIN,344,11,355,72,342,11,353,780
2019,01329,ROSSILLON,200040350,CC BUGEY SUD,01,AIN,0,0,0,0,2,0,2,2
2019,02738,TERGNIER,200071785,CA CHAUNY TERGNIER LA FERE,02,AISNE,30,10,40,32,172,2,174,246
2019,03190,MOULINS,200071140,CA MOULINS COMMUNAUTE,03,ALLIER,120,0,120,50,148,4,152,322
2019,06033,CARROS,200030195,METROPOLE NICE COTE D'AZUR,06,ALPES MARITIMES,90,17,107,19,138,6,144,270
2019,06104,ROQUEBRUNE CAP MARTIN,240600551,CA DE LA RIVIERA FRANCAISE,06,ALPES MARITIMES,134,0,134,8,46,1,47,189
2019,06161,VILLENEUVE LOUBET,240600585,CA DE SOPHIA ANTIPOLIS,06,ALPES MARITIMES,177,4,181,0,116,8,124,305
2019,07324,TOURNON SUR RHONE,200073096,CA ARCHE AGGLO,07,ARDECHE,50,0,50,36,109,5,114,200
2019,09225,PAMIERS,200066231,CC DES PORTES D'ARIEGE PYRENEES,09,ARIEGE,183,0,183,13,105,4,109,305
2019,10362,SAINTE SAVINE,200069250,CA TROYES CHAMPAGNE METROPOLE,10,AUBE,65,0,65,0,144,4,148,213
2019,11076,CASTELNAUDARY,200035855,CC CASTELNAUDARY LAURAGAIS AUDOIS,11,AUDE,40,14,54,26,93,4,97,177
2019,12202,RODEZ,241200187,CA RODEZ AGGLOMERATION,12,AVEYRON,211,19,230,62,143,13,156,449
2019,13028,LA CIOTAT,200054807,METROPOLE D'AIX-MARSEILLE-PROVENCE,13,BOUCHES DU RHONE,236,15,251,12,312,16,328,591
2019,13039,FOS SUR MER,200054807,METROPOLE D'AIX-MARSEILLE-PROVENCE,13,BOUCHES DU RHONE,150,0,150,0,104,4,108,258
2019,13040,FUVEAU,200054807,METROPOLE D'AIX-MARSEILLE-PROVENCE,13,BOUCHES DU RHONE,75,8,83,0,147,2,149,232
2019,13054,MARIGNANE,200054807,METROPOLE D'AIX-MARSEILLE-PROVENCE,13,BOUCHES DU RHONE,279,23,302,0,272,6,278,580
2019,13069,PELISSANNE,200054807,METROPOLE D'AIX-MARSEILLE-PROVENCE,13,BOUCHES DU RHONE,72,5,77,1,137,5,142,220
2019,13075,PLAN DE CUQUES,200054807,METROPOLE D'AIX-MARSEILLE-PROVENCE,13,BOUCHES DU RHONE,109,10,119,0,85,1,86,205
2019,13106,SEPTEMES LES VALLONS,200054807,METROPOLE D'AIX-MARSEILLE-PROVENCE,13,BOUCHES DU RHONE,110,4,114,13,73,2,75,203
2019,13110,TRETS,200054807,METROPOLE D'AIX-MARSEILLE-PROVENCE,13,BOUCHES DU RHONE,98,11,109,0,89,3,92,202
2019,13203,MARSEILLE 3E ARRONDISSEMENT,200054807,METROPOLE D'AIX-MARSEILLE-PROVENCE,13,BOUCHES DU RHONE,366,16,382,120,124,19,143,645
2019,13212,MARSEILLE 12E ARRONDISSEMENT,200054807,METROPOLE D'AIX-MARSEILLE-PROVENCE,13,BOUCHES DU RHONE,322,115,437,14,409,44,453,904
2019,14327,HEROUVILLE SAINT CLAIR,200065597,CU CAEN LA MER,14,CALVADOS,255,6,261,57,245,10,255,573
2019,17300,LA ROCHELLE,241700434,CA DE LA ROCHELLE,17,CHARENTE MARITIME,539,30,569,71,600,81,681,1321
2019,22050,DINAN,200068989,CA DINAN AGGLOMERATION,22,COTES D ARMOR,65,4,69,32,89,3,92,193
2019,22278,SAINT BRIEUC,200069409,CA SAINT-BRIEUC ARMOR AGGLOMERATION,22,COTES D ARMOR,278,9,287,126,445,21,466,879
2019,25031,AUDINCOURT,200065647,CA PAYS DE MONTBELIARD AGGLOMERATION,25,DOUBS,90,0,90,44,110,3,113,247
2019,25056,BESANCON,242500361,CU GRAND BESANCON METROPOLE,25,DOUBS,789,158,947,174,1057,48,1105,2225
2019,26198,MONTELIMAR,200040459,CA MONTELIMAR AGGLOMERATION,26,DROME,154,57,211,35,381,10,391,637
2019,27284,GISORS,200071843,CC DU VEXIN NORMAND,27,EURE,109,5,114,0,172,1,173,287
2019,28134,DREUX,200040277,CA AGGLO DU PAYS DE DREUX,28,EURE ET LOIR,270,6,276,46,198,12,210,532
2019,28229,MAINVILLIERS,200033181,CA CHARTRES METROPOLE,28,EURE ET LOIR,79,1,80,44,137,2,139,263
2019,29039,CONCARNEAU,242900769,CA CONCARNEAU CORNOUAILLE AGGLOMERATION,29,FINISTERE,72,2,74,68,185,6,191,333
2019,29189,PLOUGASTEL DAOULAS,242900314,BREST METROPOLE,29,FINISTERE,56,0,56,58,232,7,239,353
2019,30007,ALES,200066918,CA ALES AGGLOMERATION,30,GARD,181,0,181,95,248,8,256,532
2019,30202,PONT SAINT ESPRIT,200034692,CA DU GARD RHODANIEN,30,GARD,60,1,61,19,76,1,77,157
2019,31069,BLAGNAC,243100518,TOULOUSE METROPOLE,31,HAUTE GARONNE,473,1,474,2,226,26,252,727
2019,31555,TOULOUSE,243100518,TOULOUSE METROPOLE,31,HAUTE GARONNE,6188,51,6239,444,2734,729,3463,10147
2019,31588,VILLENEUVE TOLOSANE,243100518,TOULOUSE METROPOLE,31,HAUTE GARONNE,73,15,88,0,152,2,154,243
2019,33238,LEOGNAN,243301264,CC DE MONTESQUIEU,33,GIRONDE,39,15,54,15,172,4,176,245
2019,33522,TALENCE,243300316,BORDEAUX METROPOLE,33,GIRONDE,374,53,427,5,379,40,419,851
2019,34157,MEZE,200066355,CA SETE AGGLOPOLE MEDITERRANEE,34,HERAULT,90,4,94,0,80,1,81,175
2019,35360,VITRE,200039022,CA VITRE COMMUNAUTE,35,ILLE ET VILAINE,105,10,115,50,290,6,296,461
2019,36044,CHATEAUROUX,243600327,CA CHATEAUROUX METROPOLE,36,INDRE,273,9,282,100,510,10,520,901
2019,36088,ISSOUDUN,243600236,CC DU PAYS D'ISSOUDUN,36,INDRE,45,0,45,35,155,0,155,235
2019,37109,FONDETTES,243700754,TOURS METROPOLE VAL DE LOIRE,37,INDRE ET LOIRE,70,4,74,0,168,11,179,253
2019,38085,CHARVIEU CHAVAGNEUX,243800935,CC LYON-SAINT-EXUPERY EN DAUPHINE,38,ISERE,20,52,72,0,260,1,261,332
2019,38185,GRENOBLE,200040715,GRENOBLE-ALPES-METROPOLE,38,ISERE,1620,313,1933,202,1529,82,1611,3746
2019,40046,BISCARROSSE,244000873,CC DES GRANDS LACS,40,LANDES,84,1,85,0,175,2,177,262
2019,40312,TARNOS,244000659,CC DU SEIGNANX,40,LANDES,60,53,113,6,111,9,120,239
2019,42044,LE CHAMBON FEUGEROLLES,244200770,SAINT-ETIENNE METROPOLE,42,LOIRE,86,0,86,35,109,2,111,232
2019,42147,MONTBRISON,200065886,CA LOIRE FOREZ AGGLOMERATION (LFA),42,LOIRE,111,3,114,0,215,5,220,335
2019,42187,ROANNE,200035731,CA ROANNAIS AGGLOMERATION,42,LOIRE,197,15,212,63,266,3,269,544
2019,43157,LE PUY EN VELAY,200073419,CA DU PUY-EN-VELAY,43,HAUTE LOIRE,100,4,104,77,174,4,178,359
2019,44020,BOUGUENAIS,244400404,NANTES METROPOLE,44,LOIRE ATLANTIQUE,161,25,186,9,419,14,433,628
2019,44143,REZE,244400404,NANTES METROPOLE,44,LOIRE ATLANTIQUE,163,50,213,12,786,56,842,1067
2019,44162,SAINT HERBLAIN,244400404,NANTES METROPOLE,44,LOIRE ATLANTIQUE,491,41,532,60,866,34,900,1492
2019,44204,THOUARE SUR LOIRE,244400404,NANTES METROPOLE,44,LOIRE ATLANTIQUE,50,16,66,0,254,3,257,323
2022,37156,MONTLOUIS SUR LOIRE,200073161,CC TOURAINE-EST VALLEES,37,INDRE ET LOIRE,40,3,43,0,229,3,232,274
2022,40046,BISCARROSSE,244000873,CC DES GRANDS LACS,40,LANDES,84,1,85,0,166,1,167,251
2022,41194,ROMORANTIN LANTHENAY,200018406,CC DU ROMORANTINAIS ET DU MONESTOIS,41,LOIR ET CHER,91,0,91,29,210,2,212,332
2022,44036,CHATEAUBRIANT,200072726,CC CHATEAUBRIANT-DERVAL,44,LOIRE ATLANTIQUE,56,0,56,31,110,7,117,204
2022,44109,NANTES,244400404,NANTES METROPOLE,44,LOIRE ATLANTIQUE,3641,400,4041,429,2924,873,3797,8268
2022,44114,ORVAULT,244400404,NANTES METROPOLE,44,LOIRE ATLANTIQUE,253,52,305,17,329,30,359,682
2022,44129,PONTCHATEAU,200000438,CC DU PAYS DE PONTCHATEAU ST-GILDAS-DES-BOIS,44,LOIRE ATLANTIQUE,23,8,31,14,245,4,249,293
2022,44131,PORNIC,200067346,CA PORNIC AGGLO PAYS DE RETZ,44,LOIRE ATLANTIQUE,35,22,57,11,209,2,211,278
2022,44190,SAINT SEBASTIEN SUR LOIRE,244400404,NANTES METROPOLE,44,LOIRE ATLANTIQUE,156,36,192,7,490,24,514,714
2022,45284,SAINT JEAN DE BRAYE,244500468,ORLEANS METROPOLE,45,LOIRET,168,32,200,0,250,8,258,458
2022,49023,BEAUPREAU EN MAUGES,200060010,CA MAUGES COMMUNAUTE,49,MAINE ET LOIRE,72,19,91,38,351,6,357,486
2022,49050,BRISSAC LOIRE AUBANCE,200071553,CC LOIRE LAYON AUBANCE,49,MAINE ET LOIRE,48,10,58,2,159,4,163,223
2022,49246,LES PONTS DE CE,244900015,CU ANGERS LOIRE METROPOLE,49,MAINE ET LOIRE,40,20,60,11,150,4,154,226
2022,49301,SEVREMOINE,200060010,CA MAUGES COMMUNAUTE,49,MAINE ET LOIRE,36,32,68,50,435,3,438,556
2022,49331,SEGRE EN ANJOU BLEU,244900809,CC ANJOU BLEU COMMUNAUTE,49,MAINE ET LOIRE,69,5,74,21,251,6,257,352
2022,50099,CARENTAN LES MARAIS,200042729,CC DE LA BAIE DU COTENTIN,50,MANCHE,24,0,24,24,139,2,141,189
2022,50502,SAINT LO,200066389,CA SAINT-LO AGGLO,50,MANCHE,90,29,119,46,215,1,216,381
2022,52448,SAINT DIZIER,200068666,CA DE SAINT-DIZIER DER ET BLAISE,52,HAUTE MARNE,137,0,137,66,186,9,195,398
2022,53147,MAYENNE,200055887,CC MAYENNE COMMUNAUTE,53,MAYENNE,80,7,87,32,134,3,137,256
2022,54329,LUNEVILLE,200070324,CC DU TERRITOIRE DE LUNEVILLE A BACCARAT,54,MEURTHE ET MOSELLE,96,1,97,41,156,10,166,304
2022,57160,CREUTZWALD,245701164,CC DU WARNDT,57,MOSELLE,58,2,60,15,71,2,73,148
2022,57306,HAYANGE,245701222,CA DU VAL DE FENSCH,57,MOSELLE,55,6,61,0,84,2,86,147
2022,59009,VILLENEUVE D ASCQ,200093201,METROPOLE EUROPEENNE DE LILLE,59,NORD,609,161,770,203,466,35,501,1474
2022,59112,BRUAY SUR L ESCAUT,245901160,CA VALENCIENNES METROPOLE,59,NORD,15,5,20,56,77,3,80,156
2022,59139,CAUDRY,200030633,CA DU CAUDRESIS ET DU CATESIS,59,NORD,45,0,45,46,131,0,131,223
2022,59163,CROIX,200093201,METROPOLE EUROPEENNE DE LILLE,59,NORD,119,59,178,61,239,29,268,507
2022,59178,DOUAI,200044618,CA DOUAISIS AGGLO,59,NORD,216,43,259,173,201,9,210,642
2022,59271,GRANDE SYNTHE,245900428,CU DE DUNKERQUE,59,NORD,150,6,156,139,133,0,133,429
2017,01173,GEX,240100750,CA DU PAYS DE GEX,01,AIN,58,16,74,0,177,2,179,252
2017,01283,OYONNAX,200042935,CA HAUT - BUGEY AGGLOMERATION,01,AIN,69,2,71,108,190,1,191,370
2017,01328,ROMANS,200069193,CC DE LA DOMBES,01,AIN,0,0,0,0,8,0,8,8
2017,02691,SAINT QUENTIN,200071892,CA DU SAINT-QUENTINOIS,02,AISNE,186,41,227,262,489,6,495,984
2017,03190,MOULINS,200071140,CA MOULINS COMMUNAUTE,03,ALLIER,120,0,120,48,171,6,177,345
2017,06012,BEAUSOLEIL,240600551,CA DE LA RIVIERA FRANCAISE,06,ALPES MARITIMES,47,0,47,4,49,1,50,101
2017,06083,MENTON,240600551,CA DE LA RIVIERA FRANCAISE,06,ALPES MARITIMES,204,0,204,9,230,2,232,445
2017,06152,VALBONNE,240600585,CA DE SOPHIA ANTIPOLIS,06,ALPES MARITIMES,208,0,208,0,138,7,145,353
2017,07010,ANNONAY,200072015,CA ANNONAY RHONE AGGLO,07,ARDECHE,122,3,125,56,117,2,119,300
2017,10323,ROMILLY SUR SEINE,200000545,CC DES PORTES DE ROMILLY SUR SEINE,10,AUBE,55,0,55,39,136,2,138,232
2017,13039,FOS SUR MER,200054807,METROPOLE D'AIX-MARSEILLE-PROVENCE,13,BOUCHES DU RHONE,150,0,150,0,105,3,108,258
2017,13071,LES PENNES MIRABEAU,200054807,METROPOLE D'AIX-MARSEILLE-PROVENCE,13,BOUCHES DU RHONE,165,18,183,15,175,8,183,381
2017,13214,MARSEILLE 14E ARRONDISSEMENT,200054807,METROPOLE D'AIX-MARSEILLE-PROVENCE,13,BOUCHES DU RHONE,374,13,387,140,164,10,174,701
2017,14341,IFS,200065597,CU CAEN LA MER,14,CALVADOS,58,6,64,0,213,4,217,280
2017,16102,COGNAC,200070514,CA DU GRAND COGNAC,16,CHARENTE,145,0,145,36,157,11,168,349
2017,17306,ROYAN,241700640,CA ROYAN ATLANTIQUE,17,CHARENTE MARITIME,49,0,49,39,112,5,117,205
2017,18279,VIERZON,200033207,CC VIERZON-SOLOGNE-BERRY,18,CHER,75,0,75,58,283,3,286,419
2017,19272,TULLE,241927201,CA TULLE AGGLO,19,CORREZE,158,1,159,34,62,10,72,265
2017,22278,SAINT BRIEUC,200069409,CA SAINT-BRIEUC ARMOR AGGLOMERATION,22,COTES D ARMOR,278,2,280,126,452,19,471,877
2017,25031,AUDINCOURT,200065647,CA PAYS DE MONTBELIARD AGGLOMERATION,25,DOUBS,90,0,90,43,143,4,147,281
2017,26235,PIERRELATTE,200042901,CC DROME SUD PROVENCE,26,DROME,50,10,60,22,143,0,143,225
2017,28404,VERNOUILLET,200040277,CA AGGLO DU PAYS DE DREUX,28,EURE ET LOIR,114,2,116,12,162,3,165,293
2017,29039,CONCARNEAU,242900769,CA CONCARNEAU CORNOUAILLE AGGLOMERATION,29,FINISTERE,72,0,72,64,175,3,178,315
2017,29103,LANDERNEAU,242900801,CC DU PAYS DE LANDERNEAU-DAOULAS,29,FINISTERE,60,0,60,76,320,4,324,460
2017,29189,PLOUGASTEL DAOULAS,242900314,BREST METROPOLE,29,FINISTERE,52,0,52,43,249,4,253,348
2017,2A004,AJACCIO,242010056,CA DU PAYS AJACCIEN,2A,CORSE DU SUD,486,0,486,33,160,32,192,711
2017,30028,BAGNOLS SUR CEZE,200034692,CA DU GARD RHODANIEN,30,GARD,130,0,130,42,56,3,59,231
2017,31395,MURET,200068641,CA LE MURETAIN AGGLO,31,HAUTE GARONNE,153,0,153,5,349,5,354,512
2017,31446,RAMONVILLE SAINT AGNE,243100633,CA DU SICOVAL,31,HAUTE GARONNE,197,0,197,0,131,9,140,337
2017,33039,BEGLES,243300316,BORDEAUX METROPOLE,33,GIRONDE,178,14,192,17,415,13,428,637
2017,33122,CESTAS,243301165,CC JALLE-EAU-BOURDE,33,GIRONDE,116,3,119,4,197,6,203,326
2017,33192,GRADIGNAN,243300316,BORDEAUX METROPOLE,33,GIRONDE,244,12,256,15,195,16,211,483
2017,38185,GRENOBLE,200040715,GRENOBLE-ALPES-METROPOLE,38,ISERE,1593,236,1829,200,1727,121,1848,3877
2017,38544,VIENNE,200077014,CA VIENNE CONDRIEU,38,ISERE,127,7,134,45,388,7,395,574
2017,39300,LONS LE SAUNIER,200071116,CA ECLA  (ESPACE COMMUNAUTAIRE LONS AGGLOMERATION),39,JURA,169,2,171,60,120,1,121,352
2017,41269,VENDOME,200072072,CA TERRITOIRES VENDOMOIS,41,LOIR ET CHER,104,0,104,15,181,3,184,303
2017,42186,RIVE DE GIER,244200770,SAINT-ETIENNE METROPOLE,42,LOIRE,55,27,82,48,195,0,195,325
2017,42218,SAINT ETIENNE,244200770,SAINT-ETIENNE METROPOLE,42,LOIRE,994,55,1049,442,1306,65,1371,2862
2017,44020,BOUGUENAIS,244400404,NANTES METROPOLE,44,LOIRE ATLANTIQUE,161,14,175,12,427,15,442,629
2017,44109,NANTES,244400404,NANTES METROPOLE,44,LOIRE ATLANTIQUE,3109,224,3333,440,3552,554,4106,7879
2017,44162,SAINT HERBLAIN,244400404,NANTES METROPOLE,44,LOIRE ATLANTIQUE,455,31,486,64,857,24,881,1431
2017,44204,THOUARE SUR LOIRE,244400404,NANTES METROPOLE,44,LOIRE ATLANTIQUE,50,12,62,7,229,5,234,303
2017,45147,FLEURY LES AUBRAIS,244500468,ORLEANS METROPOLE,45,LOIRET,141,14,155,0,317,11,328,483
2017,46042,CAHORS,200023737,CA DU GRAND CAHORS,46,LOT,212,0,212,34,226,5,231,477
2017,48095,MENDE,244800405,CC COEUR DE LOZERE,48,LOZERE,112,0,112,65,137,3,140,317
2017,49218,MONTREVAULT SUR EVRE,200060010,CA MAUGES COMMUNAUTE,49,MAINE ET LOIRE,36,3,39,24,393,1,394,457
2017,49246,LES PONTS DE CE,244900015,CU ANGERS LOIRE METROPOLE,49,MAINE ET LOIRE,40,7,47,13,204,3,207,267
2017,52121,CHAUMONT,200068658,CA DE CHAUMONT DU BASSIN NOGENTAIS ET DU BASSIN DE BOLOGNE VIGNORY FRONCLES,52,HAUTE MARNE,112,0,112,36,328,4,332,480
2017,53062,CHATEAU GONTIER SUR MAYENNE,245300447,CC DU PAYS DE CHATEAU-GONTIER,53,MAYENNE,75,0,75,36,363,5,368,479
2017,53147,MAYENNE,200055887,CC MAYENNE COMMUNAUTE,53,MAYENNE,80,7,87,30,207,4,211,328
2017,54547,VANDOEUVRE LES NANCY,245400676,METROPOLE DU GRAND NANCY,54,MEURTHE ET MOSELLE,284,2,286,112,215,14,229,627
2017,56121,LORIENT,200042174,CA LORIENT AGGLOMERATION,56,MORBIHAN,291,6,297,266,545,29,574,1137
2017,56206,SAINT AVE,200067932,CA GOLFE DU MORBIHAN - VANNES AGGLOMERATION,56,MORBIHAN,40,1,41,50,209,7,216,307
2017,57240,FREYMING MERLEBACH,245700398,CC DE FREYMING-MERLEBACH,57,MOSELLE,0,0,0,21,91,1,92,113
2017,57630,SARREBOURG,200068146,CC SARREBOURG MOSELLE SUD,57,MOSELLE,50,0,50,6,149,3,152,208
2017,57757,YUTZ,245701362,CA PORTES DE FRANCE-THIONVILLE,57,MOSELLE,101,18,119,16,202,3,205,339
2017,59009,VILLENEUVE D ASCQ,245900410,METROPOLE EUROPEENNE DE LILLE,59,NORD,581,66,647,265,703,40,743,1656
2017,59112,BRUAY SUR L ESCAUT,245901160,CA VALENCIENNES METROPOLE,59,NORD,15,0,15,73,75,0,75,163
2017,59139,CAUDRY,200030633,CA DU CAUDRESIS ET DU CATESIS,59,NORD,45,0,45,73,123,1,124,242
2017,59172,DENAIN,200042190,CA DE LA PORTE DU HAINAUT,59,NORD,55,1,56,119,124,2,126,301
2017,59179,DOUCHY LES MINES,200042190,CA DE LA PORTE DU HAINAUT,59,NORD,20,1,21,76,119,1,120,216
2017,59183,DUNKERQUE,245900428,CU DE DUNKERQUE,59,NORD,430,21,451,435,761,18,779,1665
2017,59220,FACHES THUMESNIL,245900410,METROPOLE EUROPEENNE DE LILLE,59,NORD,124,16,140,53,327,7,334,526
2017,59273,GRAVELINES,245900428,CU DE DUNKERQUE,59,NORD,65,0,65,82,143,6,149,296
2017,59299,HEM,245900410,METROPOLE EUROPEENNE DE LILLE,59,NORD,125,48,173,87,277,13,290,550
2017,59328,LAMBERSART,245900410,METROPOLE EUROPEENNE DE LILLE,59,NORD,210,63,273,110,359,37,396,779
2017,59350,LILLE,245900410,METROPOLE EUROPEENNE DE LILLE,59,NORD,1977,318,2295,663,1865,183,2048,5006
2017,59368,LA MADELEINE,245900410,METROPOLE EUROPEENNE DE LILLE,59,NORD,241,64,305,68,217,67,284,656
2017,59383,MARLY,245901160,CA VALENCIENNES METROPOLE,59,NORD,90,9,99,36,168,0,168,303
2017,59386,MARQUETTE LEZ LILLE,245900410,METROPOLE EUROPEENNE DE LILLE,59,NORD,115,7,122,44,246,2,248,414
2017,59507,RONCHIN,245900410,METROPOLE EUROPEENNE DE LILLE,59,NORD,102,55,157,0,273,13,286,443
2017,59606,VALENCIENNES,245901160,CA VALENCIENNES METROPOLE,59,NORD,363,7,370,178,338,15,353,901
2017,59646,WASQUEHAL,245900410,METROPOLE EUROPEENNE DE LILLE,59,NORD,221,47,268,95,334,31,365,728
2017,59648,WATTIGNIES,245900410,METROPOLE EUROPEENNE DE LILLE,59,NORD,74,20,94,17,175,10,185,297
2017,60139,CHAMBLY,200067973,CC THELLOISE,60,OISE,40,0,40,0,207,4,211,251
2017,60395,MERU,246000582,CC DES SABLONS,60,OISE,80,1,81,30,177,1,178,289
2017,60414,MONTATAIRE,200068047,CA CREIL SUD OISE,60,OISE,101,1,102,47,103,3,106,255
2017,60509,PONT SAINTE MAXENCE,246000921,CC DES PAYS D'OISE ET D'HALATTE,60,OISE,157,3,160,28,116,8,124,312
2017,60612,SENLIS,200066975,CC SENLIS SUD OISE,60,OISE,132,4,136,12,234,8,242,390
2017,62193,CALAIS,246201149,CA DU CALAISIS,62,PAS DE CALAIS,396,10,406,274,459,15,474,1153
2017,62318,ETAPLES,200069029,CA DES DEUX BAIES EN MONTREUILLOIS,62,PAS DE CALAIS,40,0,40,92,135,2,137,269
2019,57447,MARLY,200039865,METZ METROPOLE,57,MOSELLE,25,13,38,0,146,0,146,184
2019,59014,ANZIN,245901160,CA VALENCIENNES METROPOLE,59,NORD,37,0,37,80,90,0,90,207
2019,59043,BAILLEUL,200040947,CC DE FLANDRE INTERIEURE,59,NORD,75,14,89,48,226,2,228,365
2019,59122,CAMBRAI,200068500,CA DE CAMBRAI,59,NORD,102,9,111,121,289,10,299,531
2019,59152,COMINES,245900410,METROPOLE EUROPEENNE DE LILLE,59,NORD,42,10,52,41,164,0,164,257
2019,59155,COUDEKERQUE BRANCHE,245900428,CU DE DUNKERQUE,59,NORD,62,7,69,79,313,4,317,466
2019,59172,DENAIN,200042190,CA DE LA PORTE DU HAINAUT,59,NORD,55,0,55,102,91,0,91,248
2019,59183,DUNKERQUE,245900428,CU DE DUNKERQUE,59,NORD,451,46,497,364,742,27,769,1630
2019,59249,FOURMIES,200043404,CC DU SUD AVESNOIS,59,NORD,24,3,27,30,69,3,72,129
2019,59273,GRAVELINES,245900428,CU DE DUNKERQUE,59,NORD,65,8,73,58,139,4,143,273
2019,59299,HEM,245900410,METROPOLE EUROPEENNE DE LILLE,59,NORD,125,73,198,66,234,20,254,518
2019,59378,MARCQ EN BAROEUL,245900410,METROPOLE EUROPEENNE DE LILLE,59,NORD,266,159,425,41,499,74,573,1039
2019,59383,MARLY,245901160,CA VALENCIENNES METROPOLE,59,NORD,90,13,103,29,140,2,142,274
2019,59491,RAISMES,200042190,CA DE LA PORTE DU HAINAUT,59,NORD,53,1,54,40,110,2,112,206
2019,59508,RONCQ,245900410,METROPOLE EUROPEENNE DE LILLE,59,NORD,107,29,136,45,141,9,150,331
2019,59636,WAMBRECHIES,245900410,METROPOLE EUROPEENNE DE LILLE,59,NORD,30,43,73,20,195,10,205,298
2019,59650,WATTRELOS,245900410,METROPOLE EUROPEENNE DE LILLE,59,NORD,187,48,235,158,435,3,438,831
2019,60139,CHAMBLY,200067973,CC THELLOISE,60,OISE,40,0,40,0,184,0,184,224
2019,60141,CHANTILLY,246000764,CC DE L'AIRE CANTILIENNE,60,OISE,138,2,140,19,161,7,168,327
2019,60414,MONTATAIRE,200068047,CA CREIL SUD OISE,60,OISE,101,0,101,23,121,5,126,250
2019,61001,ALENCON,246100663,CU D'ALENCON,61,ORNE,168,0,168,79,236,7,243,490
2019,61169,FLERS,200035814,CA FLERS AGGLO,61,ORNE,66,0,66,28,117,4,121,215
2019,62160,BOULOGNE SUR MER,246200729,CA DU BOULONNAIS,62,PAS DE CALAIS,259,9,268,139,148,14,162,569
2019,62318,ETAPLES,200069029,CA DES DEUX BAIES EN MONTREUILLOIS,62,PAS DE CALAIS,33,1,34,77,121,1,122,233
2019,62510,LIEVIN,246200364,CA DE LENS - LIEVIN,62,PAS DE CALAIS,155,28,183,66,192,5,197,446
2019,62525,LONGUENESSE,200069037,CA DU PAYS DE SAINT-OMER,62,PAS DE CALAIS,45,2,47,30,123,2,125,203
2019,62587,MONTIGNY EN GOHELLE,246200299,CA D'HENIN-CARVIN,62,PAS DE CALAIS,30,6,36,40,66,1,67,143
2019,63075,CHAMALIERES,246300701,CLERMONT AUVERGNE METROPOLE,63,PUY DE DOME,199,4,203,11,106,28,134,348
2019,63113,CLERMONT FERRAND,246300701,CLERMONT AUVERGNE METROPOLE,63,PUY DE DOME,991,64,1055,130,1218,78,1296,2481
2019,63124,COURNON D AUVERGNE,246300701,CLERMONT AUVERGNE METROPOLE,63,PUY DE DOME,116,10,126,17,268,10,278,421
2019,63284,PONT DU CHATEAU,246300701,CLERMONT AUVERGNE METROPOLE,63,PUY DE DOME,30,26,56,3,237,1,238,298
2019,63300,RIOM,200070753,CA RIOM LIMAGNE ET VOLCANS,63,PUY DE DOME,108,18,126,32,189,9,198,356
2019,64024,ANGLET,200067106,CA DU PAYS BASQUE,64,PYRENEES ATLANTIQUES,145,89,234,27,380,32,412,674
2019,64445,PAU,200067254,CA PAU BEARN PYRENEES,64,PYRENEES ATLANTIQUES,429,50,479,100,578,38,616,1195
2019,64483,SAINT JEAN DE LUZ,200067106,CA DU PAYS BASQUE,64,PYRENEES ATLANTIQUES,70,25,95,41,74,3,77,214
2019,66171,SAINT CYPRIEN,246600282,CC SUD-ROUSSILLON,66,PYRENEES ORIENTALES,40,3,43,11,46,0,46,100
2019,66180,SAINT LAURENT DE LA SALANQUE,200027183,CU PERPIGNAN MEDITERRANEE METROPOLE,66,PYRENEES ORIENTALES,50,4,54,0,74,1,75,129
2019,67043,BISCHHEIM,246700488,EUROMETROPOLE DE STRASBOURG,67,BAS RHIN,206,34,240,25,119,8,127,392
2019,67046,BISCHWILLER,200067874,CA DE HAGUENAU,67,BAS RHIN,167,28,195,0,47,1,48,243
2019,67130,ERSTEIN,200067924,CC DU CANTON D'ERSTEIN,67,BAS RHIN,65,28,93,0,146,3,149,242
2019,67204,HOENHEIM,246700488,EUROMETROPOLE DE STRASBOURG,67,BAS RHIN,120,23,143,0,101,3,104,246
2019,67348,OBERNAI,246701080,CC DU PAYS DE SAINTE-ODILE,67,BAS RHIN,126,12,138,8,77,0,77,223
2019,67447,SCHILTIGHEIM,246700488,EUROMETROPOLE DE STRASBOURG,67,BAS RHIN,397,77,474,74,303,19,322,870
2019,67462,SELESTAT,246700967,CC DE SELESTAT,67,BAS RHIN,106,42,148,0,149,9,158,306
2019,68066,COLMAR,246800726,CA COLMAR AGGLOMERATION,68,HAUT RHIN,682,38,720,58,379,16,395,1174
2019,68278,RIXHEIM,200066009,CA MULHOUSE ALSACE AGGLOMERATION,68,HAUT RHIN,130,2,132,13,124,4,128,273
2019,68297,SAINT LOUIS,200066058,CA SAINT-LOUIS AGGLOMERATION,68,HAUT RHIN,153,5,158,36,145,1,146,339
2019,69029,BRON,200046977,METROPOLE DE LYON,69,RHONE,375,39,414,78,290,29,319,812
2019,69204,SAINT GENIS LAVAL,200046977,METROPOLE DE LYON,69,RHONE,190,25,215,23,207,22,229,467
2019,69264,VILLEFRANCHE SUR SAONE,200040590,CA VILLEFRANCHE BEAUJOLAIS SAONE,69,RHONE,330,18,348,126,261,17,278,752
2019,69271,CHASSIEU,200046977,METROPOLE DE LYON,69,RHONE,67,15,82,0,143,8,151,232
2019,69290,SAINT PRIEST,200046977,METROPOLE DE LYON,69,RHONE,510,51,561,72,548,19,567,1200
2019,69385,LYON 5E ARRONDISSEMENT,200046977,METROPOLE DE LYON,69,RHONE,451,64,515,31,345,72,417,963
2019,69386,LYON 6E ARRONDISSEMENT,200046977,METROPOLE DE LYON,69,RHONE,580,189,769,22,378,243,621,1412
2019,69388,LYON 8E ARRONDISSEMENT,200046977,METROPOLE DE LYON,69,RHONE,892,80,972,187,713,97,810,1969
2019,71076,CHALON SUR SAONE,247100589,CA LE GRAND CHALON,71,SAONE ET LOIRE,315,40,355,71,340,20,360,785
2019,72003,ALLONNES,247200132,CU LE MANS METROPOLE,72,SARTHE,18,0,18,69,162,2,164,251
2019,72154,LA FLECHE,247200348,CC DU PAYS FLECHOIS,72,SARTHE,80,0,80,34,209,2,211,325
2019,73011,ALBERTVILLE,200068997,CA ARLYSERE,73,SAVOIE,79,5,84,34,265,2,267,384
2019,74081,CLUSES,200033116,CC CLUSES-ARVE ET MONTAGNES,74,HAUTE SAVOIE,68,4,72,42,139,1,140,254
2019,74224,LA ROCHE SUR FORON,247400724,CC DU PAYS ROCHOIS,74,HAUTE SAVOIE,42,3,45,0,147,6,153,198
2019,74225,RUMILLY,247400740,CC RUMILLY TERRE DE SAVOIE,74,HAUTE SAVOIE,170,30,200,0,172,4,176,375
2019,74243,SAINT JULIEN EN GENEVOIS,247400690,CC DU GENEVOIS,74,HAUTE SAVOIE,101,14,115,0,151,8,159,274
2019,75101,PARIS 1ER ARRONDISSEMENT,200054781,METROPOLE DU GRAND PARIS,75,PARIS,234,3,237,7,28,92,120,364
2019,75102,PARIS 2E ARRONDISSEMENT,200054781,METROPOLE DU GRAND PARIS,75,PARIS,318,17,335,8,20,146,166,509
2019,75107,PARIS 7E ARRONDISSEMENT,200054781,METROPOLE DU GRAND PARIS,75,PARIS,636,28,664,61,15,323,338,1063
2019,75109,PARIS 9E ARRONDISSEMENT,200054781,METROPOLE DU GRAND PARIS,75,PARIS,1101,97,1198,4,90,614,704,1906
2019,75111,PARIS 11E ARRONDISSEMENT,200054781,METROPOLE DU GRAND PARIS,75,PARIS,2655,217,2872,62,197,803,1000,3934
2019,75117,PARIS 17E ARRONDISSEMENT,200054781,METROPOLE DU GRAND PARIS,75,PARIS,2388,370,2758,46,419,1683,2102,4906
2019,75118,PARIS 18E ARRONDISSEMENT,200054781,METROPOLE DU GRAND PARIS,75,PARIS,3464,215,3679,102,417,956,1373,5154
2019,75120,PARIS 20E ARRONDISSEMENT,200054781,METROPOLE DU GRAND PARIS,75,PARIS,3892,104,3996,77,477,447,924,4996
2019,76057,BARENTIN,247600646,CC CAUX - AUSTREBERTHE,76,SEINE MARITIME,72,0,72,4,234,0,234,310
2019,76231,ELBEUF,200023414,METROPOLE ROUEN NORMANDIE,76,SEINE MARITIME,74,4,78,29,115,6,121,228
2019,76484,OISSEL,200023414,METROPOLE ROUEN NORMANDIE,76,SEINE MARITIME,12,2,14,15,181,2,183,212
2019,76540,ROUEN,200023414,METROPOLE ROUEN NORMANDIE,76,SEINE MARITIME,990,168,1158,45,892,96,988,2191
2019,76681,SOTTEVILLE LES ROUEN,200023414,METROPOLE ROUEN NORMANDIE,76,SEINE MARITIME,195,22,217,14,427,4,431,662
2019,77067,CESSON,200059228,CA GRAND PARIS SUD SEINE ESSONNE SENART,77,SEINE ET MARNE,163,6,169,7,109,3,112,289
2019,77118,CLAYE SOUILLY,200055655,CA ROISSY PAYS DE FRANCE,77,SEINE ET MARNE,30,4,34,15,164,3,167,216
2019,77122,COMBS LA VILLE,200059228,CA GRAND PARIS SUD SEINE ESSONNE SENART,77,SEINE ET MARNE,163,1,164,22,319,11,330,516
2019,77243,LAGNY SUR MARNE,247700594,CA MARNE ET GONDOIRE,77,SEINE ET MARNE,71,20,91,0,306,5,311,401
2019,77251,LIEUSAINT,200059228,CA GRAND PARIS SUD SEINE ESSONNE SENART,77,SEINE ET MARNE,135,14,149,0,286,2,288,437
2019,77285,LE MEE SUR SEINE,247700057,CA MELUN VAL DE SEINE,77,SEINE ET MARNE,246,0,246,63,190,3,193,502
2019,77288,MELUN,247700057,CA MELUN VAL DE SEINE,77,SEINE ET MARNE,421,1,422,32,321,22,343,797
2019,77379,PROVINS,200037133,CC DU PROVINOIS,77,SEINE ET MARNE,100,8,108,42,82,3,85,234
2019,77445,SAVIGNY LE TEMPLE,200059228,CA GRAND PARIS SUD SEINE ESSONNE SENART,77,SEINE ET MARNE,250,3,253,49,324,9,333,635
2019,77464,THORIGNY SUR MARNE,247700594,CA MARNE ET GONDOIRE,77,SEINE ET MARNE,70,4,74,0,122,0,122,195
2019,77487,VAUX LE PENIL,247700057,CA MELUN VAL DE SEINE,77,SEINE ET MARNE,137,0,137,0,146,1,147,284
2019,77514,VILLEPARISIS,200055655,CA ROISSY PAYS DE FRANCE,77,SEINE ET MARNE,138,2,140,0,408,6,414,554
2019,78015,ANDRESY,200059889,CU GRAND PARIS SEINE ET OISE,78,YVELINES,35,12,47,9,242,3,245,301
2019,78124,CARRIERES SUR SEINE,200058519,CA SAINT GERMAIN BOUCLES DE SEINE,78,YVELINES,220,6,226,15,117,12,129,370
2019,78138,CHANTELOUP LES VIGNES,200059889,CU GRAND PARIS SEINE ET OISE,78,YVELINES,108,1,109,16,103,2,105,230
2019,78158,LE CHESNAY ROCQUENCOURT,247800584,CA VERSAILLES GRAND PARC (CAVGP),78,YVELINES,458,12,470,14,142,40,182,666
2019,78165,LES CLAYES SOUS BOIS,200058782,CA DE SAINT QUENTIN EN YVELINES,78,YVELINES,181,34,215,19,205,8,213,446
2019,78208,ELANCOURT,200058782,CA DE SAINT QUENTIN EN YVELINES,78,YVELINES,335,6,341,10,393,6,399,750
2019,78242,FONTENAY LE FLEURY,247800584,CA VERSAILLES GRAND PARC (CAVGP),78,YVELINES,156,4,160,0,163,14,177,337
2019,78311,HOUILLES,200058519,CA SAINT GERMAIN BOUCLES DE SEINE,78,YVELINES,270,102,372,0,491,77,568,940
2019,78335,LIMAY,200059889,CU GRAND PARIS SEINE ET OISE,78,YVELINES,135,20,155,0,209,1,210,365
2019,78358,MAISONS LAFFITTE,200058519,CA SAINT GERMAIN BOUCLES DE SEINE,78,YVELINES,329,64,393,0,121,92,213,606
2019,78362,MANTES LA VILLE,200059889,CU GRAND PARIS SEINE ET OISE,78,YVELINES,100,59,159,0,238,5,243,402
2019,78418,MONTESSON,200058519,CA SAINT GERMAIN BOUCLES DE SEINE,78,YVELINES,195,5,200,0,122,21,143,343
2019,78517,RAMBOUILLET,200073344,CA RAMBOUILLET TERRITOIRES,78,YVELINES,282,9,291,0,268,15,283,574
2019,78545,SAINT CYR L ECOLE,247800584,CA VERSAILLES GRAND PARC (CAVGP),78,YVELINES,279,75,354,0,211,33,244,597
2019,78640,VELIZY VILLACOUBLAY,247800584,CA VERSAILLES GRAND PARC (CAVGP),78,YVELINES,555,13,568,0,243,19,262,830
2019,78674,VILLEPREUX,200058782,CA DE SAINT QUENTIN EN YVELINES,78,YVELINES,75,25,100,0,169,7,176,275
2019,78686,VIROFLAY,247800584,CA VERSAILLES GRAND PARC (CAVGP),78,YVELINES,222,30,252,4,79,76,155,410
2019,81065,CASTRES,248100430,CA DE CASTRES MAZAMET,81,TARN,284,43,327,60,186,28,214,600
2019,81105,GRAULHET,200066124,CA GAILLAC-GRAULHET,81,TARN,74,0,74,37,62,2,64,175
2019,83049,CUERS,200027100,CC MEDITERRANEE PORTE DES MAURES,83,VAR,50,6,56,4,203,3,206,267
2019,83071,LA LONDE LES MAURES,200027100,CC MEDITERRANEE PORTE DES MAURES,83,VAR,80,0,80,0,55,5,60,140
2019,83073,LE LUC,248300550,CC COEUR DU VAR,83,VAR,90,1,91,2,78,3,81,174
2019,83090,OLLIOULES,248300543,METROPOLE TOULON-PROVENCE-MEDITERRANEE,83,VAR,94,30,124,0,110,5,115,239
2019,83107,ROQUEBRUNE SUR ARGENS,200035319,CA VAR ESTEREL MEDITERRANEE (CAVEM),83,VAR,94,2,96,0,110,5,115,211
2019,83116,SAINT MAXIMIN LA SAINTE BAUME,200068104,CA DE LA PROVENCE VERTE,83,VAR,151,10,161,1,187,12,199,361
2019,83126,LA SEYNE SUR MER,248300543,METROPOLE TOULON-PROVENCE-MEDITERRANEE,83,VAR,368,135,503,110,411,28,439,1052
2019,83137,TOULON,248300543,METROPOLE TOULON-PROVENCE-MEDITERRANEE,83,VAR,1250,84,1334,311,957,170,1127,2772
2019,83148,VIDAUBAN,248300493,CA DRACENIE PROVENCE VERDON AGGLOMERATION,83,VAR,20,3,23,0,136,7,143,166
2019,84007,AVIGNON,248400251,CA DU GRAND AVIGNON (COGA),84,VAUCLUSE,797,101,898,67,366,44,410,1375
2019,84080,MONTEUX,248400293,CC DES SORGUES DU COMTAT,84,VAUCLUSE,71,13,84,0,146,1,147,232
2019,84088,PERNES LES FONTAINES,248400293,CC DES SORGUES DU COMTAT,84,VAUCLUSE,68,3,71,4,112,6,118,193
2019,84092,LE PONTET,248400251,CA DU GRAND AVIGNON (COGA),84,VAUCLUSE,67,11,78,0,155,5,160,237
2019,84129,SORGUES,248400293,CC DES SORGUES DU COMTAT,84,VAUCLUSE,100,27,127,5,140,0,140,272
2019,86066,CHATELLERAULT,248600413,CA GRAND CHATELLERAULT,86,VIENNE,125,0,125,78,256,6,262,465
2019,87114,PANAZOL,248719312,CU LIMOGES METROPOLE,87,HAUTE VIENNE,38,12,50,0,147,7,154,204
2019,88413,SAINT DIE DES VOSGES,200071066,CA DE SAINT-DIE-DES-VOSGES,88,VOSGES,126,0,126,68,146,2,148,342
2019,89024,AUXERRE,200067114,CA DE L'AUXERROIS,89,YONNE,315,4,319,34,399,9,408,762
2019,90010,BELFORT,200069052,CA GRAND BELFORT,90,TERRITOIRE DE BELFORT,395,8,403,153,282,17,299,854
2019,91027,ATHIS MONS,200054781,METROPOLE DU GRAND PARIS,91,ESSONNE,298,24,322,57,381,8,389,767
2019,91086,BONDOUFLE,200059228,CA GRAND PARIS SUD SEINE ESSONNE SENART,91,ESSONNE,110,3,113,0,134,5,139,252
2019,91114,BRUNOY,200058477,CA VAL D'YERRES VAL DE SEINE,91,ESSONNE,270,10,280,9,237,14,251,539
2019,91174,CORBEIL ESSONNES,200059228,CA GRAND PARIS SUD SEINE ESSONNE SENART,91,ESSONNE,346,9,355,99,365,16,381,835
2019,91200,DOURDAN,249100595,CC LE DOURDANNAIS EN HUREPOIX (CCDH),91,ESSONNE,70,4,74,5,128,5,133,212
2019,91228,EVRY COURCOURONNES,200059228,CA GRAND PARIS SUD SEINE ESSONNE SENART,91,ESSONNE,610,7,617,115,717,20,737,1469
2019,91272,GIF SUR YVETTE,200056232,CA COMMUNAUTE PARIS-SACLAY,91,ESSONNE,205,1,206,0,189,11,200,407
2019,91345,LONGJUMEAU,200056232,CA COMMUNAUTE PARIS-SACLAY,91,ESSONNE,215,5,220,9,237,13,250,478
2019,91421,MONTGERON,200058477,CA VAL D'YERRES VAL DE SEINE,91,ESSONNE,205,4,209,16,256,14,270,495
2019,91471,ORSAY,200056232,CA COMMUNAUTE PARIS-SACLAY,91,ESSONNE,202,7,209,0,100,14,114,323
2019,91477,PALAISEAU,200056232,CA COMMUNAUTE PARIS-SACLAY,91,ESSONNE,518,49,567,0,440,12,452,1019
2019,91521,RIS ORANGIS,200059228,CA GRAND PARIS SUD SEINE ESSONNE SENART,91,ESSONNE,221,6,227,18,304,10,314,559
2019,91549,SAINTE GENEVIEVE DES BOIS,200057859,CA COEUR D'ESSONNE AGGLOMERATION,91,ESSONNE,260,22,282,33,404,11,415,730
2019,91570,SAINT MICHEL SUR ORGE,200057859,CA COEUR D'ESSONNE AGGLOMERATION,91,ESSONNE,156,18,174,3,258,7,265,442
2019,91573,SAINT PIERRE DU PERRAY,200059228,CA GRAND PARIS SUD SEINE ESSONNE SENART,91,ESSONNE,97,3,100,0,229,0,229,329
2019,91657,VIGNEUX SUR SEINE,200058477,CA VAL D'YERRES VAL DE SEINE,91,ESSONNE,228,18,246,0,310,7,317,563
2019,92014,BOURG LA REINE,200054781,METROPOLE DU GRAND PARIS,92,HAUTS DE SEINE,327,10,337,0,93,67,160,497
2019,92023,CLAMART,200054781,METROPOLE DU GRAND PARIS,92,HAUTS DE SEINE,643,78,721,57,320,153,473,1251
2019,92035,LA GARENNE COLOMBES,200054781,METROPOLE DU GRAND PARIS,92,HAUTS DE SEINE,660,38,698,4,115,114,229,931
2019,92046,MALAKOFF,200054781,METROPOLE DU GRAND PARIS,92,HAUTS DE SEINE,390,8,398,11,224,51,275,684
2019,92049,MONTROUGE,200054781,METROPOLE DU GRAND PARIS,92,HAUTS DE SEINE,1038,52,1090,42,234,226,460,1592
2019,92060,LE PLESSIS ROBINSON,200054781,METROPOLE DU GRAND PARIS,92,HAUTS DE SEINE,512,10,522,13,276,44,320,855
2019,92062,PUTEAUX,200054781,METROPOLE DU GRAND PARIS,92,HAUTS DE SEINE,1013,57,1070,24,324,206,530,1623
2019,92063,RUEIL MALMAISON,200054781,METROPOLE DU GRAND PARIS,92,HAUTS DE SEINE,1205,83,1288,30,364,241,605,1923
2019,93007,LE BLANC MESNIL,200054781,METROPOLE DU GRAND PARIS,93,SEINE SAINT DENIS,322,6,328,12,179,9,188,528
2019,93010,BONDY,200054781,METROPOLE DU GRAND PARIS,93,SEINE SAINT DENIS,611,9,620,65,304,17,321,1006
2019,93014,CLICHY SOUS BOIS,200054781,METROPOLE DU GRAND PARIS,93,SEINE SAINT DENIS,185,2,187,51,95,5,100,338
2019,93032,GAGNY,200054781,METROPOLE DU GRAND PARIS,93,SEINE SAINT DENIS,345,15,360,0,316,20,336,695
2019,93045,LES LILAS,200054781,METROPOLE DU GRAND PARIS,93,SEINE SAINT DENIS,232,2,234,3,220,57,277,514
2019,93046,LIVRY GARGAN,200054781,METROPOLE DU GRAND PARIS,93,SEINE SAINT DENIS,355,29,384,0,306,14,320,704
2019,93048,MONTREUIL,200054781,METROPOLE DU GRAND PARIS,93,SEINE SAINT DENIS,1222,118,1340,72,653,400,1053,2465
2019,93049,NEUILLY PLAISANCE,200054781,METROPOLE DU GRAND PARIS,93,SEINE SAINT DENIS,162,22,184,0,157,24,181,366
2019,93050,NEUILLY SUR MARNE,200054781,METROPOLE DU GRAND PARIS,93,SEINE SAINT DENIS,399,16,415,39,327,20,347,801
2019,93055,PANTIN,200054781,METROPOLE DU GRAND PARIS,93,SEINE SAINT DENIS,666,28,694,74,301,160,461,1229
2019,93063,ROMAINVILLE,200054781,METROPOLE DU GRAND PARIS,93,SEINE SAINT DENIS,377,15,392,0,284,31,315,707
2019,93070,SAINT OUEN SUR SEINE,200054781,METROPOLE DU GRAND PARIS,93,SEINE SAINT DENIS,592,38,630,38,410,149,559,1227
2019,93072,STAINS,200054781,METROPOLE DU GRAND PARIS,93,SEINE SAINT DENIS,341,3,344,36,127,9,136,516
2019,93073,TREMBLAY EN FRANCE,200054781,METROPOLE DU GRAND PARIS,93,SEINE SAINT DENIS,335,4,339,44,278,13,291,674
2019,93079,VILLETANEUSE,200054781,METROPOLE DU GRAND PARIS,93,SEINE SAINT DENIS,65,0,65,59,44,2,46,171
2019,94016,CACHAN,200054781,METROPOLE DU GRAND PARIS,94,VAL DE MARNE,317,10,327,19,252,46,298,644
2019,94018,CHARENTON LE PONT,200054781,METROPOLE DU GRAND PARIS,94,VAL DE MARNE,557,33,590,0,172,136,308,898
2019,94019,CHENNEVIERES SUR MARNE,200054781,METROPOLE DU GRAND PARIS,94,VAL DE MARNE,200,6,206,0,125,21,146,352
2019,94038,L'HAY LES ROSES,200054781,METROPOLE DU GRAND PARIS,94,VAL DE MARNE,293,43,336,18,246,31,277,632
2019,94042,JOINVILLE LE PONT,200054781,METROPOLE DU GRAND PARIS,94,VAL DE MARNE,289,18,307,0,142,49,191,498
2019,94044,LIMEIL BREVANNES,200054781,METROPOLE DU GRAND PARIS,94,VAL DE MARNE,287,7,294,18,269,16,285,598
2019,94046,MAISONS ALFORT,200054781,METROPOLE DU GRAND PARIS,94,VAL DE MARNE,616,23,639,0,507,134,641,1280
2019,94068,SAINT MAUR DES FOSSES,200054781,METROPOLE DU GRAND PARIS,94,VAL DE MARNE,722,114,836,43,481,135,616,1495
2019,94073,THIAIS,200054781,METROPOLE DU GRAND PARIS,94,VAL DE MARNE,385,34,419,14,190,14,204,637
2019,94078,VILLENEUVE SAINT GEORGES,200054781,METROPOLE DU GRAND PARIS,94,VAL DE MARNE,210,2,212,33,182,7,189,433
2019,94079,VILLIERS SUR MARNE,200054781,METROPOLE DU GRAND PARIS,94,VAL DE MARNE,254,23,277,0,234,25,259,536
2019,94080,VINCENNES,200054781,METROPOLE DU GRAND PARIS,94,VAL DE MARNE,938,80,1018,6,199,434,633,1658
2019,94081,VITRY SUR SEINE,200054781,METROPOLE DU GRAND PARIS,94,VAL DE MARNE,746,83,829,60,376,44,420,1310
2019,95018,ARGENTEUIL,200054781,METROPOLE DU GRAND PARIS,95,VAL D OISE,1056,50,1106,75,826,65,891,2072
2019,95063,BEZONS,200058519,CA SAINT GERMAIN BOUCLES DE SEINE,95,VAL D OISE,225,73,298,30,291,31,322,650
2019,95210,ENGHIEN LES BAINS,200056380,CA PLAINE VALLEE,95,VAL D OISE,263,9,272,0,51,28,79,351
2019,95306,HERBLAY SUR SEINE,200058485,CA VAL PARISIS,95,VAL D OISE,218,10,228,0,442,30,472,700
2019,95313,L'ISLE ADAM,249500455,CC DE LA VALLEE DE L'OISE ET DES TROIS FORETS,95,VAL D OISE,67,31,98,5,118,7,125,228
2019,95351,LOUVRES,200055655,CA ROISSY PAYS DE FRANCE,95,VAL D OISE,128,0,128,0,88,1,89,217
2019,95424,MONTIGNY LES CORMEILLES,200058485,CA VAL PARISIS,95,VAL D OISE,171,8,179,33,245,11,256,468
2019,95427,MONTMAGNY,200056380,CA PLAINE VALLEE,95,VAL D OISE,90,2,92,13,148,5,153,258
2019,95428,MONTMORENCY,200056380,CA PLAINE VALLEE,95,VAL D OISE,100,28,128,9,212,22,234,371
2019,95476,OSNY,249500109,CA DE CERGY-PONTOISE,95,VAL D OISE,160,25,185,3,201,3,204,392
2019,95500,PONTOISE,249500109,CA DE CERGY-PONTOISE,95,VAL D OISE,335,29,364,19,277,10,287,670
2019,95539,SAINT BRICE SOUS FORET,200056380,CA PLAINE VALLEE,95,VAL D OISE,105,16,121,0,173,17,190,312
2019,95572,SAINT OUEN L AUMONE,249500109,CA DE CERGY-PONTOISE,95,VAL D OISE,236,34,270,33,274,3,277,580
2019,95582,SANNOIS,200058485,CA VAL PARISIS,95,VAL D OISE,225,3,228,1,354,19,373,602
2019,97101,LES ABYMES,200018653,CA CAP EXCELLENCE,971,GUADELOUPE,496,30,526,169,256,11,267,962
2019,97107,CAPESTERRE BELLE EAU,249710070,CA GRAND SUD CARAIBE,971,GUADELOUPE,25,5,30,58,33,2,35,122
2019,97113,LE GOSIER,200041507,CA LA RIVIERA DU LEVANT,971,GUADELOUPE,175,42,217,75,124,22,146,437
2019,97115,LAMENTIN,249710062,CA DU NORD BASSE-TERRE,971,GUADELOUPE,56,26,82,40,121,6,127,249
2019,97125,SAINT FRANCOIS,200041507,CA LA RIVIERA DU LEVANT,971,GUADELOUPE,53,32,85,39,68,2,70,194
2019,97128,SAINTE ANNE,200041507,CA LA RIVIERA DU LEVANT,971,GUADELOUPE,55,51,106,34,118,6,124,264
2019,97129,SAINTE ROSE,249710062,CA DU NORD BASSE-TERRE,971,GUADELOUPE,168,14,182,40,64,6,70,291
2019,97207,DUCOS,249720053,CA DE L'ESPACE SUD DE LA MARTINIQUE,972,MARTINIQUE,26,34,60,63,130,9,139,262
2019,97209,FORT DE FRANCE,249720061,CA DU CENTRE DE LA MARTINIQUE,972,MARTINIQUE,829,36,865,269,211,28,239,1373
2019,97213,LE LAMENTIN,249720061,CA DU CENTRE DE LA MARTINIQUE,972,MARTINIQUE,719,38,757,51,144,8,152,960
2019,97222,LE ROBERT,200041788,CA DU PAYS NORD MARTINIQUE,972,MARTINIQUE,195,62,257,62,72,3,75,394
2019,97224,SAINT JOSEPH,249720061,CA DU CENTRE DE LA MARTINIQUE,972,MARTINIQUE,112,46,158,87,27,2,29,273
2019,97306,MANA,249730037,CC DE L'OUEST GUYANAIS,973,GUYANE,0,0,0,18,3,6,9,27
2019,97353,MARIPASOULA,249730037,CC DE L'OUEST GUYANAIS,973,GUYANE,0,0,0,18,0,0,0,18
2019,97401,LES AVIRONS,249740077,CA CIVIS (COMMUNAUTE INTERCOMMUNALE DES VILLES SOLIDAIRES),974,LA REUNION,0,71,71,19,87,12,99,190
2019,97402,BRAS PANON,249740093,CA INTERCOMMUNALE DE LA REUNION EST (CIREST),974,LA REUNION,52,38,90,79,49,4,53,222
2019,97404,L'ETANG SALE,249740077,CA CIVIS (COMMUNAUTE INTERCOMMUNALE DES VILLES SOLIDAIRES),974,LA REUNION,60,51,111,0,131,26,157,268
2019,97408,LA POSSESSION,249740101,CA TERRITOIRE DE LA COTE OUEST (TCO),974,LA REUNION,190,241,431,46,156,25,181,658
2019,97410,SAINT BENOIT,249740093,CA INTERCOMMUNALE DE LA REUNION EST (CIREST),974,LA REUNION,190,115,305,40,89,16,105,450
2019,97412,SAINT JOSEPH,249740085,CA DU SUD,974,LA REUNION,145,136,281,38,75,25,100,419
2019,97414,SAINT LOUIS,249740077,CA CIVIS (COMMUNAUTE INTERCOMMUNALE DES VILLES SOLIDAIRES),974,LA REUNION,149,111,260,111,197,58,255,626
2019,97420,SAINTE SUZANNE,249740119,CA INTERCOMMUNALE DU NORD DE LA REUNION (CINOR),974,LA REUNION,183,88,271,13,103,15,118,403
2019,97422,LE TAMPON,249740085,CA DU SUD,974,LA REUNION,216,150,366,17,406,47,453,836
2019,97701,SAINT-BARTHELEMY,XX,XX,977,COLLECTIVITE D'OUTRE MER SAINT BARTHELEMY,0,0,0,14,0,5,5,19
2020,01033,VALSERHONE,240100891,CC DU PAYS BELLEGARDIEN (CCPB),01,AIN,65,15,80,33,237,5,242,355
2020,01173,GEX,240100750,CA DU PAYS DE GEX,01,AIN,78,4,82,0,166,8,174,256
2020,01283,OYONNAX,200042935,CA HAUT - BUGEY AGGLOMERATION,01,AIN,30,7,37,80,186,4,190,307
2020,01328,ROMANS,200069193,CC DE LA DOMBES,01,AIN,0,0,0,0,6,0,6,6
2020,02168,CHATEAU THIERRY,200072031,CA DE LA REGION DE CHATEAU-THIERRY,02,AISNE,102,4,106,38,175,4,179,323
2020,02810,VILLERS COTTERETS,200071991,CC RETZ EN VALOIS,02,AISNE,24,10,34,0,162,0,162,196
2020,03095,CUSSET,200071363,CA VICHY COMMUNAUTE,03,ALLIER,26,0,26,17,111,6,117,161
2020,04112,MANOSQUE,200034700,CA DURANCE-LUBERON-VERDON AGGLOMERATION,04,ALPES DE HAUTE PROVENCE,179,15,194,28,136,5,141,363
2020,06012,BEAUSOLEIL,240600551,CA DE LA RIVIERA FRANCAISE,06,ALPES MARITIMES,44,0,44,13,50,2,52,109
2020,06030,LE CANNET,200039915,CA CANNES PAYS DE LERINS,06,ALPES MARITIMES,271,31,302,10,251,13,264,577
2020,06069,GRASSE,200039857,CA DU PAYS DE GRASSE,06,ALPES MARITIMES,451,26,477,25,396,14,410,912
2020,06085,MOUGINS,200039915,CA CANNES PAYS DE LERINS,06,ALPES MARITIMES,304,28,332,0,139,18,157,489
2020,06088,NICE,200030195,METROPOLE NICE COTE D'AZUR,06,ALPES MARITIMES,2990,145,3135,320,1726,165,1891,5346
2020,06157,VENCE,200030195,METROPOLE NICE COTE D'AZUR,06,ALPES MARITIMES,159,3,162,8,93,5,98,269
2020,07010,ANNONAY,200072015,CA ANNONAY RHONE AGGLO,07,ARDECHE,122,18,140,40,81,3,84,264
2020,07324,TOURNON SUR RHONE,200073096,CA ARCHE AGGLO,07,ARDECHE,50,0,50,27,118,4,122,199
2020,08409,SEDAN,200041630,CA ARDENNE METROPOLE,08,ARDENNES,60,26,86,34,81,1,82,201
2020,09225,PAMIERS,200066231,CC DES PORTES D'ARIEGE PYRENEES,09,ARIEGE,193,0,193,6,105,0,105,304
2020,10081,LA CHAPELLE SAINT LUC,200069250,CA TROYES CHAMPAGNE METROPOLE,10,AUBE,78,0,78,61,86,7,93,232
2020,10323,ROMILLY SUR SEINE,200000545,CC DES PORTES DE ROMILLY SUR SEINE,10,AUBE,55,0,55,32,147,4,151,239
2020,10362,SAINTE SAVINE,200069250,CA TROYES CHAMPAGNE METROPOLE,10,AUBE,57,0,57,0,140,4,144,201
2020,10387,TROYES,200069250,CA TROYES CHAMPAGNE METROPOLE,10,AUBE,446,0,446,99,259,33,292,837
2020,11076,CASTELNAUDARY,200035855,CC CASTELNAUDARY LAURAGAIS AUDOIS,11,AUDE,70,9,79,26,88,3,91,196
2020,13004,ARLES,241300417,CA D'ARLES-CRAU-CAMARGUE-MONTAGNETTE,13,BOUCHES DU RHONE,186,14,200,68,318,11,329,597
2020,13007,AURIOL,200054807,METROPOLE D'AIX-MARSEILLE-PROVENCE,13,BOUCHES DU RHONE,72,2,74,0,124,4,128,202
2020,13028,LA CIOTAT,200054807,METROPOLE D'AIX-MARSEILLE-PROVENCE,13,BOUCHES DU RHONE,267,18,285,15,302,15,317,617
2020,13040,FUVEAU,200054807,METROPOLE D'AIX-MARSEILLE-PROVENCE,13,BOUCHES DU RHONE,75,10,85,0,135,7,142,227
2020,13041,GARDANNE,200054807,METROPOLE D'AIX-MARSEILLE-PROVENCE,13,BOUCHES DU RHONE,147,12,159,20,208,5,213,392
2020,13071,LES PENNES MIRABEAU,200054807,METROPOLE D'AIX-MARSEILLE-PROVENCE,13,BOUCHES DU RHONE,165,39,204,18,123,8,131,353
2020,13075,PLAN DE CUQUES,200054807,METROPOLE D'AIX-MARSEILLE-PROVENCE,13,BOUCHES DU RHONE,109,14,123,0,78,0,78,201
2020,13081,ROGNAC,200054807,METROPOLE D'AIX-MARSEILLE-PROVENCE,13,BOUCHES DU RHONE,81,13,94,0,140,1,141,236
2020,13103,SALON DE PROVENCE,200054807,METROPOLE D'AIX-MARSEILLE-PROVENCE,13,BOUCHES DU RHONE,392,39,431,0,369,41,410,841
2020,13106,SEPTEMES LES VALLONS,200054807,METROPOLE D'AIX-MARSEILLE-PROVENCE,13,BOUCHES DU RHONE,110,5,115,15,71,4,75,205
2020,13209,MARSEILLE 9E ARRONDISSEMENT,200054807,METROPOLE D'AIX-MARSEILLE-PROVENCE,13,BOUCHES DU RHONE,962,93,1055,22,476,86,562,1639
2020,13210,MARSEILLE 10E ARRONDISSEMENT,200054807,METROPOLE D'AIX-MARSEILLE-PROVENCE,13,BOUCHES DU RHONE,358,72,430,36,318,35,353,819
2020,13211,MARSEILLE 11E ARRONDISSEMENT,200054807,METROPOLE D'AIX-MARSEILLE-PROVENCE,13,BOUCHES DU RHONE,455,59,514,51,346,19,365,930
2020,13212,MARSEILLE 12E ARRONDISSEMENT,200054807,METROPOLE D'AIX-MARSEILLE-PROVENCE,13,BOUCHES DU RHONE,386,141,527,12,401,54,455,993
2020,13214,MARSEILLE 14E ARRONDISSEMENT,200054807,METROPOLE D'AIX-MARSEILLE-PROVENCE,13,BOUCHES DU RHONE,375,16,391,131,162,27,189,711
2020,13216,MARSEILLE 16E ARRONDISSEMENT,200054807,METROPOLE D'AIX-MARSEILLE-PROVENCE,13,BOUCHES DU RHONE,232,20,252,26,42,2,44,322
2020,14762,VIRE NORMANDIE,200068799,CC INTERCOM DE LA VIRE AU NOIREAU,14,CALVADOS,45,0,45,12,247,3,250,308
2020,17299,ROCHEFORT,200041762,CA ROCHEFORT OCEAN,17,CHARENTE MARITIME,187,2,189,24,219,3,222,435
2020,17306,ROYAN,241700640,CA ROYAN ATLANTIQUE,17,CHARENTE MARITIME,49,0,49,18,87,3,90,157
2020,21166,CHENOVE,242100410,DIJON METROPOLE,21,COTE D OR,96,4,100,73,108,3,111,285
2020,21617,TALANT,242100410,DIJON METROPOLE,21,COTE D OR,126,16,142,10,91,3,94,246
2020,22093,LAMBALLE ARMOR,200069391,CA LAMBALLE TERRE ET MER,22,COTES D ARMOR,46,8,54,32,311,5,316,402
2020,22187,PLERIN,200069409,CA SAINT-BRIEUC ARMOR AGGLOMERATION,22,COTES D ARMOR,109,1,110,36,197,7,204,351
2020,24037,BERGERAC,200070647,CA BERGERACOISE,24,DORDOGNE,155,0,155,61,173,8,181,397
2020,24053,BOULAZAC ISLE MANOIRE,200040392,CA LE GRAND PERIGUEUX,24,DORDOGNE,83,1,84,7,94,3,97,189
2020,25031,AUDINCOURT,200065647,CA PAYS DE MONTBELIARD AGGLOMERATION,25,DOUBS,74,1,75,24,108,0,108,207
2020,25056,BESANCON,242500361,CU GRAND BESANCON METROPOLE,25,DOUBS,781,164,945,177,981,43,1024,2146
2020,26235,PIERRELATTE,200042901,CC DROME SUD PROVENCE,26,DROME,50,8,58,15,175,3,178,250
2020,26281,ROMANS SUR ISERE,200068781,CA VALENCE ROMANS AGGLO,26,DROME,198,14,212,51,318,5,323,586
2020,26362,VALENCE,200068781,CA VALENCE ROMANS AGGLO,26,DROME,713,39,752,134,438,37,475,1361
2020,27284,GISORS,200071843,CC DU VEXIN NORMAND,27,EURE,109,7,116,0,149,4,153,268
2020,28085,CHARTRES,200033181,CA CHARTRES METROPOLE,28,EURE ET LOIR,365,19,384,15,365,31,396,795
2020,28088,CHATEAUDUN,200069961,CC DU GRAND CHATEAUDUN,28,EURE ET LOIR,79,4,83,26,85,2,87,196
2020,28404,VERNOUILLET,200040277,CA AGGLO DU PAYS DE DREUX,28,EURE ET LOIR,98,6,104,6,140,12,152,262
2020,29075,GUIPAVAS,242900314,BREST METROPOLE,29,FINISTERE,167,1,168,33,297,8,305,506
2020,29151,MORLAIX,242900835,CA MORLAIX COMMUNAUTE,29,FINISTERE,130,0,130,19,107,8,115,264
2020,29233,QUIMPERLE,242900694,CA QUIMPERLE COMMUNAUTE,29,FINISTERE,43,7,50,34,179,0,179,263
2020,30007,ALES,200066918,CA ALES AGGLOMERATION,30,GARD,181,1,182,106,228,6,234,522
2020,30032,BEAUCAIRE,243000585,CC BEAUCAIRE TERRE D'ARGENCE,30,GARD,120,0,120,22,73,1,74,216
2020,30341,VAUVERT,243000593,CC DE PETITE CAMARGUE,30,GARD,37,2,39,29,96,1,97,165
2020,31113,CASTANET TOLOSAN,243100633,CA DU SICOVAL,31,HAUTE GARONNE,120,17,137,1,190,7,197,335
2020,31116,CASTELGINEST,243100518,TOULOUSE METROPOLE,31,HAUTE GARONNE,49,0,49,0,190,2,192,241
2020,31555,TOULOUSE,243100518,TOULOUSE METROPOLE,31,HAUTE GARONNE,6198,64,6262,430,2556,748,3304,9996
2020,33063,BORDEAUX,243300316,BORDEAUX METROPOLE,33,GIRONDE,3194,304,3498,139,1994,505,2499,6136
2020,33075,BRUGES,243300316,BORDEAUX METROPOLE,33,GIRONDE,253,22,275,0,302,12,314,589
2020,33200,LE HAILLAN,243300316,BORDEAUX METROPOLE,33,GIRONDE,138,10,148,0,138,5,143,291
2020,33281,MERIGNAC,243300316,BORDEAUX METROPOLE,33,GIRONDE,527,102,629,0,997,54,1051,1680
2020,33318,PESSAC,243300316,BORDEAUX METROPOLE,33,GIRONDE,541,56,597,26,809,36,845,1467
2020,33519,LE TAILLAN MEDOC,243300316,BORDEAUX METROPOLE,33,GIRONDE,41,29,70,4,179,1,180,254
2020,34032,BEZIERS,243400769,CA DE BEZIERS-MEDITERRANEE,34,HERAULT,322,19,341,88,412,15,427,856
2020,34129,LATTES,243400017,MONTPELLIER MEDITERRANEE METROPOLE,34,HERAULT,225,6,231,0,125,16,141,371
2020,34172,MONTPELLIER,243400017,MONTPELLIER MEDITERRANEE METROPOLE,34,HERAULT,2580,149,2729,209,1602,262,1864,4801
2020,34270,SAINT JEAN DE VEDAS,243400017,MONTPELLIER MEDITERRANEE METROPOLE,34,HERAULT,70,42,112,1,149,6,155,268
2020,34337,VILLENEUVE LES MAGUELONE,243400017,MONTPELLIER MEDITERRANEE METROPOLE,34,HERAULT,91,10,101,0,97,5,102,204
2020,35024,BETTON,243500139,RENNES METROPOLE,35,ILLE ET VILAINE,56,38,94,9,223,9,232,335
2020,35055,CHANTEPIE,243500139,RENNES METROPOLE,35,ILLE ET VILAINE,42,10,52,11,180,1,181,244
2020,35115,FOUGERES,200072452,CA FOUGERES AGGLOMERATION,35,ILLE ET VILAINE,72,24,96,46,214,11,225,367
2020,35210,PACE,243500139,RENNES METROPOLE,35,ILLE ET VILAINE,60,3,63,24,172,12,184,271
2020,35360,VITRE,200039022,CA VITRE COMMUNAUTE,35,ILLE ET VILAINE,105,11,116,57,264,11,275,448
2020,36088,ISSOUDUN,243600236,CC DU PAYS D'ISSOUDUN,36,INDRE,40,0,40,26,135,0,135,201
2020,37003,AMBOISE,200043065,CC DU VAL D AMBOISE,37,INDRE ET LOIRE,60,0,60,0,182,3,185,245
2020,38085,CHARVIEU CHAVAGNEUX,243800935,CC LYON-SAINT-EXUPERY EN DAUPHINE,38,ISERE,20,47,67,0,250,1,251,318
2020,38169,FONTAINE,200040715,GRENOBLE-ALPES-METROPOLE,38,ISERE,147,14,161,34,320,7,327,522
2020,38229,MEYLAN,200040715,GRENOBLE-ALPES-METROPOLE,38,ISERE,184,23,207,2,193,13,206,415
2020,38382,SAINT EGREVE,200040715,GRENOBLE-ALPES-METROPOLE,38,ISERE,209,7,216,0,249,8,257,474
2020,39198,DOLE,200010650,CA DU GRAND DOLE,39,JURA,176,0,176,37,194,10,204,417
2020,39300,LONS LE SAUNIER,200071116,CA ECLA  (ESPACE COMMUNAUTAIRE LONS AGGLOMERATION),39,JURA,160,3,163,27,114,2,116,307
2020,40046,BISCARROSSE,244000873,CC DES GRANDS LACS,40,LANDES,84,2,86,0,152,3,155,241
2020,40088,DAX,244000675,CA DU GRAND DAX,40,LANDES,202,1,203,43,106,10,116,362
2020,40192,MONT DE MARSAN,244000808,CA MONT DE MARSAN AGGLOMERATION,40,LANDES,176,4,180,32,345,4,349,561
2020,40312,TARNOS,244000659,CC DU SEIGNANX,40,LANDES,60,44,104,6,110,5,115,224
2020,41018,BLOIS,200030385,CA DE BLOIS ''AGGLOPOLYS'',41,LOIR ET CHER,340,19,359,88,468,8,476,923
2020,41194,ROMORANTIN LANTHENAY,200018406,CC DU ROMORANTINAIS ET DU MONESTOIS,41,LOIR ET CHER,85,0,85,17,208,0,208,310
2020,41269,VENDOME,200072072,CA TERRITOIRES VENDOMOIS,41,LOIR ET CHER,104,0,104,7,189,0,189,300
2020,42044,LE CHAMBON FEUGEROLLES,244200770,SAINT-ETIENNE METROPOLE,42,LOIRE,86,2,88,32,89,3,92,212
2020,42095,FIRMINY,244200770,SAINT-ETIENNE METROPOLE,42,LOIRE,65,16,81,28,145,3,148,257
2020,42147,MONTBRISON,200065886,CA LOIRE FOREZ AGGLOMERATION (LFA),42,LOIRE,111,4,115,0,211,9,220,335
2020,42279,SAINT JUST SAINT RAMBERT,200065886,CA LOIRE FOREZ AGGLOMERATION (LFA),42,LOIRE,111,7,118,8,200,12,212,338
2020,43157,LE PUY EN VELAY,200073419,CA DU PUY-EN-VELAY,43,HAUTE LOIRE,100,5,105,102,125,3,128,334
2020,44114,ORVAULT,244400404,NANTES METROPOLE,44,LOIRE ATLANTIQUE,237,31,268,15,391,36,427,710
2020,44162,SAINT HERBLAIN,244400404,NANTES METROPOLE,44,LOIRE ATLANTIQUE,491,55,546,63,814,43,857,1466
2020,44172,SAINTE LUCE SUR LOIRE,244400404,NANTES METROPOLE,44,LOIRE ATLANTIQUE,122,8,130,0,318,10,328,458
2020,44184,SAINT NAZAIRE,244400644,CA DE LA REGION NAZAIRIENNE ET DE L'ESTUAIRE (CARENE),44,LOIRE ATLANTIQUE,420,41,461,164,745,52,797,1423
2020,44190,SAINT SEBASTIEN SUR LOIRE,244400404,NANTES METROPOLE,44,LOIRE ATLANTIQUE,126,23,149,5,521,24,545,700
2020,44215,VERTOU,244400404,NANTES METROPOLE,44,LOIRE ATLANTIQUE,120,56,176,10,452,23,475,661
2020,45068,CHALETTE SUR LOING,244500203,CA MONTARGOISE ET RIVES DU LOING (AME),45,LOIRET,100,6,106,51,75,0,75,232
2020,45147,FLEURY LES AUBRAIS,244500468,ORLEANS METROPOLE,45,LOIRET,132,28,160,0,280,5,285,445
2020,47157,MARMANDE,200030674,CA VAL DE GARONNE AGGLOMERATION,47,LOT ET GARONNE,136,0,136,9,145,4,149,294
2020,47323,VILLENEUVE SUR LOT,200023307,CA DU GRAND VILLENEUVOIS,47,LOT ET GARONNE,147,0,147,37,172,8,180,364
2020,49015,AVRILLE,244900015,CU ANGERS LOIRE METROPOLE,49,MAINE ET LOIRE,57,41,98,9,182,13,195,301
2020,49099,CHOLET,200071678,CA AGGLOMERATION DU CHOLETAIS,49,MAINE ET LOIRE,292,27,319,141,627,19,646,1106
2020,49125,DOUE EN ANJOU,200071876,CA SAUMUR VAL DE LOIRE,49,MAINE ET LOIRE,20,1,21,5,158,3,161,187
2020,49246,LES PONTS DE CE,244900015,CU ANGERS LOIRE METROPOLE,49,MAINE ET LOIRE,40,8,48,6,170,9,179,233
2020,49331,SEGRE EN ANJOU BLEU,244900809,CC ANJOU BLEU COMMUNAUTE,49,MAINE ET LOIRE,69,1,70,24,279,8,287,381
2020,49353,TRELAZE,244900015,CU ANGERS LOIRE METROPOLE,49,MAINE ET LOIRE,84,44,128,71,322,9,331,530
2020,50129,CHERBOURG EN COTENTIN,200067205,CA DU COTENTIN,50,MANCHE,561,0,561,149,899,46,945,1655
2020,50502,SAINT LO,200066389,CA SAINT-LO AGGLO,50,MANCHE,90,16,106,31,235,8,243,380
2020,51108,CHALONS EN CHAMPAGNE,200066876,CA DE CHALONS-EN-CHAMPAGNE,51,MARNE,476,25,501,39,300,14,314,854
2020,51454,REIMS,200067213,CU DU GRAND REIMS,51,MARNE,1348,439,1787,279,1164,159,1323,3389
2020,51573,TINQUEUX,200067213,CU DU GRAND REIMS,51,MARNE,74,27,101,0,139,3,142,243
2020,53147,MAYENNE,200055887,CC MAYENNE COMMUNAUTE,53,MAYENNE,80,7,87,30,140,2,142,259
2020,54323,LONGWY,245400262,CA GRAND LONGWY AGGLOMERATION,54,MEURTHE ET MOSELLE,85,0,85,14,60,0,60,159
2020,54431,PONT A MOUSSON,200041515,CC DU BASSIN DE PONT-A-MOUSSON,54,MEURTHE ET MOSELLE,50,0,50,10,123,3,126,186
2020,54482,SAINT MAX,245400676,METROPOLE DU GRAND NANCY,54,MEURTHE ET MOSELLE,34,8,42,0,82,8,90,132
2020,54578,VILLERS LES NANCY,245400676,METROPOLE DU GRAND NANCY,54,MEURTHE ET MOSELLE,45,9,54,19,142,4,146,220
2020,56083,HENNEBONT,200042174,CA LORIENT AGGLOMERATION,56,MORBIHAN,50,3,53,76,174,4,178,308
2020,56206,SAINT AVE,200067932,CA GOLFE DU MORBIHAN - VANNES AGGLOMERATION,56,MORBIHAN,45,4,49,46,181,10,191,287
2020,57019,AMNEVILLE,245701271,CC DU PAYS ORNE MOSELLE,57,MOSELLE,60,3,63,26,181,0,181,270
2020,57221,FLORANGE,245701222,CA DU VAL DE FENSCH,57,MOSELLE,35,15,50,21,92,0,92,162
2020,57480,MONTIGNY LES METZ,200039865,METZ METROPOLE,57,MOSELLE,90,23,113,0,240,7,247,359
2020,57631,SARREGUEMINES,200070746,CA SARREGUEMINES CONFLUENCES,57,MOSELLE,210,0,210,33,54,2,56,299
2020,57751,WOIPPY,200039865,METZ METROPOLE,57,MOSELLE,30,4,34,32,161,3,164,230
2020,59009,VILLENEUVE D ASCQ,200093201,METROPOLE EUROPEENNE DE LILLE,59,NORD,613,100,713,214,555,46,601,1528
2020,59011,ANNOEULLIN,200093201,METROPOLE EUROPEENNE DE LILLE,59,NORD,54,14,68,28,147,6,153,249
2020,59017,ARMENTIERES,200093201,METROPOLE EUROPEENNE DE LILLE,59,NORD,101,32,133,102,250,13,263,497
2020,59043,BAILLEUL,200040947,CC DE FLANDRE INTERIEURE,59,NORD,75,14,89,40,209,4,213,342
2020,59112,BRUAY SUR L ESCAUT,245901160,CA VALENCIENNES METROPOLE,59,NORD,15,1,16,44,80,0,80,141
2020,59139,CAUDRY,200030633,CA DU CAUDRESIS ET DU CATESIS,59,NORD,45,3,48,69,142,1,143,260
2020,59155,COUDEKERQUE BRANCHE,245900428,CU DE DUNKERQUE,59,NORD,62,7,69,79,313,6,319,467
2020,59172,DENAIN,200042190,CA DE LA PORTE DU HAINAUT,59,NORD,55,0,55,90,81,1,82,227
2020,59178,DOUAI,200044618,CA DOUAISIS AGGLO,59,NORD,206,26,232,189,231,14,245,666
2020,59179,DOUCHY LES MINES,200042190,CA DE LA PORTE DU HAINAUT,59,NORD,20,0,20,85,123,0,123,229
2020,59249,FOURMIES,200043404,CC DU SUD AVESNOIS,59,NORD,24,4,28,27,61,2,63,119
2020,59273,GRAVELINES,245900428,CU DE DUNKERQUE,59,NORD,65,11,76,55,127,1,128,260
2020,59279,HALLUIN,200093201,METROPOLE EUROPEENNE DE LILLE,59,NORD,92,35,127,49,272,4,276,452
2020,59286,HAUBOURDIN,200093201,METROPOLE EUROPEENNE DE LILLE,59,NORD,61,24,85,39,230,11,241,365
2020,59324,JEUMONT,200043396,CA MAUBEUGE VAL DE SAMBRE,59,NORD,20,0,20,57,78,2,80,157
2020,59360,LOOS,200093201,METROPOLE EUROPEENNE DE LILLE,59,NORD,135,25,160,40,302,7,309,509
2020,59378,MARCQ EN BAROEUL,200093201,METROPOLE EUROPEENNE DE LILLE,59,NORD,286,183,469,42,496,91,587,1098
2020,59383,MARLY,245901160,CA VALENCIENNES METROPOLE,59,NORD,90,8,98,38,149,1,150,286
2020,59386,MARQUETTE LEZ LILLE,200093201,METROPOLE EUROPEENNE DE LILLE,59,NORD,115,11,126,27,233,8,241,394
2020,59392,MAUBEUGE,200043396,CA MAUBEUGE VAL DE SAMBRE,59,NORD,94,2,96,126,150,4,154,376
2020,59507,RONCHIN,200093201,METROPOLE EUROPEENNE DE LILLE,59,NORD,102,57,159,19,226,5,231,409
2020,59527,SAINT ANDRE LEZ LILLE,200093201,METROPOLE EUROPEENNE DE LILLE,59,NORD,103,28,131,16,156,10,166,313
2020,59569,SIN LE NOBLE,200044618,CA DOUAISIS AGGLO,59,NORD,60,11,71,69,150,5,155,295
2020,59599,TOURCOING,200093201,METROPOLE EUROPEENNE DE LILLE,59,NORD,540,137,677,366,864,20,884,1927
2020,59616,VIEUX CONDE,245901160,CA VALENCIENNES METROPOLE,59,NORD,25,1,26,34,63,2,65,125
2020,59636,WAMBRECHIES,200093201,METROPOLE EUROPEENNE DE LILLE,59,NORD,30,48,78,22,178,4,182,282
2020,59646,WASQUEHAL,200093201,METROPOLE EUROPEENNE DE LILLE,59,NORD,227,55,282,59,295,25,320,661
2020,59650,WATTRELOS,200093201,METROPOLE EUROPEENNE DE LILLE,59,NORD,185,54,239,129,432,5,437,806
2020,60057,BEAUVAIS,200067999,CA DU BEAUVAISIS,60,OISE,530,16,546,155,382,21,403,1103
2020,60139,CHAMBLY,200067973,CC THELLOISE,60,OISE,40,3,43,0,164,2,166,209
2020,60471,NOYON,246000756,CC DU PAYS NOYONNAIS,60,OISE,122,0,122,37,78,1,79,238
2020,60509,PONT SAINTE MAXENCE,246000921,CC DES PAYS D'OISE ET D'HALATTE,60,OISE,167,7,174,26,93,2,95,295
2020,60612,SENLIS,200066975,CC SENLIS SUD OISE,60,OISE,170,2,172,6,184,14,198,376
2020,61169,FLERS,200035814,CA FLERS AGGLO,61,ORNE,66,0,66,34,99,3,102,202
2020,62413,HARNES,246200364,CA DE LENS - LIEVIN,62,PAS DE CALAIS,0,24,24,44,112,1,113,181
2020,62498,LENS,246200364,CA DE LENS - LIEVIN,62,PAS DE CALAIS,115,30,145,95,153,3,156,396
2020,62525,LONGUENESSE,200069037,CA DU PAYS DE SAINT-OMER,62,PAS DE CALAIS,45,3,48,30,123,1,124,202
2020,62548,MARCK,200090751,CA GRAND CALAIS TERRES ET MERS,62,PAS DE CALAIS,47,0,47,26,111,2,113,186
2020,62643,OUTREAU,246200729,CA DU BOULONNAIS,62,PAS DE CALAIS,60,1,61,47,87,2,89,197
2020,62758,SAINT MARTIN BOULOGNE,246200729,CA DU BOULONNAIS,62,PAS DE CALAIS,50,7,57,49,99,4,103,209
2020,63284,PONT DU CHATEAU,246300701,CLERMONT AUVERGNE METROPOLE,63,PUY DE DOME,30,25,55,4,223,2,225,284
2020,63430,THIERS,200070712,CC THIERS DORE ET MONTAGNE,63,PUY DE DOME,15,2,17,26,97,6,103,146
2020,64024,ANGLET,200067106,CA DU PAYS BASQUE,64,PYRENEES ATLANTIQUES,145,87,232,12,388,33,421,665
2020,64129,BILLERE,200067254,CA PAU BEARN PYRENEES,64,PYRENEES ATLANTIQUES,94,11,105,10,137,6,143,258
2020,64260,HENDAYE,200067106,CA DU PAYS BASQUE,64,PYRENEES ATLANTIQUES,86,11,97,10,67,3,70,177
2020,64422,OLORON SAINTE MARIE,200067262,CC DU HAUT BEARN,64,PYRENEES ATLANTIQUES,91,0,91,19,64,0,64,174
2020,64445,PAU,200067254,CA PAU BEARN PYRENEES,64,PYRENEES ATLANTIQUES,432,46,478,62,513,35,548,1089
2020,64545,URRUGNE,200067106,CA DU PAYS BASQUE,64,PYRENEES ATLANTIQUES,81,11,92,4,57,1,58,153
2020,66037,CANET EN ROUSSILLON,200027183,CU PERPIGNAN MEDITERRANEE METROPOLE,66,PYRENEES ORIENTALES,79,13,92,0,61,6,67,159
2020,66136,PERPIGNAN,200027183,CU PERPIGNAN MEDITERRANEE METROPOLE,66,PYRENEES ORIENTALES,742,120,862,337,421,36,457,1656
2020,67204,HOENHEIM,246700488,EUROMETROPOLE DE STRASBOURG,67,BAS RHIN,120,19,139,0,88,3,91,230
2020,67218,ILLKIRCH GRAFFENSTADEN,246700488,EUROMETROPOLE DE STRASBOURG,67,BAS RHIN,409,40,449,0,232,6,238,687
2020,67365,OSTWALD,246700488,EUROMETROPOLE DE STRASBOURG,67,BAS RHIN,160,10,170,0,111,2,113,283
2020,67437,SAVERNE,200068112,CC DU PAYS DE SAVERNE,67,BAS RHIN,111,12,123,23,76,6,82,228
2020,67447,SCHILTIGHEIM,246700488,EUROMETROPOLE DE STRASBOURG,67,BAS RHIN,397,84,481,52,254,16,270,804
2020,68063,CERNAY,200036465,CC DE THANN-CERNAY,68,HAUT RHIN,33,8,41,6,103,0,103,150
2020,68154,ILLZACH,200066009,CA MULHOUSE ALSACE AGGLOMERATION,68,HAUT RHIN,85,3,88,14,66,3,69,171
2020,68278,RIXHEIM,200066009,CA MULHOUSE ALSACE AGGLOMERATION,68,HAUT RHIN,130,3,133,11,119,1,120,264
2020,68376,WITTENHEIM,200066009,CA MULHOUSE ALSACE AGGLOMERATION,68,HAUT RHIN,85,8,93,0,104,2,106,200
2020,69034,CALUIRE ET CUIRE,200046977,METROPOLE DE LYON,69,RHONE,339,110,449,37,450,68,518,1004
2020,69089,FRANCHEVILLE,200046977,METROPOLE DE LYON,69,RHONE,159,51,210,0,165,12,177,387
2020,69152,PIERRE BENITE,200046977,METROPOLE DE LYON,69,RHONE,171,2,173,27,140,7,147,347
2020,69202,SAINTE FOY LES LYON,200046977,METROPOLE DE LYON,69,RHONE,174,46,220,5,223,22,245,470
2020,69244,TASSIN LA DEMI LUNE,200046977,METROPOLE DE LYON,69,RHONE,131,66,197,4,256,21,277,478
2020,69256,VAULX EN VELIN,200046977,METROPOLE DE LYON,69,RHONE,402,21,423,185,356,16,372,979
2020,69264,VILLEFRANCHE SUR SAONE,200040590,CA VILLEFRANCHE BEAUJOLAIS SAONE,69,RHONE,330,19,349,120,235,16,251,720
2020,69277,GENAS,246900575,CC DE L'EST LYONNAIS (CCEL),69,RHONE,96,28,124,0,158,8,166,290
2020,69282,MEYZIEU,200046977,METROPOLE DE LYON,69,RHONE,239,77,316,53,470,14,484,853
2020,69283,MIONS,200046977,METROPOLE DE LYON,69,RHONE,59,27,86,0,235,3,238,325
2020,69383,LYON 3E ARRONDISSEMENT,200046977,METROPOLE DE LYON,69,RHONE,1433,260,1693,20,982,241,1223,2936
2020,69389,LYON 9E ARRONDISSEMENT,200046977,METROPOLE DE LYON,69,RHONE,657,72,729,117,526,70,596,1442
2020,70285,HERICOURT,247000722,CC DU PAYS D'HERICOURT,70,HAUTE SAONE,30,2,32,16,146,2,148,196
2020,73008,AIX LES BAINS,200068674,CA GRAND LAC,73,SAVOIE,155,54,209,28,312,16,328,565
2020,73011,ALBERTVILLE,200068997,CA ARLYSERE,73,SAVOIE,88,2,90,24,248,3,251,365
2020,74010,ANNECY,200066793,CA DU GRAND ANNECY,74,HAUTE SAVOIE,1254,90,1344,36,1094,83,1177,2558
2020,74042,BONNEVILLE,200000172,CC FAUCIGNY-GLIERES,74,HAUTE SAVOIE,52,13,65,0,201,3,204,269
2020,74081,CLUSES,200033116,CC CLUSES-ARVE ET MONTAGNES,74,HAUTE SAVOIE,68,5,73,42,123,2,125,240
2020,74208,PASSY,200034882,CC PAYS DU MONT-BLANC,74,HAUTE SAVOIE,78,11,89,0,127,4,131,220
2020,74243,SAINT JULIEN EN GENEVOIS,247400690,CC DU GENEVOIS,74,HAUTE SAVOIE,101,12,113,1,146,5,151,265
2020,75102,PARIS 2E ARRONDISSEMENT,200054781,METROPOLE DU GRAND PARIS,75,PARIS,378,17,395,3,20,141,161,559
2020,75103,PARIS 3E ARRONDISSEMENT,200054781,METROPOLE DU GRAND PARIS,75,PARIS,686,19,705,12,63,163,226,943
2020,75104,PARIS 4E ARRONDISSEMENT,200054781,METROPOLE DU GRAND PARIS,75,PARIS,595,6,601,24,27,113,140,765
2020,75108,PARIS 8E ARRONDISSEMENT,200054781,METROPOLE DU GRAND PARIS,75,PARIS,671,31,702,58,31,336,367,1128
2020,75120,PARIS 20E ARRONDISSEMENT,200054781,METROPOLE DU GRAND PARIS,75,PARIS,3954,97,4051,63,466,429,895,5009
2020,76057,BARENTIN,247600646,CC CAUX - AUSTREBERTHE,76,SEINE MARITIME,72,1,73,1,209,0,209,283
2020,76157,CANTELEU,200023414,METROPOLE ROUEN NORMANDIE,76,SEINE MARITIME,157,4,161,32,131,2,133,326
2020,76216,DEVILLE LES ROUEN,200023414,METROPOLE ROUEN NORMANDIE,76,SEINE MARITIME,40,6,46,10,203,2,205,261
2020,76259,FECAMP,200069821,CA FECAMP CAUX LITTORAL AGGLOMERATION,76,SEINE MARITIME,126,1,127,29,149,4,153,309
2020,76322,LE GRAND QUEVILLY,200023414,METROPOLE ROUEN NORMANDIE,76,SEINE MARITIME,127,11,138,15,414,3,417,571
2020,76451,MONT SAINT AIGNAN,200023414,METROPOLE ROUEN NORMANDIE,76,SEINE MARITIME,258,26,284,4,134,26,160,448
2020,76476,PORT JEROME SUR SEINE,200010700,CA CAUX SEINE AGGLO,76,SEINE MARITIME,30,3,33,0,198,3,201,234
2020,76498,LE PETIT QUEVILLY,200023414,METROPOLE ROUEN NORMANDIE,76,SEINE MARITIME,114,18,132,45,298,6,304,481
2020,76575,SAINT ETIENNE DU ROUVRAY,200023414,METROPOLE ROUEN NORMANDIE,76,SEINE MARITIME,120,13,133,61,424,9,433,628
2020,77014,AVON,200072346,CA DU PAYS DE FONTAINEBLEAU,77,SEINE ET MARNE,78,8,86,2,144,3,147,235
2020,77058,BUSSY SAINT GEORGES,247700594,CA MARNE ET GONDOIRE,77,SEINE ET MARNE,365,17,382,16,231,14,245,643
2020,77067,CESSON,200059228,CA GRAND PARIS SUD SEINE ESSONNE SENART,77,SEINE ET MARNE,163,4,167,4,105,1,106,277
2020,77118,CLAYE SOUILLY,200055655,CA ROISSY PAYS DE FRANCE,77,SEINE ET MARNE,30,4,34,6,168,4,172,212
2020,77122,COMBS LA VILLE,200059228,CA GRAND PARIS SUD SEINE ESSONNE SENART,77,SEINE ET MARNE,163,1,164,23,319,9,328,516
2020,77131,COULOMMIERS,200090504,CA COULOMMIERS PAYS DE BRIE,77,SEINE ET MARNE,147,20,167,24,147,1,148,339
2020,77152,DAMMARIE LES LYS,247700057,CA MELUN VAL DE SEINE,77,SEINE ET MARNE,220,0,220,0,246,2,248,468
2020,77153,DAMMARTIN EN GOELE,200055655,CA ROISSY PAYS DE FRANCE,77,SEINE ET MARNE,40,5,45,0,168,4,172,217
2020,77285,LE MEE SUR SEINE,247700057,CA MELUN VAL DE SEINE,77,SEINE ET MARNE,246,0,246,74,166,4,170,490
2020,77307,MONTEVRAIN,247700594,CA MARNE ET GONDOIRE,77,SEINE ET MARNE,136,21,157,0,197,3,200,357
2020,77316,MORET LOING ET ORVANNE,247700032,CC MORET SEINE ET LOING,77,SEINE ET MARNE,152,7,159,1,126,3,129,289
2020,77337,NOISIEL,200057958,CA PARIS - VALLEE DE LA MARNE,77,SEINE ET MARNE,197,1,198,12,103,5,108,318
2020,77350,OZOIR LA FERRIERE,200023125,CC LES PORTES BRIARDES ENTRE VILLES ET FORETS,77,SEINE ET MARNE,200,8,208,8,221,1,222,438
2020,77373,PONTAULT COMBAULT,200057958,CA PARIS - VALLEE DE LA MARNE,77,SEINE ET MARNE,195,4,199,47,571,10,581,826
2020,77390,ROISSY EN BRIE,200057958,CA PARIS - VALLEE DE LA MARNE,77,SEINE ET MARNE,166,8,174,22,283,11,294,490
2020,77468,TORCY,200057958,CA PARIS - VALLEE DE LA MARNE,77,SEINE ET MARNE,294,23,317,13,203,10,213,544
2020,78124,CARRIERES SUR SEINE,200058519,CA SAINT GERMAIN BOUCLES DE SEINE,78,YVELINES,220,13,233,28,121,16,137,398
2020,78138,CHANTELOUP LES VIGNES,200059889,CU GRAND PARIS SEINE ET OISE,78,YVELINES,108,2,110,4,107,2,109,223
2020,78146,CHATOU,200058519,CA SAINT GERMAIN BOUCLES DE SEINE,78,YVELINES,453,21,474,9,219,100,319,802
2020,78165,LES CLAYES SOUS BOIS,200058782,CA DE SAINT QUENTIN EN YVELINES,78,YVELINES,181,30,211,12,189,8,197,420
2020,78172,CONFLANS SAINTE HONORINE,200059889,CU GRAND PARIS SEINE ET OISE,78,YVELINES,331,38,369,4,425,29,454,827
2020,78208,ELANCOURT,200058782,CA DE SAINT QUENTIN EN YVELINES,78,YVELINES,320,15,335,7,367,12,379,720
2020,78311,HOUILLES,200058519,CA SAINT GERMAIN BOUCLES DE SEINE,78,YVELINES,290,103,393,0,454,74,528,921
2020,78362,MANTES LA VILLE,200059889,CU GRAND PARIS SEINE ET OISE,78,YVELINES,100,62,162,11,203,16,219,392
2020,78418,MONTESSON,200058519,CA SAINT GERMAIN BOUCLES DE SEINE,78,YVELINES,195,5,200,0,112,16,128,328
2020,78517,RAMBOUILLET,200073344,CA RAMBOUILLET TERRITOIRES,78,YVELINES,282,15,297,0,275,20,295,592
2020,78551,SAINT GERMAIN EN LAYE,200058519,CA SAINT GERMAIN BOUCLES DE SEINE,78,YVELINES,559,110,669,11,213,88,301,981
2020,78586,SARTROUVILLE,200058519,CA SAINT GERMAIN BOUCLES DE SEINE,78,YVELINES,352,268,620,53,573,84,657,1330
2020,78624,TRIEL SUR SEINE,200059889,CU GRAND PARIS SEINE ET OISE,78,YVELINES,45,32,77,0,143,9,152,229
2020,78642,VERNEUIL SUR SEINE,200059889,CU GRAND PARIS SEINE ET OISE,78,YVELINES,76,30,106,0,207,9,216,322
2020,78650,LE VESINET,200058519,CA SAINT GERMAIN BOUCLES DE SEINE,78,YVELINES,233,4,237,16,53,68,121,374
2020,78686,VIROFLAY,247800584,CA VERSAILLES GRAND PARC (CAVGP),78,YVELINES,222,35,257,0,89,82,171,428
2020,79329,THOUARS,247900798,CC DU THOUARSAIS,79,DEUX SEVRES,91,0,91,11,150,2,152,254
2020,81004,ALBI,248100737,CA DE L'ALBIGEOIS (C2A),81,TARN,399,61,460,32,246,26,272,765
2020,81099,GAILLAC,200066124,CA GAILLAC-GRAULHET,81,TARN,62,7,69,8,170,7,177,254
2020,81140,LAVAUR,200034023,CC TARN-AGOUT,81,TARN,125,0,125,11,125,1,126,262
2020,83023,BRIGNOLES,200068104,CA DE LA PROVENCE VERTE,83,VAR,110,3,113,1,174,7,181,295
2020,83042,COGOLIN,200036077,CC DU GOLFE DE SAINT-TROPEZ,83,VAR,108,1,109,0,91,2,93,203
2020,83049,CUERS,200027100,CC MEDITERRANEE PORTE DES MAURES,83,VAR,50,14,64,0,180,4,184,248
2020,83116,SAINT MAXIMIN LA SAINTE BAUME,200068104,CA DE LA PROVENCE VERTE,83,VAR,151,10,161,1,173,7,180,343
2020,83123,SANARY SUR MER,248300394,CA SUD SAINTE BAUME,83,VAR,111,28,139,5,77,8,85,229
2020,83129,SIX FOURS LES PLAGES,248300543,METROPOLE TOULON-PROVENCE-MEDITERRANEE,83,VAR,243,65,308,3,204,13,217,529
2020,83130,SOLLIES PONT,248300410,CC DE LA VALLEE DU GAPEAU,83,VAR,75,13,88,8,115,6,121,217
2020,84080,MONTEUX,248400293,CA DES SORGUES DU COMTAT,84,VAUCLUSE,71,16,87,0,133,3,136,223
2020,84141,VEDENE,248400251,CA DU GRAND AVIGNON (COGA),84,VAUCLUSE,65,23,88,0,142,3,145,234
2020,85109,LES HERBIERS,248500621,CC DU PAYS DES HERBIERS,85,VENDEE,61,40,101,32,287,7,294,428
2020,85146,MONTAIGU VENDEE,200070233,CA TERRES DE MONTAIGU,85,VENDEE,98,21,119,14,458,11,469,602
2020,85191,LA ROCHE SUR YON,248500589,CA LA ROCHE SUR YON - AGGLOMERATION,85,VENDEE,380,28,408,68,529,33,562,1038
2020,86041,BUXEROLLES,200069854,CU DU GRAND POITIERS,86,VIENNE,30,1,31,0,156,2,158,189
2020,87114,PANAZOL,248719312,CU LIMOGES METROPOLE,87,HAUTE VIENNE,38,11,49,0,121,7,128,177
2020,88160,EPINAL,200068757,CA D'EPINAL,88,VOSGES,225,6,231,64,272,5,277,572
2020,89024,AUXERRE,200067114,CA DE L'AUXERROIS,89,YONNE,315,7,322,32,381,4,385,739
2020,89387,SENS,248900334,CA DU GRAND SENONAIS,89,YONNE,252,0,252,0,210,13,223,476
2020,90010,BELFORT,200069052,CA GRAND BELFORT,90,TERRITOIRE DE BELFORT,395,10,405,140,257,16,273,818
2020,91103,BRETIGNY SUR ORGE,200057859,CA COEUR D'ESSONNE AGGLOMERATION,91,ESSONNE,253,30,283,0,410,3,413,696
2020,91114,BRUNOY,200058477,CA VAL D'YERRES VAL DE SEINE,91,ESSONNE,220,9,229,32,230,14,244,505
2020,91174,CORBEIL ESSONNES,200059228,CA GRAND PARIS SUD SEINE ESSONNE SENART,91,ESSONNE,346,16,362,98,380,14,394,855
2020,91223,ETAMPES,200017846,CA ETAMPOIS SUD ESSONNE,91,ESSONNE,238,14,252,23,200,3,203,477
2020,91272,GIF SUR YVETTE,200056232,CA COMMUNAUTE PARIS-SACLAY,91,ESSONNE,232,4,236,4,179,12,191,431
2020,91326,JUVISY SUR ORGE,200054781,METROPOLE DU GRAND PARIS,91,ESSONNE,150,17,167,0,145,18,163,329
2020,91345,LONGJUMEAU,200056232,CA COMMUNAUTE PARIS-SACLAY,91,ESSONNE,215,4,219,10,219,8,227,456
2020,91377,MASSY,200056232,CA COMMUNAUTE PARIS-SACLAY,91,ESSONNE,902,49,951,7,636,28,664,1623
2020,91386,MENNECY,249100546,CC DU VAL D'ESSONNE (CCVE),91,ESSONNE,100,4,104,0,180,7,187,291
2020,91421,MONTGERON,200058477,CA VAL D'YERRES VAL DE SEINE,91,ESSONNE,196,6,202,20,255,26,281,503
2020,91657,VIGNEUX SUR SEINE,200058477,CA VAL D'YERRES VAL DE SEINE,91,ESSONNE,218,24,242,0,300,9,309,550
2020,91691,YERRES,200058477,CA VAL D'YERRES VAL DE SEINE,91,ESSONNE,415,11,426,53,316,14,330,810
2020,92004,ASNIERES SUR SEINE,200054781,METROPOLE DU GRAND PARIS,92,HAUTS DE SEINE,1260,167,1427,25,429,783,1212,2664
2020,92007,BAGNEUX,200054781,METROPOLE DU GRAND PARIS,92,HAUTS DE SEINE,420,43,463,83,356,48,404,950
2020,92009,BOIS COLOMBES,200054781,METROPOLE DU GRAND PARIS,92,HAUTS DE SEINE,372,127,499,1,177,165,342,842
2020,92019,CHATENAY MALABRY,200054781,METROPOLE DU GRAND PARIS,92,HAUTS DE SEINE,416,10,426,42,206,41,247,715
2020,92033,GARCHES,200054781,METROPOLE DU GRAND PARIS,92,HAUTS DE SEINE,359,10,369,0,66,70,136,505
2020,92046,MALAKOFF,200054781,METROPOLE DU GRAND PARIS,92,HAUTS DE SEINE,390,14,404,14,211,54,265,684
2020,92048,MEUDON,200054781,METROPOLE DU GRAND PARIS,92,HAUTS DE SEINE,637,33,670,8,266,162,428,1106
2020,92049,MONTROUGE,200054781,METROPOLE DU GRAND PARIS,92,HAUTS DE SEINE,1079,68,1147,38,212,195,407,1592
2020,92051,NEUILLY SUR SEINE,200054781,METROPOLE DU GRAND PARIS,92,HAUTS DE SEINE,779,40,819,25,26,642,668,1513
2020,92060,LE PLESSIS ROBINSON,200054781,METROPOLE DU GRAND PARIS,92,HAUTS DE SEINE,512,8,520,8,246,39,285,814
2020,92062,PUTEAUX,200054781,METROPOLE DU GRAND PARIS,92,HAUTS DE SEINE,1052,79,1131,23,305,212,517,1671
2020,92064,SAINT CLOUD,200054781,METROPOLE DU GRAND PARIS,92,HAUTS DE SEINE,482,43,525,3,124,175,299,827
2020,92071,SCEAUX,200054781,METROPOLE DU GRAND PARIS,92,HAUTS DE SEINE,322,2,324,0,65,53,118,442
2020,92072,SEVRES,200054781,METROPOLE DU GRAND PARIS,92,HAUTS DE SEINE,309,20,329,0,196,64,260,589
2020,92075,VANVES,200054781,METROPOLE DU GRAND PARIS,92,HAUTS DE SEINE,353,7,360,7,151,88,239,606
2020,92078,VILLENEUVE LA GARENNE,200054781,METROPOLE DU GRAND PARIS,92,HAUTS DE SEINE,354,0,354,31,83,15,98,483
2020,93006,BAGNOLET,200054781,METROPOLE DU GRAND PARIS,93,SEINE SAINT DENIS,346,20,366,35,175,42,217,618
2020,93008,BOBIGNY,200054781,METROPOLE DU GRAND PARIS,93,SEINE SAINT DENIS,619,2,621,69,130,17,147,836
2020,93010,BONDY,200054781,METROPOLE DU GRAND PARIS,93,SEINE SAINT DENIS,611,15,626,71,286,22,308,1006
2020,93013,LE BOURGET,200054781,METROPOLE DU GRAND PARIS,93,SEINE SAINT DENIS,141,1,142,0,64,2,66,208
2020,93027,LA COURNEUVE,200054781,METROPOLE DU GRAND PARIS,93,SEINE SAINT DENIS,336,1,337,48,119,11,130,515
2020,93030,DUGNY,200054781,METROPOLE DU GRAND PARIS,93,SEINE SAINT DENIS,120,2,122,0,57,2,59,181
2020,93045,LES LILAS,200054781,METROPOLE DU GRAND PARIS,93,SEINE SAINT DENIS,232,2,234,6,210,61,271,510
2020,93046,LIVRY GARGAN,200054781,METROPOLE DU GRAND PARIS,93,SEINE SAINT DENIS,355,37,392,0,291,21,312,703
2020,93047,MONTFERMEIL,200054781,METROPOLE DU GRAND PARIS,93,SEINE SAINT DENIS,227,7,234,20,135,6,141,395
2020,93061,LE PRE SAINT GERVAIS,200054781,METROPOLE DU GRAND PARIS,93,SEINE SAINT DENIS,194,4,198,7,133,25,158,363
2020,93062,LE RAINCY,200054781,METROPOLE DU GRAND PARIS,93,SEINE SAINT DENIS,179,16,195,0,142,20,162,357
2020,93064,ROSNY SOUS BOIS,200054781,METROPOLE DU GRAND PARIS,93,SEINE SAINT DENIS,525,18,543,5,344,38,382,929
2020,93073,TREMBLAY EN FRANCE,200054781,METROPOLE DU GRAND PARIS,93,SEINE SAINT DENIS,335,3,338,51,281,15,296,685
2020,93078,VILLEPINTE,200054781,METROPOLE DU GRAND PARIS,93,SEINE SAINT DENIS,270,2,272,0,188,7,195,467
2020,93079,VILLETANEUSE,200054781,METROPOLE DU GRAND PARIS,93,SEINE SAINT DENIS,65,2,67,55,41,5,46,168
2020,94002,ALFORTVILLE,200054781,METROPOLE DU GRAND PARIS,94,VAL DE MARNE,397,75,472,41,389,68,457,970
2020,94016,CACHAN,200054781,METROPOLE DU GRAND PARIS,94,VAL DE MARNE,319,12,331,16,249,52,301,648
2020,94018,CHARENTON LE PONT,200054781,METROPOLE DU GRAND PARIS,94,VAL DE MARNE,557,34,591,0,170,136,306,897
2020,94019,CHENNEVIERES SUR MARNE,200054781,METROPOLE DU GRAND PARIS,94,VAL DE MARNE,200,7,207,0,107,17,124,331
2020,94022,CHOISY LE ROI,200054781,METROPOLE DU GRAND PARIS,94,VAL DE MARNE,502,40,542,48,407,18,425,1014
2020,94034,FRESNES,200054781,METROPOLE DU GRAND PARIS,94,VAL DE MARNE,280,34,314,0,229,13,242,556
2020,94038,L'HAY LES ROSES,200054781,METROPOLE DU GRAND PARIS,94,VAL DE MARNE,292,52,344,16,234,23,257,617
2020,94042,JOINVILLE LE PONT,200054781,METROPOLE DU GRAND PARIS,94,VAL DE MARNE,289,22,311,0,141,36,177,488
2020,94044,LIMEIL BREVANNES,200054781,METROPOLE DU GRAND PARIS,94,VAL DE MARNE,287,5,292,18,256,15,271,582
2020,94058,LE PERREUX SUR MARNE,200054781,METROPOLE DU GRAND PARIS,94,VAL DE MARNE,409,47,456,7,252,75,327,790
2020,94059,LE PLESSIS TREVISE,200054781,METROPOLE DU GRAND PARIS,94,VAL DE MARNE,195,10,205,0,177,8,185,390
2020,94068,SAINT MAUR DES FOSSES,200054781,METROPOLE DU GRAND PARIS,94,VAL DE MARNE,737,114,851,47,470,144,614,1512
2020,94073,THIAIS,200054781,METROPOLE DU GRAND PARIS,94,VAL DE MARNE,355,40,395,14,196,14,210,619
2020,94074,VALENTON,200054781,METROPOLE DU GRAND PARIS,94,VAL DE MARNE,122,4,126,46,58,11,69,241
2020,94075,VILLECRESNES,200054781,METROPOLE DU GRAND PARIS,94,VAL DE MARNE,36,23,59,1,124,7,131,191
2020,94077,VILLENEUVE LE ROI,200054781,METROPOLE DU GRAND PARIS,94,VAL DE MARNE,229,3,232,0,115,10,125,357
2020,94080,VINCENNES,200054781,METROPOLE DU GRAND PARIS,94,VAL DE MARNE,960,71,1031,8,206,383,589,1628
2020,95019,ARNOUVILLE,200055655,CA ROISSY PAYS DE FRANCE,95,VAL D OISE,110,1,111,1,77,3,80,192
2020,95252,FRANCONVILLE,200058485,CA VAL PARISIS,95,VAL D OISE,310,18,328,0,460,19,479,807
2020,95268,GARGES LES GONESSE,200055655,CA ROISSY PAYS DE FRANCE,95,VAL D OISE,273,3,276,145,158,4,162,583
2020,95277,GONESSE,200055655,CA ROISSY PAYS DE FRANCE,95,VAL D OISE,274,0,274,26,134,7,141,441
2020,95280,GOUSSAINVILLE,200055655,CA ROISSY PAYS DE FRANCE,95,VAL D OISE,121,4,125,18,169,6,175,317
2020,95351,LOUVRES,200055655,CA ROISSY PAYS DE FRANCE,95,VAL D OISE,128,0,128,1,95,3,98,227
2020,95424,MONTIGNY LES CORMEILLES,200058485,CA VAL PARISIS,95,VAL D OISE,171,5,176,35,242,11,253,464
2020,95500,PONTOISE,249500109,CA DE CERGY-PONTOISE,95,VAL D OISE,335,27,362,17,269,11,280,659
2020,95572,SAINT OUEN L AUMONE,249500109,CA DE CERGY-PONTOISE,95,VAL D OISE,236,36,272,22,257,8,265,559
2020,95598,SOISY SOUS MONTMORENCY,200056380,CA PLAINE VALLEE,95,VAL D OISE,92,17,109,5,209,19,228,342
2020,95607,TAVERNY,200058485,CA VAL PARISIS,95,VAL D OISE,177,9,186,1,353,6,359,546
2020,97101,LES ABYMES,200018653,CA CAP EXCELLENCE,971,GUADELOUPE,443,30,473,157,276,13,289,919
2020,97107,CAPESTERRE BELLE EAU,249710070,CA GRAND SUD CARAIBE,971,GUADELOUPE,25,5,30,70,41,2,43,143
2020,97117,LE MOULE,200044691,CA DU NORD GRANDE TERRE,971,GUADELOUPE,0,72,72,44,86,9,95,211
2020,97129,SAINTE ROSE,249710062,CA DU NORD BASSE-TERRE,971,GUADELOUPE,168,13,181,37,68,6,74,291
2020,97209,FORT DE FRANCE,249720061,CA DU CENTRE DE LA MARTINIQUE,972,MARTINIQUE,829,37,866,280,207,24,231,1378
2020,97220,RIVIERE PILOTE,249720053,CA DE L'ESPACE SUD DE LA MARTINIQUE,972,MARTINIQUE,35,11,46,34,26,5,31,111
2020,97229,SCHOELCHER,249720061,CA DU CENTRE DE LA MARTINIQUE,972,MARTINIQUE,172,10,182,44,70,16,86,312
2020,97309,REMIRE MONTJOLY,249730045,CA DU CENTRE LITTORAL,973,GUYANE,287,10,297,3,99,21,120,420
2020,97404,L'ETANG SALE,249740077,CA CIVIS (COMMUNAUTE INTERCOMMUNALE DES VILLES SOLIDAIRES),974,LA REUNION,60,60,120,0,128,26,154,275
2020,97409,SAINT ANDRE,249740093,CA INTERCOMMUNALE DE LA REUNION EST (CIREST),974,LA REUNION,478,143,621,89,147,27,174,884
2020,97411,SAINT DENIS,249740119,CA INTERCOMMUNALE DU NORD DE LA REUNION (CINOR),974,LA REUNION,1434,599,2033,332,324,78,402,2767
2020,97415,SAINT PAUL,249740101,CA TERRITOIRE DE LA COTE OUEST (TCO),974,LA REUNION,450,524,974,200,412,84,496,1670
2020,97416,SAINT PIERRE,249740077,CA CIVIS (COMMUNAUTE INTERCOMMUNALE DES VILLES SOLIDAIRES),974,LA REUNION,553,415,968,114,386,62,448,1530
2020,97420,SAINTE SUZANNE,249740119,CA INTERCOMMUNALE DU NORD DE LA REUNION (CINOR),974,LA REUNION,221,97,318,13,101,19,120,451
2020,97701,SAINT-BARTHELEMY,XX,XX,977,COLLECTIVITE D'OUTRE MER SAINT BARTHELEMY,0,0,0,23,103,12,115,138
2021,01173,GEX,240100750,CA DU PAYS DE GEX,01,AIN,119,7,126,0,185,7,192,319
2021,01053,BOURG EN BRESSE,200071751,CA DU BASSIN DE BOURG-EN-BRESSE,01,AIN,375,21,396,69,324,8,332,797
2021,01283,OYONNAX,200042935,CA HAUT - BUGEY AGGLOMERATION,01,AIN,54,13,67,85,154,2,156,308
2021,01160,FERNEY VOLTAIRE,240100750,CA DU PAYS DE GEX,01,AIN,50,5,55,4,116,3,119,178
2021,01004,AMBERIEU EN BUGEY,240100883,CC DE LA PLAINE DE L'AIN,01,AIN,98,3,101,0,280,8,288,390
2021,02168,CHATEAU THIERRY,200072031,CA DE LA REGION DE CHATEAU-THIERRY,02,AISNE,102,8,110,43,149,6,155,308
2021,02173,CHAUNY,200071785,CA CHAUNY TERGNIER LA FERE,02,AISNE,60,11,71,18,133,1,134,223
2021,02738,TERGNIER,200071785,CA CHAUNY TERGNIER LA FERE,02,AISNE,30,11,41,38,136,3,139,218
2021,03190,MOULINS,200071140,CA MOULINS COMMUNAUTE,03,ALLIER,120,0,120,41,152,13,165,326
2021,05061,GAP,200067825,CA GAP-TALLARD-DURANCE,05,HAUTES ALPES,332,4,336,26,273,13,286,647
2021,06083,MENTON,240600551,CA DE LA RIVIERA FRANCAISE,06,ALPES MARITIMES,197,6,203,2,209,7,216,420
2021,06123,SAINT LAURENT DU VAR,200030195,METROPOLE NICE COTE D'AZUR,06,ALPES MARITIMES,249,52,301,0,320,10,330,632
2021,06149,LA TRINITE,200030195,METROPOLE NICE COTE D'AZUR,06,ALPES MARITIMES,83,1,84,7,59,0,59,150
2021,06029,CANNES,200039915,CA CANNES PAYS DE LERINS,06,ALPES MARITIMES,722,41,763,18,224,26,250,1031
2021,06155,VALLAURIS,240600585,CA DE SOPHIA ANTIPOLIS,06,ALPES MARITIMES,226,18,244,7,161,12,173,424
2021,06004,ANTIBES,240600585,CA DE SOPHIA ANTIPOLIS,06,ALPES MARITIMES,456,68,524,11,668,33,701,1236
2021,06161,VILLENEUVE LOUBET,240600585,CA DE SOPHIA ANTIPOLIS,06,ALPES MARITIMES,153,9,162,0,124,7,131,293
2021,07324,TOURNON SUR RHONE,200073096,CA ARCHE AGGLO,07,ARDECHE,50,1,51,35,102,3,105,191
2021,12202,RODEZ,241200187,CA RODEZ AGGLOMERATION,12,AVEYRON,198,22,220,38,142,11,153,411
2021,13001,AIX EN PROVENCE,200054807,METROPOLE D'AIX-MARSEILLE-PROVENCE,13,BOUCHES DU RHONE,1441,283,1724,58,899,133,1032,2815
2021,13002,ALLAUCH,200054807,METROPOLE D'AIX-MARSEILLE-PROVENCE,13,BOUCHES DU RHONE,181,28,209,0,162,14,176,385
2021,13005,AUBAGNE,200054807,METROPOLE D'AIX-MARSEILLE-PROVENCE,13,BOUCHES DU RHONE,322,43,365,44,385,13,398,808
2021,13027,CHATEAURENARD,200035087,CA TERRE DE PROVENCE,13,BOUCHES DU RHONE,68,17,85,0,156,5,161,246
2021,13028,LA CIOTAT,200054807,METROPOLE D'AIX-MARSEILLE-PROVENCE,13,BOUCHES DU RHONE,267,13,280,21,302,15,317,617
2021,13054,MARIGNANE,200054807,METROPOLE D'AIX-MARSEILLE-PROVENCE,13,BOUCHES DU RHONE,256,33,289,0,277,10,287,576
2021,13075,PLAN DE CUQUES,200054807,METROPOLE D'AIX-MARSEILLE-PROVENCE,13,BOUCHES DU RHONE,109,12,121,0,79,5,84,205
2021,13081,ROGNAC,200054807,METROPOLE D'AIX-MARSEILLE-PROVENCE,13,BOUCHES DU RHONE,81,20,101,0,172,2,174,275
2021,13106,SEPTEMES LES VALLONS,200054807,METROPOLE D'AIX-MARSEILLE-PROVENCE,13,BOUCHES DU RHONE,106,8,114,16,57,9,66,196
2021,13110,TRETS,200054807,METROPOLE D'AIX-MARSEILLE-PROVENCE,13,BOUCHES DU RHONE,98,17,115,0,87,1,88,203
2021,13203,MARSEILLE 3E ARRONDISSEMENT,200054807,METROPOLE D'AIX-MARSEILLE-PROVENCE,13,BOUCHES DU RHONE,401,29,430,107,108,10,118,654
2021,13204,MARSEILLE 4E ARRONDISSEMENT,200054807,METROPOLE D'AIX-MARSEILLE-PROVENCE,13,BOUCHES DU RHONE,409,95,504,20,308,36,344,868
2021,13207,MARSEILLE 7E ARRONDISSEMENT,200054807,METROPOLE D'AIX-MARSEILLE-PROVENCE,13,BOUCHES DU RHONE,372,91,463,21,245,65,310,794
2021,13208,MARSEILLE 8E ARRONDISSEMENT,200054807,METROPOLE D'AIX-MARSEILLE-PROVENCE,13,BOUCHES DU RHONE,776,196,972,4,593,225,818,1794
2021,13209,MARSEILLE 9E ARRONDISSEMENT,200054807,METROPOLE D'AIX-MARSEILLE-PROVENCE,13,BOUCHES DU RHONE,964,108,1072,36,453,68,521,1630
2021,13210,MARSEILLE 10E ARRONDISSEMENT,200054807,METROPOLE D'AIX-MARSEILLE-PROVENCE,13,BOUCHES DU RHONE,358,89,447,54,322,45,367,869
2021,13214,MARSEILLE 14E ARRONDISSEMENT,200054807,METROPOLE D'AIX-MARSEILLE-PROVENCE,13,BOUCHES DU RHONE,420,19,439,152,151,17,168,759
2021,13215,MARSEILLE 15E ARRONDISSEMENT,200054807,METROPOLE D'AIX-MARSEILLE-PROVENCE,13,BOUCHES DU RHONE,731,27,758,249,185,21,206,1213
2021,14118,CAEN,200065597,CU CAEN LA MER,14,CALVADOS,1091,74,1165,196,672,80,752,2113
2021,14341,IFS,200065597,CU CAEN LA MER,14,CALVADOS,58,6,64,0,203,2,205,270
2021,14366,LISIEUX,200069532,CA LISIEUX NORMANDIE,14,CALVADOS,92,0,92,51,308,5,313,456
2021,14762,VIRE NORMANDIE,200068799,CC INTERCOM DE LA VIRE AU NOIREAU,14,CALVADOS,45,0,45,22,258,4,262,329
2021,17415,SAINTES,200036473,CA DE SAINTES,17,CHARENTE MARITIME,161,0,161,22,264,11,275,458
2021,17299,ROCHEFORT,200041762,CA ROCHEFORT OCEAN,17,CHARENTE MARITIME,187,3,190,32,204,5,209,431
2021,17300,LA ROCHELLE,241700434,CA DE LA ROCHELLE,17,CHARENTE MARITIME,544,55,599,83,544,63,607,1289
2021,18033,BOURGES,241800507,CA BOURGES PLUS,18,CHER,271,12,283,100,687,15,702,1084
2021,21171,CHEVIGNY SAINT SAUVEUR,242100410,DIJON METROPOLE,21,COTE D OR,36,8,44,10,170,6,176,230
2021,21166,CHENOVE,242100410,DIJON METROPOLE,21,COTE D OR,96,6,102,56,117,5,122,280
2021,22113,LANNION,200065928,CA LANNION-TREGOR COMMUNAUTE,22,COTES D ARMOR,130,3,133,31,196,6,202,366
2021,22215,PLOUFRAGAN,200069409,CA SAINT-BRIEUC ARMOR AGGLOMERATION,22,COTES D ARMOR,70,1,71,20,164,4,168,258
2021,24053,BOULAZAC ISLE MANOIRE,200040392,CA LE GRAND PERIGUEUX,24,DORDOGNE,83,1,84,17,107,0,107,208
2021,24037,BERGERAC,200070647,CA BERGERACOISE,24,DORDOGNE,155,0,155,52,159,12,171,378
2021,25056,BESANCON,242500361,CU GRAND BESANCON METROPOLE,25,DOUBS,806,200,1006,186,932,43,975,2167
2021,25031,AUDINCOURT,200065647,CA PAYS DE MONTBELIARD AGGLOMERATION,25,DOUBS,74,1,75,29,106,1,107,211
2021,25388,MONTBELIARD,200065647,CA PAYS DE MONTBELIARD AGGLOMERATION,25,DOUBS,153,1,154,43,113,6,119,317
2021,26281,ROMANS SUR ISERE,200068781,CA VALENCE ROMANS AGGLO,26,DROME,198,11,209,62,320,5,325,596
2021,27701,VAL DE REUIL,200089456,CA SEINE-EURE,27,EURE,115,1,116,43,85,0,85,244
2021,27375,LOUVIERS,200089456,CA SEINE-EURE,27,EURE,218,1,219,27,183,0,183,429
2021,27284,GISORS,200071843,CC DU VEXIN NORMAND,27,EURE,109,8,117,0,135,5,140,257
2021,28088,CHATEAUDUN,200069961,CC DU GRAND CHATEAUDUN,28,EURE ET LOIR,63,8,71,34,108,3,111,215
2021,28229,MAINVILLIERS,200033181,CA CHARTRES METROPOLE,28,EURE ET LOIR,79,1,80,44,123,3,126,251
2021,28404,VERNOUILLET,200040277,CA AGGLO DU PAYS DE DREUX,28,EURE ET LOIR,98,12,110,5,135,7,142,257
2021,28218,LUCE,200033181,CA CHARTRES METROPOLE,28,EURE ET LOIR,100,7,107,0,180,3,183,290
2021,28085,CHARTRES,200033181,CA CHARTRES METROPOLE,28,EURE ET LOIR,365,28,393,12,321,22,343,748
2021,29232,QUIMPER,200068120,CA QUIMPER BRETAGNE OCCIDENTALE,29,FINISTERE,285,15,300,196,715,24,739,1235
2021,29235,LE RELECQ KERHUON,242900314,BREST METROPOLE,29,FINISTERE,42,3,45,30,173,9,182,257
2021,29233,QUIMPERLE,242900694,CA QUIMPERLE COMMUNAUTE,29,FINISTERE,43,8,51,31,186,2,188,270
2021,29046,DOUARNENEZ,242900645,CC DOUARNENEZ COMMUNAUTE,29,FINISTERE,48,0,48,35,113,0,113,196
2021,30341,VAUVERT,243000593,CC DE PETITE CAMARGUE,30,GARD,37,10,47,39,93,1,94,180
2021,31506,SAINT ORENS DE GAMEVILLE,243100518,TOULOUSE METROPOLE,31,HAUTE GARONNE,117,19,136,0,144,9,153,289
2021,31446,RAMONVILLE SAINT AGNE,243100633,CA DU SICOVAL,31,HAUTE GARONNE,192,8,200,0,113,2,115,314
2021,31557,TOURNEFEUILLE,243100518,TOULOUSE METROPOLE,31,HAUTE GARONNE,229,18,247,0,253,29,282,529
2021,31483,SAINT GAUDENS,200072643,CC COEUR ET COTEAUX DU COMMINGES,31,HAUTE GARONNE,106,0,106,21,70,1,71,198
2021,31488,SAINT JEAN,243100518,TOULOUSE METROPOLE,31,HAUTE GARONNE,79,9,88,0,161,3,164,252
2021,33284,MIOS,243301504,CA DU BASSIN D'ARCACHON NORD,33,GIRONDE,20,27,47,0,253,1,254,301
2021,33519,LE TAILLAN MEDOC,243300316,BORDEAUX METROPOLE,33,GIRONDE,41,32,73,2,179,2,181,256
2021,33200,LE HAILLAN,243300316,BORDEAUX METROPOLE,33,GIRONDE,140,13,153,0,143,6,149,302
2021,33003,AMBARES ET LAGRAVE,243300316,BORDEAUX METROPOLE,33,GIRONDE,102,26,128,4,280,2,282,414
2021,33119,CENON,243300316,BORDEAUX METROPOLE,33,GIRONDE,58,52,110,62,303,11,314,486
2021,33051,BIGANOS,243301504,CA DU BASSIN D'ARCACHON NORD,33,GIRONDE,50,23,73,0,164,2,166,239
2021,33122,CESTAS,243301165,CC JALLE-EAU-BOURDE,33,GIRONDE,116,10,126,0,201,8,209,336
2021,34032,BEZIERS,243400769,CA DE BEZIERS-MEDITERRANEE,34,HERAULT,337,32,369,86,387,22,409,863
2021,34154,MAUGUIO,243400470,CA DU PAYS DE L'OR,34,HERAULT,150,6,156,6,185,7,192,355
2021,34145,LUNEL,243400520,CC DU PAYS DE LUNEL,34,HERAULT,77,11,88,18,250,4,254,360
2021,34270,SAINT JEAN DE VEDAS,243400017,MONTPELLIER MEDITERRANEE METROPOLE,34,HERAULT,54,46,100,0,175,11,186,286
2021,34123,JUVIGNAC,243400017,MONTPELLIER MEDITERRANEE METROPOLE,34,HERAULT,100,14,114,0,140,9,149,263
2021,34003,AGDE,243400819,CA HERAULT-MEDITERRANEE,34,HERAULT,179,16,195,41,86,11,97,332
2021,35238,RENNES,243500139,RENNES METROPOLE,35,ILLE ET VILAINE,1725,292,2017,652,1819,249,2068,4737
2021,36088,ISSOUDUN,243600236,CC DU PAYS D'ISSOUDUN,36,INDRE,36,0,36,25,146,1,147,208
2021,37156,MONTLOUIS SUR LOIRE,200073161,CC TOURAINE-EST VALLEES,37,INDRE ET LOIRE,40,2,42,0,213,0,213,255
2021,37261,TOURS,243700754,TOURS METROPOLE VAL DE LOIRE,37,INDRE ET LOIRE,1201,253,1454,121,1113,81,1194,2768
2021,37109,FONDETTES,243700754,TOURS METROPOLE VAL DE LOIRE,37,INDRE ET LOIRE,70,5,75,0,160,7,167,242
2021,38544,VIENNE,200077014,CA VIENNE CONDRIEU,38,ISERE,168,26,194,12,395,12,407,613
2021,38229,MEYLAN,200040715,GRENOBLE-ALPES-METROPOLE,38,ISERE,184,37,221,0,166,7,173,394
2021,38151,ECHIROLLES,200040715,GRENOBLE-ALPES-METROPOLE,38,ISERE,315,23,338,82,330,10,340,760
2021,38474,SASSENAGE,200040715,GRENOBLE-ALPES-METROPOLE,38,ISERE,88,9,97,0,182,2,184,281
2021,38085,CHARVIEU CHAVAGNEUX,243800935,CC LYON-SAINT-EXUPERY EN DAUPHINE,38,ISERE,20,45,65,0,217,2,219,284
2021,38193,L'ISLE D ABEAU,243800604,CA PORTE DE L'ISERE (CAPI),38,ISERE,123,50,173,5,245,3,248,426
2021,38053,BOURGOIN JALLIEU,243800604,CA PORTE DE L'ISERE (CAPI),38,ISERE,132,63,195,24,331,5,336,556
2021,38485,SEYSSINET PARISET,200040715,GRENOBLE-ALPES-METROPOLE,38,ISERE,91,16,107,0,137,2,139,246
2021,39198,DOLE,200010650,CA DU GRAND DOLE,39,JURA,176,0,176,30,182,5,187,393
2021,40312,TARNOS,244000659,CC DU SEIGNANX,40,LANDES,60,38,98,4,132,3,135,237
2021,40279,SAINT PAUL LES DAX,244000675,CA DU GRAND DAX,40,LANDES,60,8,68,0,155,1,156,223
2021,40088,DAX,244000675,CA DU GRAND DAX,40,LANDES,202,3,205,33,109,12,121,359
2021,42218,SAINT ETIENNE,244200770,SAINT-ETIENNE METROPOLE,42,LOIRE,1031,111,1142,136,1054,74,1128,2405
2021,42184,RIORGES,200035731,CA ROANNAIS AGGLOMERATION,42,LOIRE,42,5,47,0,139,3,142,188
2021,42147,MONTBRISON,200065886,CA LOIRE FOREZ AGGLOMERATION (LFA),42,LOIRE,111,4,115,26,195,5,200,341
2021,42279,SAINT JUST SAINT RAMBERT,200065886,CA LOIRE FOREZ AGGLOMERATION (LFA),42,LOIRE,111,6,117,4,179,13,192,312
2021,43157,LE PUY EN VELAY,200073419,CA DU PUY-EN-VELAY,43,HAUTE LOIRE,100,2,102,72,120,2,122,296
2021,44109,NANTES,244400404,NANTES METROPOLE,44,LOIRE ATLANTIQUE,3543,374,3917,414,3018,835,3853,8184
2021,44003,ANCENIS SAINT GEREON,244400552,CC DU PAYS D'ANCENIS,44,LOIRE ATLANTIQUE,40,7,47,10,213,4,217,275
2021,44154,SAINT BREVIN LES PINS,244400586,CC DU SUD ESTUAIRE,44,LOIRE ATLANTIQUE,42,17,59,8,176,6,182,248
2021,44184,SAINT NAZAIRE,244400644,CA DE LA REGION NAZAIRIENNE ET DE L'ESTUAIRE (CARENE),44,LOIRE ATLANTIQUE,380,47,427,198,730,49,779,1404
2021,45208,MONTARGIS,244500203,CA MONTARGOISE ET RIVES DU LOING (AME),45,LOIRET,131,10,141,18,80,3,83,242
2021,45284,SAINT JEAN DE BRAYE,244500468,ORLEANS METROPOLE,45,LOIRET,168,29,197,0,256,7,263,461
2021,45068,CHALETTE SUR LOING,244500203,CA MONTARGOISE ET RIVES DU LOING (AME),45,LOIRET,100,6,106,57,78,1,79,241
2021,45147,FLEURY LES AUBRAIS,244500468,ORLEANS METROPOLE,45,LOIRET,132,30,162,0,265,9,274,436
2021,45285,SAINT JEAN DE LA RUELLE,244500468,ORLEANS METROPOLE,45,LOIRET,120,15,135,39,210,4,214,388
2021,49328,SAUMUR,200071876,CA SAUMUR VAL DE LOIRE,49,MAINE ET LOIRE,160,25,185,66,213,24,237,487
2021,49099,CHOLET,200071678,CA AGGLOMERATION DU CHOLETAIS,49,MAINE ET LOIRE,292,34,326,141,591,21,612,1079
2021,50099,CARENTAN LES MARAIS,200042729,CC DE LA BAIE DU COTENTIN,50,MANCHE,23,0,23,23,144,0,144,190
2021,51108,CHALONS EN CHAMPAGNE,200066876,CA DE CHALONS-EN-CHAMPAGNE,51,MARNE,491,26,517,55,271,18,289,861
2021,53130,LAVAL,200083392,CA LAVAL AGGLOMERATION,53,MAYENNE,345,44,389,95,504,29,533,1018
2021,54580,VILLERUPT,245701404,CC DU PAYS HAUT VAL D'ALZETTE,54,MEURTHE ET MOSELLE,30,1,31,0,13,0,13,44
2021,54431,PONT A MOUSSON,200041515,CC DU BASSIN DE PONT-A-MOUSSON,54,MEURTHE ET MOSELLE,50,1,51,17,126,1,127,194
2021,54578,VILLERS LES NANCY,245400676,METROPOLE DU GRAND NANCY,54,MEURTHE ET MOSELLE,45,10,55,13,134,9,143,211
2021,54323,LONGWY,245400262,CA GRAND LONGWY AGGLOMERATION,54,MEURTHE ET MOSELLE,85,0,85,18,57,0,57,160
2021,56007,AURAY,200043123,CC AURAY QUIBERON TERRE ATLANTIQUE,56,MORBIHAN,45,1,46,73,149,6,155,274
2021,56260,VANNES,200067932,CA GOLFE DU MORBIHAN - VANNES AGGLOMERATION,56,MORBIHAN,414,34,448,218,266,55,321,987
2021,56206,SAINT AVE,200067932,CA GOLFE DU MORBIHAN - VANNES AGGLOMERATION,56,MORBIHAN,45,5,50,39,196,6,202,291
2021,57480,MONTIGNY LES METZ,200039865,METZ METROPOLE,57,MOSELLE,90,21,111,0,214,5,219,330
2021,57227,FORBACH,245700372,CA DE FORBACH PORTE DE FRANCE,57,MOSELLE,47,0,47,39,90,2,92,178
2021,57463,METZ,200039865,METZ METROPOLE,57,MOSELLE,1153,90,1243,53,769,44,813,2109
2021,57606,SAINT AVOLD,200067502,CA SAINT-AVOLD SYNERGIE,57,MOSELLE,44,3,47,8,125,1,126,181
2021,57447,MARLY,200039865,METZ METROPOLE,57,MOSELLE,25,18,43,0,107,2,109,152
2021,57240,FREYMING MERLEBACH,245700398,CC DE FREYMING-MERLEBACH,57,MOSELLE,0,0,0,13,81,1,82,96
2021,57751,WOIPPY,200039865,METZ METROPOLE,57,MOSELLE,30,3,33,40,149,2,151,225
2021,59569,SIN LE NOBLE,200044618,CA DOUAISIS AGGLO,59,NORD,60,12,72,74,150,2,152,297
2021,59017,ARMENTIERES,200093201,METROPOLE EUROPEENNE DE LILLE,59,NORD,101,43,144,92,242,7,249,485
2021,59507,RONCHIN,200093201,METROPOLE EUROPEENNE DE LILLE,59,NORD,102,62,164,41,235,8,243,448
2021,59527,SAINT ANDRE LEZ LILLE,200093201,METROPOLE EUROPEENNE DE LILLE,59,NORD,103,46,149,23,170,12,182,354
2021,59295,HAZEBROUCK,200040947,CC DE FLANDRE INTERIEURE,59,NORD,87,5,92,69,272,6,278,438
2021,59368,LA MADELEINE,200093201,METROPOLE EUROPEENNE DE LILLE,59,NORD,191,97,288,42,194,65,259,589
2021,59014,ANZIN,245901160,CA VALENCIENNES METROPOLE,59,NORD,37,3,40,73,89,2,91,204
2021,59544,SAINT SAULVE,245901160,CA VALENCIENNES METROPOLE,59,NORD,150,4,154,29,105,1,106,290
2021,59220,FACHES THUMESNIL,200093201,METROPOLE EUROPEENNE DE LILLE,59,NORD,130,37,167,6,270,6,276,450
2021,59392,MAUBEUGE,200043396,CA MAUBEUGE VAL DE SAMBRE,59,NORD,94,3,97,128,116,2,118,344
2021,59491,RAISMES,200042190,CA DE LA PORTE DU HAINAUT,59,NORD,53,2,55,51,93,2,95,200
2021,59286,HAUBOURDIN,200093201,METROPOLE EUROPEENNE DE LILLE,59,NORD,61,33,94,42,211,4,215,350
2021,59172,DENAIN,200042190,CA DE LA PORTE DU HAINAUT,59,NORD,55,0,55,90,95,6,101,246
2021,59421,MOUVAUX,200093201,METROPOLE EUROPEENNE DE LILLE,59,NORD,85,56,141,29,165,28,193,363
2021,59328,LAMBERSART,200093201,METROPOLE EUROPEENNE DE LILLE,59,NORD,210,115,325,47,282,45,327,699
2021,60139,CHAMBLY,200067973,CC THELLOISE,60,OISE,40,3,43,0,163,3,166,208
2021,60463,NOGENT SUR OISE,200068047,CA CREIL SUD OISE,60,OISE,110,4,114,45,171,0,171,330
2021,60395,MERU,246000582,CC DES SABLONS,60,OISE,80,3,83,30,153,3,156,269
2021,61001,ALENCON,246100663,CU D'ALENCON,61,ORNE,162,3,165,82,224,4,228,476
2021,62587,MONTIGNY EN GOHELLE,246200299,CA D'HENIN-CARVIN,62,PAS DE CALAIS,30,13,43,41,88,0,88,172
2021,62510,LIEVIN,246200364,CA DE LENS - LIEVIN,62,PAS DE CALAIS,155,48,203,55,185,1,186,444
2021,62186,BULLY LES MINES,246200364,CA DE LENS - LIEVIN,62,PAS DE CALAIS,30,15,45,37,97,0,97,179
2021,62413,HARNES,246200364,CA DE LENS - LIEVIN,62,PAS DE CALAIS,0,23,23,39,120,2,122,184
2021,62193,CALAIS,200090751,CA GRAND CALAIS TERRES ET MERS,62,PAS DE CALAIS,378,15,393,250,357,10,367,1010
2021,62427,HENIN BEAUMONT,246200299,CA D'HENIN-CARVIN,62,PAS DE CALAIS,110,73,183,48,210,6,216,447
2021,63032,BEAUMONT,246300701,CLERMONT AUVERGNE METROPOLE,63,PUY DE DOME,46,18,64,0,122,6,128,192
2021,63300,RIOM,200070753,CA RIOM LIMAGNE ET VOLCANS,63,PUY DE DOME,83,13,96,21,196,7,203,320
2021,63430,THIERS,200070712,CC THIERS DORE ET MONTAGNE,63,PUY DE DOME,15,3,18,24,106,6,112,154
2021,63284,PONT DU CHATEAU,246300701,CLERMONT AUVERGNE METROPOLE,63,PUY DE DOME,30,21,51,0,234,2,236,287
2021,64129,BILLERE,200067254,CA PAU BEARN PYRENEES,64,PYRENEES ATLANTIQUES,94,7,101,6,132,8,140,247
2021,64545,URRUGNE,200067106,CA DU PAYS BASQUE,64,PYRENEES ATLANTIQUES,81,20,101,9,54,1,55,166
2021,67462,SELESTAT,246700967,CC DE SELESTAT,67,BAS RHIN,137,49,186,0,140,5,145,331
2021,67437,SAVERNE,200068112,CC DU PAYS DE SAVERNE,67,BAS RHIN,111,12,123,12,68,3,71,206
2021,67267,LINGOLSHEIM,246700488,EUROMETROPOLE DE STRASBOURG,67,BAS RHIN,169,62,231,0,170,3,173,403
2021,67482,STRASBOURG,246700488,EUROMETROPOLE DE STRASBOURG,67,BAS RHIN,3520,807,4327,396,1300,189,1489,6212
2021,67204,HOENHEIM,246700488,EUROMETROPOLE DE STRASBOURG,67,BAS RHIN,120,26,146,0,91,5,96,242
2021,68376,WITTENHEIM,200066009,CA MULHOUSE ALSACE AGGLOMERATION,68,HAUT RHIN,85,12,97,0,116,5,121,218
2021,68066,COLMAR,246800726,CA COLMAR AGGLOMERATION,68,HAUT RHIN,705,42,747,32,323,15,338,1118
2021,68112,GUEBWILLER,246800569,CC DE LA REGION DE GUEBWILLER,68,HAUT RHIN,70,13,83,0,46,2,48,131
2021,68166,KINGERSHEIM,200066009,CA MULHOUSE ALSACE AGGLOMERATION,68,HAUT RHIN,75,6,81,0,120,4,124,205
2021,68375,WITTELSHEIM,200066009,CA MULHOUSE ALSACE AGGLOMERATION,68,HAUT RHIN,40,10,50,0,131,0,131,181
2021,69019,BELLEVILLE EN BEAUJOLAIS,200067817,CC SAONE-BEAUJOLAIS,69,RHONE,40,21,61,35,174,3,177,273
2021,69027,BRIGNAIS,246900757,CC DE LA VALLEE DU GARON (CCVG),69,RHONE,88,26,114,13,152,5,157,285
2021,69029,BRON,200046977,METROPOLE DE LYON,69,RHONE,370,62,432,66,273,27,300,798
2021,69081,ECULLY,200046977,METROPOLE DE LYON,69,RHONE,180,19,199,12,193,12,205,416
2021,69089,FRANCHEVILLE,200046977,METROPOLE DE LYON,69,RHONE,105,63,168,1,151,7,158,327
2021,69091,GIVORS,200046977,METROPOLE DE LYON,69,RHONE,132,12,144,89,168,6,174,407
2021,69152,PIERRE BENITE,200046977,METROPOLE DE LYON,69,RHONE,186,5,191,38,119,5,124,353
2021,69202,SAINTE FOY LES LYON,200046977,METROPOLE DE LYON,69,RHONE,174,54,228,0,217,22,239,467
2021,69204,SAINT GENIS LAVAL,200046977,METROPOLE DE LYON,69,RHONE,190,28,218,14,190,25,215,447
2021,69259,VENISSIEUX,200046977,METROPOLE DE LYON,69,RHONE,482,38,520,539,428,23,451,1510
2021,69275,DECINES CHARPIEU,200046977,METROPOLE DE LYON,69,RHONE,179,59,238,29,326,16,342,610
2021,69277,GENAS,246900575,CC DE L'EST LYONNAIS (CCEL),69,RHONE,96,28,124,1,147,11,158,284
2021,69384,LYON 4E ARRONDISSEMENT,200046977,METROPOLE DE LYON,69,RHONE,408,131,539,11,390,76,466,1017
2021,69388,LYON 8E ARRONDISSEMENT,200046977,METROPOLE DE LYON,69,RHONE,965,96,1061,177,648,72,720,1958
2021,71014,AUTUN,200070530,CC DU GRAND AUTUNOIS MORVAN,71,SAONE ET LOIRE,91,0,91,30,93,2,95,216
2021,71270,MACON,200070308,CA MACONNAIS BEAUJOLAIS AGGLOMERATION,71,SAONE ET LOIRE,286,11,297,45,258,9,267,609
2021,71076,CHALON SUR SAONE,247100589,CA LE GRAND CHALON,71,SAONE ET LOIRE,308,70,378,94,280,26,306,778
2021,72154,LA FLECHE,247200348,CC DU PAYS FLECHOIS,72,SARTHE,80,0,80,23,189,1,190,293
2021,72003,ALLONNES,247200132,CU LE MANS METROPOLE,72,SARTHE,18,0,18,41,158,1,159,218
2021,73179,LA MOTTE SERVOLEX,200069110,CA DU GRAND CHAMBERY,73,SAVOIE,50,17,67,3,197,5,202,273
2021,74012,ANNEMASSE,200011773,CA ANNEMASSE-LES VOIRONS-AGGLOMERATION,74,HAUTE SAVOIE,205,7,212,42,359,8,367,621
2021,74081,CLUSES,200033116,CC CLUSES-ARVE ET MONTAGNES,74,HAUTE SAVOIE,68,5,73,47,115,4,119,240
2021,74243,SAINT JULIEN EN GENEVOIS,247400690,CC DU GENEVOIS,74,HAUTE SAVOIE,101,16,117,0,144,4,148,266
2021,75105,PARIS 5E ARRONDISSEMENT,200054781,METROPOLE DU GRAND PARIS,75,PARIS,868,16,884,29,17,164,181,1094
2021,75107,PARIS 7E ARRONDISSEMENT,200054781,METROPOLE DU GRAND PARIS,75,PARIS,639,40,679,54,10,263,273,1006
2021,75108,PARIS 8E ARRONDISSEMENT,200054781,METROPOLE DU GRAND PARIS,75,PARIS,686,46,732,79,35,300,335,1146
2021,75109,PARIS 9E ARRONDISSEMENT,200054781,METROPOLE DU GRAND PARIS,75,PARIS,1055,109,1164,13,70,512,582,1759
2021,75110,PARIS 10E ARRONDISSEMENT,200054781,METROPOLE DU GRAND PARIS,75,PARIS,1901,144,2045,20,191,555,746,2811
2021,75111,PARIS 11E ARRONDISSEMENT,200054781,METROPOLE DU GRAND PARIS,75,PARIS,2819,218,3037,35,171,637,808,3880
2021,75115,PARIS 15E ARRONDISSEMENT,200054781,METROPOLE DU GRAND PARIS,75,PARIS,3929,400,4329,92,376,1145,1521,5942
2021,75119,PARIS 19E ARRONDISSEMENT,200054781,METROPOLE DU GRAND PARIS,75,PARIS,4451,29,4480,147,288,659,947,5573
2021,75120,PARIS 20E ARRONDISSEMENT,200054781,METROPOLE DU GRAND PARIS,75,PARIS,3901,147,4048,82,450,417,867,4996
2021,76758,YVETOT,247600620,CC YVETOT NORMANDIE,76,SEINE MARITIME,62,8,70,5,207,6,213,288
2021,76540,ROUEN,200023414,METROPOLE ROUEN NORMANDIE,76,SEINE MARITIME,972,199,1171,19,862,83,945,2136
2021,76351,LE HAVRE,200084952,CU LE HAVRE SEINE METROPOLE,76,SEINE MARITIME,876,212,1088,175,1823,79,1902,3165
2021,76575,SAINT ETIENNE DU ROUVRAY,200023414,METROPOLE ROUEN NORMANDIE,76,SEINE MARITIME,123,13,136,69,357,5,362,567
2021,76157,CANTELEU,200023414,METROPOLE ROUEN NORMANDIE,76,SEINE MARITIME,157,6,163,15,130,3,133,311
2021,76057,BARENTIN,247600646,CC CAUX - AUSTREBERTHE,76,SEINE MARITIME,72,2,74,1,232,1,233,308
2021,76447,MONTIVILLIERS,200084952,CU LE HAVRE SEINE METROPOLE,76,SEINE MARITIME,40,26,66,3,238,8,246,314
2021,76216,DEVILLE LES ROUEN,200023414,METROPOLE ROUEN NORMANDIE,76,SEINE MARITIME,40,6,46,11,185,4,189,247
2021,77294,MITRY MORY,200055655,CA ROISSY PAYS DE FRANCE,77,SEINE ET MARNE,87,4,91,0,285,3,288,378
2021,77468,TORCY,200057958,CA PARIS - VALLEE DE LA MARNE,77,SEINE ET MARNE,294,27,321,14,206,6,212,548
2021,77316,MORET LOING ET ORVANNE,247700032,CC MORET SEINE ET LOING,77,SEINE ET MARNE,152,9,161,3,131,2,133,296
2021,77487,VAUX LE PENIL,247700057,CA MELUN VAL DE SEINE,77,SEINE ET MARNE,137,1,138,0,140,2,142,280
2021,77296,MOISSY CRAMAYEL,200059228,CA GRAND PARIS SUD SEINE ESSONNE SENART,77,SEINE ET MARNE,143,11,154,19,255,7,262,435
2021,77333,NEMOURS,200023240,CC PAYS DE NEMOURS,77,SEINE ET MARNE,0,15,15,8,153,4,157,180
2021,77464,THORIGNY SUR MARNE,247700594,CA MARNE ET GONDOIRE,77,SEINE ET MARNE,70,5,75,0,110,3,113,188
2021,77284,MEAUX,200072130,CA DU PAYS DE MEAUX,77,SEINE ET MARNE,538,24,562,20,494,20,514,1096
2021,77379,PROVINS,200037133,CC DU PROVINOIS,77,SEINE ET MARNE,100,10,110,42,62,4,66,218
2021,77350,OZOIR LA FERRIERE,200023125,CC LES PORTES BRIARDES ENTRE VILLES ET FORETS,77,SEINE ET MARNE,200,12,212,9,232,3,235,455
2021,77118,CLAYE SOUILLY,200055655,CA ROISSY PAYS DE FRANCE,77,SEINE ET MARNE,30,6,36,15,162,6,168,219
2021,77445,SAVIGNY LE TEMPLE,200059228,CA GRAND PARIS SUD SEINE ESSONNE SENART,77,SEINE ET MARNE,230,5,235,41,325,8,333,609
2021,77373,PONTAULT COMBAULT,200057958,CA PARIS - VALLEE DE LA MARNE,77,SEINE ET MARNE,195,13,208,17,560,10,570,795
2021,77307,MONTEVRAIN,247700594,CA MARNE ET GONDOIRE,77,SEINE ET MARNE,156,22,178,0,193,8,201,379
2021,78642,VERNEUIL SUR SEINE,200059889,CU GRAND PARIS SEINE ET OISE,78,YVELINES,76,25,101,0,185,9,194,295
2021,78123,CARRIERES SOUS POISSY,200059889,CU GRAND PARIS SEINE ET OISE,78,YVELINES,161,79,240,18,199,17,216,475
2021,78005,ACHERES,200059889,CU GRAND PARIS SEINE ET OISE,78,YVELINES,222,45,267,19,245,14,259,546
2021,78517,RAMBOUILLET,200073344,CA RAMBOUILLET TERRITOIRES,78,YVELINES,282,15,297,0,272,24,296,593
2021,78015,ANDRESY,200059889,CU GRAND PARIS SEINE ET OISE,78,YVELINES,35,19,54,5,201,2,203,262
2021,78490,PLAISIR,200058782,CA DE SAINT QUENTIN EN YVELINES,78,YVELINES,225,107,332,30,330,9,339,701
2021,78586,SARTROUVILLE,200058519,CA SAINT GERMAIN BOUCLES DE SEINE,78,YVELINES,352,284,636,57,557,60,617,1310
2021,78440,LES MUREAUX,200059889,CU GRAND PARIS SEINE ET OISE,78,YVELINES,258,44,302,79,169,9,178,560
2021,78551,SAINT GERMAIN EN LAYE,200058519,CA SAINT GERMAIN BOUCLES DE SEINE,78,YVELINES,634,127,761,3,211,97,308,1072
2021,78208,ELANCOURT,200058782,CA DE SAINT QUENTIN EN YVELINES,78,YVELINES,290,18,308,7,331,12,343,658
2021,79049,BRESSUIRE,200040244,CA DU BOCAGE BRESSUIRAIS,79,DEUX SEVRES,70,8,78,13,285,1,286,377
2021,79191,NIORT,200041317,CA DU NIORTAIS,79,DEUX SEVRES,418,1,419,77,574,36,610,1106
2021,79329,THOUARS,247900798,CC DU THOUARSAIS,79,DEUX SEVRES,91,0,91,16,137,2,139,246
2021,82112,MOISSAC,200066322,CC TERRES DES CONFLUENCES,82,TARN ET GARONNE,55,7,62,40,96,2,98,200
2021,83049,CUERS,200027100,CC MEDITERRANEE PORTE DES MAURES,83,VAR,50,18,68,0,168,5,173,242
2021,83112,SAINT CYR SUR MER,248300394,CA SUD SAINTE BAUME,83,VAR,60,2,62,0,118,7,125,187
2021,83090,OLLIOULES,248300543,METROPOLE TOULON-PROVENCE-MEDITERRANEE,83,VAR,94,28,122,0,118,3,121,243
2021,84080,MONTEUX,248400293,CA DES SORGUES DU COMTAT,84,VAUCLUSE,71,19,90,0,139,1,140,230
2021,84087,ORANGE,248400236,CC PAYS D'ORANGE EN PROVENCE,84,VAUCLUSE,172,6,178,3,271,5,276,458
2021,85194,LES SABLES D OLONNE,200071165,CA LES SABLES D'OLONNE AGGLOMERATION,85,VENDEE,106,38,144,87,355,26,381,612
2021,85047,CHALLANS,200071629,CC CHALLANS-GOIS COMMUNAUTE,85,VENDEE,62,22,84,37,351,3,354,475
2021,87154,SAINT JUNIEN,200059400,CC PORTE OCEANE DU LIMOUSIN,87,HAUTE VIENNE,40,1,41,0,126,2,128,169
2021,87085,LIMOGES,248719312,CU LIMOGES METROPOLE,87,HAUTE VIENNE,904,60,964,141,718,82,800,1904
2021,88413,SAINT DIE DES VOSGES,200071066,CA DE SAINT-DIE-DES-VOSGES,88,VOSGES,126,0,126,51,149,3,152,329
2021,89387,SENS,248900334,CA DU GRAND SENONAIS,89,YONNE,263,0,263,0,192,9,201,464
2021,91692,LES ULIS,200056232,CA COMMUNAUTE PARIS-SACLAY,91,ESSONNE,292,13,305,18,241,6,247,570
2021,91021,ARPAJON,200057859,CA COEUR D'ESSONNE AGGLOMERATION,91,ESSONNE,91,11,102,6,107,2,109,217
2021,91286,GRIGNY,200059228,CA GRAND PARIS SUD SEINE ESSONNE SENART,91,ESSONNE,192,3,195,195,120,3,123,513
2021,91161,CHILLY MAZARIN,200056232,CA COMMUNAUTE PARIS-SACLAY,91,ESSONNE,198,13,211,0,197,10,207,418
2021,91201,DRAVEIL,200058477,CA VAL D'YERRES VAL DE SEINE,91,ESSONNE,411,15,426,6,285,6,291,723
2021,91223,ETAMPES,200017846,CA ETAMPOIS SUD ESSONNE,91,ESSONNE,238,18,256,20,193,8,201,476
2021,91272,GIF SUR YVETTE,200056232,CA COMMUNAUTE PARIS-SACLAY,91,ESSONNE,250,4,254,7,195,14,209,470
2021,91345,LONGJUMEAU,200056232,CA COMMUNAUTE PARIS-SACLAY,91,ESSONNE,215,14,229,5,229,7,236,470
2021,91471,ORSAY,200056232,CA COMMUNAUTE PARIS-SACLAY,91,ESSONNE,202,14,216,9,97,10,107,332
2021,91114,BRUNOY,200058477,CA VAL D'YERRES VAL DE SEINE,91,ESSONNE,220,9,229,25,213,14,227,481
2021,91661,VILLEBON SUR YVETTE,200056232,CA COMMUNAUTE PARIS-SACLAY,91,ESSONNE,220,14,234,0,71,7,78,312
2021,92032,FONTENAY AUX ROSES,200054781,METROPOLE DU GRAND PARIS,92,HAUTS DE SEINE,278,25,303,0,144,20,164,467
2021,92071,SCEAUX,200054781,METROPOLE DU GRAND PARIS,92,HAUTS DE SEINE,322,0,322,0,60,42,102,425
2021,92014,BOURG LA REINE,200054781,METROPOLE DU GRAND PARIS,92,HAUTS DE SEINE,327,5,332,0,87,64,151,483
2021,92077,VILLE D AVRAY,200054781,METROPOLE DU GRAND PARIS,92,HAUTS DE SEINE,171,5,176,0,76,36,112,288
2021,92044,LEVALLOIS PERRET,200054781,METROPOLE DU GRAND PARIS,92,HAUTS DE SEINE,1342,180,1522,55,228,641,869,2447
2021,92064,SAINT CLOUD,200054781,METROPOLE DU GRAND PARIS,92,HAUTS DE SEINE,482,53,535,21,121,169,290,846
2021,92040,ISSY LES MOULINEAUX,200054781,METROPOLE DU GRAND PARIS,92,HAUTS DE SEINE,1405,60,1465,7,539,247,786,2257
2021,92049,MONTROUGE,200054781,METROPOLE DU GRAND PARIS,92,HAUTS DE SEINE,1109,76,1185,0,213,160,373,1558
2021,92046,MALAKOFF,200054781,METROPOLE DU GRAND PARIS,92,HAUTS DE SEINE,390,23,413,5,216,54,270,688
2021,92033,GARCHES,200054781,METROPOLE DU GRAND PARIS,92,HAUTS DE SEINE,379,22,401,0,68,74,142,543
2021,92062,PUTEAUX,200054781,METROPOLE DU GRAND PARIS,92,HAUTS DE SEINE,1049,97,1146,4,305,212,517,1667
2021,92026,COURBEVOIE,200054781,METROPOLE DU GRAND PARIS,92,HAUTS DE SEINE,1888,94,1982,19,584,284,868,2869
2021,92063,RUEIL MALMAISON,200054781,METROPOLE DU GRAND PARIS,92,HAUTS DE SEINE,1177,128,1305,39,307,271,578,1922
2021,92060,LE PLESSIS ROBINSON,200054781,METROPOLE DU GRAND PARIS,92,HAUTS DE SEINE,512,12,524,10,254,35,289,823
2021,93007,LE BLANC MESNIL,200054781,METROPOLE DU GRAND PARIS,93,SEINE SAINT DENIS,363,13,376,15,144,15,159,550
2021,93063,ROMAINVILLE,200054781,METROPOLE DU GRAND PARIS,93,SEINE SAINT DENIS,377,45,422,0,275,84,359,781
2021,93030,DUGNY,200054781,METROPOLE DU GRAND PARIS,93,SEINE SAINT DENIS,120,1,121,0,42,4,46,167
2021,93073,TREMBLAY EN FRANCE,200054781,METROPOLE DU GRAND PARIS,93,SEINE SAINT DENIS,335,3,338,43,278,11,289,670
2021,93010,BONDY,200054781,METROPOLE DU GRAND PARIS,93,SEINE SAINT DENIS,611,20,631,63,289,25,314,1008
2021,93061,LE PRE SAINT GERVAIS,200054781,METROPOLE DU GRAND PARIS,93,SEINE SAINT DENIS,194,7,201,6,127,23,150,357
2021,93066,SAINT DENIS,200054781,METROPOLE DU GRAND PARIS,93,SEINE SAINT DENIS,1060,48,1108,172,558,54,612,1893
2021,93071,SEVRAN,200054781,METROPOLE DU GRAND PARIS,93,SEINE SAINT DENIS,317,8,325,94,204,8,212,632
2021,93014,CLICHY SOUS BOIS,200054781,METROPOLE DU GRAND PARIS,93,SEINE SAINT DENIS,185,2,187,48,86,5,91,326
2021,93008,BOBIGNY,200054781,METROPOLE DU GRAND PARIS,93,SEINE SAINT DENIS,619,2,621,86,127,16,143,850
2021,93077,VILLEMOMBLE,200054781,METROPOLE DU GRAND PARIS,93,SEINE SAINT DENIS,246,29,275,0,198,37,235,510
2021,93006,BAGNOLET,200054781,METROPOLE DU GRAND PARIS,93,SEINE SAINT DENIS,381,23,404,36,189,45,234,674
2021,93051,NOISY LE GRAND,200054781,METROPOLE DU GRAND PARIS,93,SEINE SAINT DENIS,642,41,683,60,550,51,601,1344
2021,93079,VILLETANEUSE,200054781,METROPOLE DU GRAND PARIS,93,SEINE SAINT DENIS,65,2,67,56,32,4,36,159
2021,93047,MONTFERMEIL,200054781,METROPOLE DU GRAND PARIS,93,SEINE SAINT DENIS,227,10,237,20,136,5,141,398
2021,93045,LES LILAS,200054781,METROPOLE DU GRAND PARIS,93,SEINE SAINT DENIS,222,1,223,6,222,46,268,497
2021,94004,BOISSY SAINT LEGER,200054781,METROPOLE DU GRAND PARIS,94,VAL DE MARNE,170,19,189,0,141,3,144,333
2021,94079,VILLIERS SUR MARNE,200054781,METROPOLE DU GRAND PARIS,94,VAL DE MARNE,254,28,282,15,227,27,254,551
2021,94059,LE PLESSIS TREVISE,200054781,METROPOLE DU GRAND PARIS,94,VAL DE MARNE,205,6,211,0,173,5,178,389
2021,94011,BONNEUIL SUR MARNE,200054781,METROPOLE DU GRAND PARIS,94,VAL DE MARNE,190,3,193,81,96,12,108,383
2021,94002,ALFORTVILLE,200054781,METROPOLE DU GRAND PARIS,94,VAL DE MARNE,453,84,537,41,343,67,410,988
2021,94022,CHOISY LE ROI,200054781,METROPOLE DU GRAND PARIS,94,VAL DE MARNE,502,66,568,43,392,21,413,1024
2021,94043,LE KREMLIN BICETRE,200054781,METROPOLE DU GRAND PARIS,94,VAL DE MARNE,483,8,491,16,180,20,200,708
2021,94075,VILLECRESNES,200054781,METROPOLE DU GRAND PARIS,94,VAL DE MARNE,36,21,57,2,119,2,121,181
2021,94052,NOGENT SUR MARNE,200054781,METROPOLE DU GRAND PARIS,94,VAL DE MARNE,479,58,537,16,140,148,288,841
2021,94033,FONTENAY SOUS BOIS,200054781,METROPOLE DU GRAND PARIS,94,VAL DE MARNE,500,55,555,48,354,163,517,1121
2021,94003,ARCUEIL,200054781,METROPOLE DU GRAND PARIS,94,VAL DE MARNE,269,29,298,19,137,25,162,479
2021,94028,CRETEIL,200054781,METROPOLE DU GRAND PARIS,94,VAL DE MARNE,1483,31,1514,114,315,80,395,2023
2021,94067,SAINT MANDE,200054781,METROPOLE DU GRAND PARIS,94,VAL DE MARNE,446,50,496,15,30,195,225,736
2021,94021,CHEVILLY LARUE,200054781,METROPOLE DU GRAND PARIS,94,VAL DE MARNE,295,11,306,1,138,10,148,455
2021,95127,CERGY,249500109,CA DE CERGY-PONTOISE,95,VAL D OISE,669,39,708,66,686,33,719,1493
2021,95637,VAUREAL,249500109,CA DE CERGY-PONTOISE,95,VAL D OISE,113,13,126,0,224,3,227,354
2021,95582,SANNOIS,200058485,CA VAL PARISIS,95,VAL D OISE,218,11,229,0,335,18,353,582
2021,95210,ENGHIEN LES BAINS,200056380,CA PLAINE VALLEE,95,VAL D OISE,233,11,244,1,41,24,65,310
2021,95427,MONTMAGNY,200056380,CA PLAINE VALLEE,95,VAL D OISE,87,6,93,0,139,3,142,235
2021,95219,ERMONT,200058485,CA VAL PARISIS,95,VAL D OISE,257,18,275,0,312,23,335,609
2021,95487,PERSAN,249500489,CC DU HAUT VAL D'OISE,95,VAL D OISE,57,9,66,20,161,2,163,249
2021,95306,HERBLAY SUR SEINE,200058485,CA VAL PARISIS,95,VAL D OISE,231,33,264,0,428,16,444,707
2021,97128,SAINTE ANNE,200041507,CA LA RIVIERA DU LEVANT,971,GUADELOUPE,55,63,118,25,130,13,143,286
2021,97125,SAINT FRANCOIS,200041507,CA LA RIVIERA DU LEVANT,971,GUADELOUPE,53,50,103,40,68,3,71,214
2021,97129,SAINTE ROSE,249710062,CA DU NORD BASSE-TERRE,971,GUADELOUPE,168,13,181,32,62,9,71,284
2021,97107,CAPESTERRE BELLE EAU,249710070,CA GRAND SUD CARAIBE,971,GUADELOUPE,65,4,69,66,30,7,37,172
2021,97116,MORNE A L EAU,200044691,CA DU NORD GRANDE TERRE,971,GUADELOUPE,0,3,3,46,67,8,75,123
2021,97222,LE ROBERT,200041788,CA DU PAYS NORD MARTINIQUE,972,MARTINIQUE,205,76,281,46,81,11,92,420
2021,97210,LE FRANCOIS,249720053,CA DE L'ESPACE SUD DE LA MARTINIQUE,972,MARTINIQUE,123,20,143,71,67,9,76,290
2021,97207,DUCOS,249720053,CA DE L'ESPACE SUD DE LA MARTINIQUE,972,MARTINIQUE,26,38,64,8,152,7,159,231
2021,97224,SAINT JOSEPH,249720061,CA DU CENTRE DE LA MARTINIQUE,972,MARTINIQUE,112,63,175,85,41,2,43,304
2021,97213,LE LAMENTIN,249720061,CA DU CENTRE DE LA MARTINIQUE,972,MARTINIQUE,669,43,712,75,159,12,171,958
2021,97353,MARIPASOULA,249730037,CC DE L'OUEST GUYANAIS,973,GUYANE,0,0,0,10,0,8,8,18
2021,97306,MANA,249730037,CC DE L'OUEST GUYANAIS,973,GUYANE,12,0,12,21,4,0,4,37
2021,97410,SAINT BENOIT,249740093,CA INTERCOMMUNALE DE LA REUNION EST (CIREST),974,LA REUNION,190,135,325,31,99,29,128,484
2021,97405,PETITE ILE,249740077,CA CIVIS (COMMUNAUTE INTERCOMMUNALE DES VILLES SOLIDAIRES),974,LA REUNION,55,29,84,18,35,12,47,149
2021,97408,LA POSSESSION,249740101,CA TERRITOIRE DE LA COTE OUEST (TCO),974,LA REUNION,190,265,455,50,195,31,226,731
2021,97402,BRAS PANON,249740093,CA INTERCOMMUNALE DE LA REUNION EST (CIREST),974,LA REUNION,52,46,98,52,55,7,62,212
2021,97422,LE TAMPON,249740085,CA DU SUD,974,LA REUNION,216,190,406,27,526,82,608,1041
2021,97401,LES AVIRONS,249740077,CA CIVIS (COMMUNAUTE INTERCOMMUNALE DES VILLES SOLIDAIRES),974,LA REUNION,0,66,66,7,97,10,107,179
2022,01033,VALSERHONE,240100891,CC DU PAYS BELLEGARDIEN (CCPB),01,AIN,65,27,92,8,212,3,215,315
2022,01354,SAINT GENIS POUILLY,240100750,CA DU PAYS DE GEX,01,AIN,105,5,110,0,108,2,110,220
2022,02173,CHAUNY,200071785,CA CHAUNY TERGNIER LA FERE,02,AISNE,60,8,68,18,149,1,150,236
2022,02738,TERGNIER,200071785,CA CHAUNY TERGNIER LA FERE,02,AISNE,30,11,41,44,177,3,180,265
2022,02810,VILLERS COTTERETS,200071991,CC RETZ EN VALOIS,02,AISNE,24,16,40,0,173,1,174,215
2022,03095,CUSSET,200071363,CA VICHY COMMUNAUTE,03,ALLIER,23,0,23,24,126,2,128,175
2022,03190,MOULINS,200071140,CA MOULINS COMMUNAUTE,03,ALLIER,120,0,120,56,148,7,155,331
2022,04070,DIGNE LES BAINS,200067437,CA PROVENCE-ALPES-AGGLOMERATION,04,ALPES DE HAUTE PROVENCE,102,15,117,15,112,3,115,247
2022,06012,BEAUSOLEIL,240600551,CA DE LA RIVIERA FRANCAISE,06,ALPES MARITIMES,44,0,44,14,47,1,48,106
2022,06029,CANNES,200039915,CA CANNES PAYS DE LERINS,06,ALPES MARITIMES,707,50,757,27,226,30,256,1040
2022,06033,CARROS,200030195,METROPOLE NICE COTE D'AZUR,06,ALPES MARITIMES,87,18,105,0,147,4,151,255
2022,06083,MENTON,240600551,CA DE LA RIVIERA FRANCAISE,06,ALPES MARITIMES,222,5,227,1,206,9,215,443
2022,06152,VALBONNE,240600585,CA DE SOPHIA ANTIPOLIS,06,ALPES MARITIMES,200,6,206,0,143,7,150,356
2022,06155,VALLAURIS,240600585,CA DE SOPHIA ANTIPOLIS,06,ALPES MARITIMES,226,21,247,3,143,13,156,406
2022,07019,AUBENAS,200073245,CC DU BASSIN D'AUBENAS,07,ARDECHE,80,1,81,32,65,4,69,182
2022,08105,CHARLEVILLE MEZIERES,200041630,CA ARDENNE METROPOLE,08,ARDENNES,358,46,404,141,229,16,245,790
2022,10081,LA CHAPELLE SAINT LUC,200069250,CA TROYES CHAMPAGNE METROPOLE,10,AUBE,78,0,78,68,97,6,103,250
2022,10362,SAINTE SAVINE,200069250,CA TROYES CHAMPAGNE METROPOLE,10,AUBE,44,1,45,5,123,6,129,179
2022,11069,CARCASSONNE,200035715,CA CARCASSONNE AGGLO,11,AUDE,246,5,251,82,260,25,285,618
2022,11076,CASTELNAUDARY,200035855,CC CASTELNAUDARY LAURAGAIS AUDOIS,11,AUDE,70,18,88,26,67,5,72,186
2022,12176,ONET LE CHATEAU,241200187,CA RODEZ AGGLOMERATION,12,AVEYRON,55,21,76,35,139,3,142,253
2022,12202,RODEZ,241200187,CA RODEZ AGGLOMERATION,12,AVEYRON,190,24,214,47,139,10,149,410
2022,12300,VILLEFRANCHE DE ROUERGUE,200069383,CC OUEST AVEYRON COMMUNAUTE,12,AVEYRON,44,0,44,41,95,1,96,181
2022,13002,ALLAUCH,200054807,METROPOLE D'AIX-MARSEILLE-PROVENCE,13,BOUCHES DU RHONE,181,46,227,2,184,11,195,423
2022,13026,CHATEAUNEUF LES MARTIGUES,200054807,METROPOLE D'AIX-MARSEILLE-PROVENCE,13,BOUCHES DU RHONE,127,46,173,2,164,7,171,346
2022,13027,CHATEAURENARD,200035087,CA TERRE DE PROVENCE,13,BOUCHES DU RHONE,68,17,85,1,171,2,173,259
2022,13041,GARDANNE,200054807,METROPOLE D'AIX-MARSEILLE-PROVENCE,13,BOUCHES DU RHONE,144,14,158,18,202,5,207,383
2022,13054,MARIGNANE,200054807,METROPOLE D'AIX-MARSEILLE-PROVENCE,13,BOUCHES DU RHONE,256,45,301,0,253,6,259,561
2022,13063,MIRAMAS,200054807,METROPOLE D'AIX-MARSEILLE-PROVENCE,13,BOUCHES DU RHONE,173,10,183,31,150,5,155,368
2022,13097,SAINT MARTIN DE CRAU,241300417,CA D'ARLES-CRAU-CAMARGUE-MONTAGNETTE,13,BOUCHES DU RHONE,112,15,127,0,153,8,161,287
2022,13117,VITROLLES,200054807,METROPOLE D'AIX-MARSEILLE-PROVENCE,13,BOUCHES DU RHONE,378,54,432,29,228,13,241,702
2022,13204,MARSEILLE 4E ARRONDISSEMENT,200054807,METROPOLE D'AIX-MARSEILLE-PROVENCE,13,BOUCHES DU RHONE,385,113,498,17,312,39,351,866
2022,13210,MARSEILLE 10E ARRONDISSEMENT,200054807,METROPOLE D'AIX-MARSEILLE-PROVENCE,13,BOUCHES DU RHONE,357,115,472,26,313,63,376,874
2022,13211,MARSEILLE 11E ARRONDISSEMENT,200054807,METROPOLE D'AIX-MARSEILLE-PROVENCE,13,BOUCHES DU RHONE,467,120,587,34,325,32,357,978
2022,13213,MARSEILLE 13E ARRONDISSEMENT,200054807,METROPOLE D'AIX-MARSEILLE-PROVENCE,13,BOUCHES DU RHONE,788,116,904,232,349,80,429,1565
2022,14047,BAYEUX,241400555,CC DE BAYEUX INTERCOM,14,CALVADOS,40,9,49,12,188,5,193,254
2022,14118,CAEN,200065597,CU CAEN LA MER,14,CALVADOS,1093,83,1176,197,595,81,676,2048
2022,14341,IFS,200065597,CU CAEN LA MER,14,CALVADOS,58,5,63,0,189,1,190,253
2022,14366,LISIEUX,200069532,CA LISIEUX NORMANDIE,14,CALVADOS,92,0,92,38,265,5,270,400
2022,16015,ANGOULEME,200071827,CA DU GRAND ANGOULEME,16,CHARENTE,348,23,371,58,210,29,239,668
2022,18033,BOURGES,241800507,CA BOURGES PLUS,18,CHER,271,16,287,94,639,14,653,1034
2022,18279,VIERZON,200090561,CC VIERZON-SOLOGNE-BERRY,18,CHER,75,0,75,24,233,7,240,339
2022,2B033,BASTIA,242000354,CA DE BASTIA,20R,CORSE,293,21,314,28,114,6,120,462
2022,21166,CHENOVE,242100410,DIJON METROPOLE,21,COTE D OR,96,16,112,65,123,1,124,300
2022,21617,TALANT,242100410,DIJON METROPOLE,21,COTE D OR,126,16,142,7,86,10,96,245
2022,22187,PLERIN,200069409,CA SAINT-BRIEUC ARMOR AGGLOMERATION,22,COTES D ARMOR,111,6,117,44,165,12,177,337
2022,23096,GUERET,200034825,CA DU GRAND GUERET,23,CREUSE,82,0,82,37,127,0,127,246
2022,24322,PERIGUEUX,200040392,CA LE GRAND PERIGUEUX,24,DORDOGNE,288,4,292,29,145,22,167,488
2022,25031,AUDINCOURT,200065647,CA PAYS DE MONTBELIARD AGGLOMERATION,25,DOUBS,73,4,77,32,101,7,108,217
2022,25056,BESANCON,242500361,CU GRAND BESANCON METROPOLE,25,DOUBS,805,272,1077,128,864,47,911,2116
2022,25388,MONTBELIARD,200065647,CA PAYS DE MONTBELIARD AGGLOMERATION,25,DOUBS,153,7,160,67,119,3,122,349
2022,26058,BOURG LES VALENCE,200068781,CA VALENCE ROMANS AGGLO,26,DROME,74,20,94,1,211,5,216,311
2022,26235,PIERRELATTE,200042901,CC DROME SUD PROVENCE,26,DROME,50,19,69,18,128,5,133,220
2022,27229,EVREUX,200071454,CA EVREUX PORTES DE NORMANDIE,27,EURE,438,46,484,78,297,3,300,862
2022,28088,CHATEAUDUN,200069961,CC DU GRAND CHATEAUDUN,28,EURE ET LOIR,63,7,70,36,107,2,109,215
2022,28134,DREUX,200040277,CA AGGLO DU PAYS DE DREUX,28,EURE ET LOIR,275,21,296,28,184,11,195,519
2022,29019,BREST,242900314,BREST METROPOLE,29,FINISTERE,1069,51,1120,379,1329,116,1445,2945
2022,29039,CONCARNEAU,242900769,CA CONCARNEAU CORNOUAILLE AGGLOMERATION,29,FINISTERE,77,1,78,44,182,7,189,311
2022,29075,GUIPAVAS,242900314,BREST METROPOLE,29,FINISTERE,167,7,174,35,289,13,302,511
2022,29151,MORLAIX,242900835,CA MORLAIX COMMUNAUTE,29,FINISTERE,114,0,114,38,89,4,93,245
2022,30341,VAUVERT,243000593,CC DE PETITE CAMARGUE,30,GARD,37,11,48,46,96,3,99,193
2022,30351,VILLENEUVE LES AVIGNON,248400251,CA DU GRAND AVIGNON (COGA),30,GARD,90,33,123,16,59,7,66,205
2022,31113,CASTANET TOLOSAN,243100633,CA DU SICOVAL,31,HAUTE GARONNE,120,27,147,0,182,7,189,337
2022,31116,CASTELGINEST,243100518,TOULOUSE METROPOLE,31,HAUTE GARONNE,49,3,52,0,194,7,201,252
2022,31149,COLOMIERS,243100518,TOULOUSE METROPOLE,31,HAUTE GARONNE,390,8,398,0,345,28,373,771
2022,31424,PLAISANCE DU TOUCH,243100781,CC LE GRAND OUEST TOULOUSAIN,31,HAUTE GARONNE,102,13,115,7,284,6,290,411
2022,31446,RAMONVILLE SAINT AGNE,243100633,CA DU SICOVAL,31,HAUTE GARONNE,218,13,231,0,120,9,129,360
2022,31488,SAINT JEAN,243100518,TOULOUSE METROPOLE,31,HAUTE GARONNE,78,8,86,0,153,1,154,240
2022,31506,SAINT ORENS DE GAMEVILLE,243100518,TOULOUSE METROPOLE,31,HAUTE GARONNE,117,20,137,0,156,8,164,301
2022,31588,VILLENEUVE TOLOSANE,243100518,TOULOUSE METROPOLE,31,HAUTE GARONNE,59,23,82,0,162,4,166,249
2022,32013,AUCH,200066926,CA GRAND AUCH COEUR DE GASCOGNE,32,GERS,174,0,174,57,185,3,188,419
2022,33005,ANDERNOS LES BAINS,243301504,CA DU BASSIN D'ARCACHON NORD,33,GIRONDE,42,7,49,3,126,2,128,180
2022,33051,BIGANOS,243301504,CA DU BASSIN D'ARCACHON NORD,33,GIRONDE,50,26,76,0,162,1,163,238
2022,33199,GUJAN MESTRAS,243300563,CA BASSIN D'ARCACHON SUD (COBAS),33,GIRONDE,108,41,149,1,195,6,201,351
2022,33449,SAINT MEDARD EN JALLES,243300316,BORDEAUX METROPOLE,33,GIRONDE,174,32,206,0,495,12,507,713
2022,34003,AGDE,243400819,CA HERAULT-MEDITERRANEE,34,HERAULT,179,19,198,51,83,7,90,339
2022,34129,LATTES,243400017,MONTPELLIER MEDITERRANEE METROPOLE,34,HERAULT,225,22,247,0,123,19,142,389
2022,34145,LUNEL,243400520,CC DU PAYS DE LUNEL,34,HERAULT,77,15,92,28,222,7,229,349
2022,34157,MEZE,200066355,CA SETE AGGLOPOLE MEDITERRANEE,34,HERAULT,91,4,95,0,82,2,84,179
2022,34172,MONTPELLIER,243400017,MONTPELLIER MEDITERRANEE METROPOLE,34,HERAULT,2657,236,2893,198,1544,285,1829,4920
2022,34255,SAINT GELY DU FESC,200022986,CC DU GRAND PIC SAINT-LOUP,34,HERAULT,63,22,85,0,123,6,129,213
2022,34337,VILLENEUVE LES MAGUELONE,243400017,MONTPELLIER MEDITERRANEE METROPOLE,34,HERAULT,91,3,94,0,82,11,93,187
2022,35047,BRUZ,243500139,RENNES METROPOLE,35,ILLE ET VILAINE,104,59,163,39,271,8,279,481
2022,35055,CHANTEPIE,243500139,RENNES METROPOLE,35,ILLE ET VILAINE,42,27,69,23,178,3,181,273
2022,35093,DINARD,243500725,CC COTE D'EMERAUDE,35,ILLE ET VILAINE,38,12,50,17,51,0,51,118
2022,35238,RENNES,243500139,RENNES METROPOLE,35,ILLE ET VILAINE,1878,355,2233,699,1785,271,2056,4988
2022,35360,VITRE,200039022,CA VITRE COMMUNAUTE,35,ILLE ET VILAINE,105,41,146,68,263,4,267,481
2022,36088,ISSOUDUN,243600236,CC DU PAYS D'ISSOUDUN,36,INDRE,34,10,44,21,148,2,150,215
2022,37233,SAINT PIERRE DES CORPS,243700754,TOURS METROPOLE VAL DE LOIRE,37,INDRE ET LOIRE,66,22,88,56,257,6,263,407
2022,38185,GRENOBLE,200040715,GRENOBLE-ALPES-METROPOLE,38,ISERE,1628,349,1977,145,1240,101,1341,3463
2022,38421,SAINT MARTIN D HERES,200040715,GRENOBLE-ALPES-METROPOLE,38,ISERE,244,43,287,10,388,6,394,691
2022,40279,SAINT PAUL LES DAX,244000675,CA DU GRAND DAX,40,LANDES,60,8,68,0,162,8,170,239
2022,42147,MONTBRISON,200065886,CA LOIRE FOREZ AGGLOMERATION (LFA),42,LOIRE,111,5,116,0,186,3,189,305
2022,42218,SAINT ETIENNE,244200770,SAINT-ETIENNE METROPOLE,42,LOIRE,1109,148,1257,164,987,65,1052,2473
2022,44069,GUERANDE,244400610,CA DE LA PRESQU'ILE DE GUERANDE ATLANTIQUE (CAP ATLANTIQUE),44,LOIRE ATLANTIQUE,70,4,74,46,232,4,236,356
2022,44162,SAINT HERBLAIN,244400404,NANTES METROPOLE,44,LOIRE ATLANTIQUE,642,96,738,57,749,36,785,1580
2017,64445,PAU,200067254,CA PAU BEARN PYRENEES,64,PYRENEES ATLANTIQUES,421,55,476,122,624,34,658,1256
2017,66172,SAINT ESTEVE,200027183,CU PERPIGNAN MEDITERRANEE METROPOLE,66,PYRENEES ORIENTALES,40,10,50,0,112,3,115,165
2017,68063,CERNAY,200036465,CC DE THANN-CERNAY,68,HAUT RHIN,33,1,34,10,114,2,116,161
2017,68154,ILLZACH,200066009,CA MULHOUSE ALSACE AGGLOMERATION,68,HAUT RHIN,85,0,85,17,99,3,102,204
2017,68278,RIXHEIM,200066009,CA MULHOUSE ALSACE AGGLOMERATION,68,HAUT RHIN,115,2,117,15,126,6,132,264
2017,69019,BELLEVILLE EN BEAUJOLAIS,200067817,CC SAONE-BEAUJOLAIS,69,RHONE,25,1,26,32,317,1,318,376
2017,69081,ECULLY,200046977,METROPOLE DE LYON,69,RHONE,159,14,173,17,226,16,242,433
2017,69152,PIERRE BENITE,200046977,METROPOLE DE LYON,69,RHONE,158,9,167,53,156,2,158,379
2017,69199,SAINT FONS,200046977,METROPOLE DE LYON,69,RHONE,157,3,160,71,95,1,96,327
2017,69204,SAINT GENIS LAVAL,200046977,METROPOLE DE LYON,69,RHONE,190,22,212,16,246,14,260,488
2017,69277,GENAS,246900575,CC DE L'EST LYONNAIS (CCEL),69,RHONE,96,17,113,0,239,7,246,359
2017,69385,LYON 5E ARRONDISSEMENT,200046977,METROPOLE DE LYON,69,RHONE,406,51,457,46,440,61,501,1003
2017,70550,VESOUL,247000011,CA DE VESOUL,70,HAUTE SAONE,98,5,103,33,139,0,139,276
2017,72003,ALLONNES,247200132,CU LE MANS METROPOLE,72,SARTHE,18,0,18,70,205,4,209,297
2017,75103,PARIS 3E ARRONDISSEMENT,200054781,METROPOLE DU GRAND PARIS,75,PARIS,652,22,674,12,63,198,261,946
2017,75110,PARIS 10E ARRONDISSEMENT,200054781,METROPOLE DU GRAND PARIS,75,PARIS,1830,97,1927,12,214,602,816,2754
2017,75112,PARIS 12E ARRONDISSEMENT,200054781,METROPOLE DU GRAND PARIS,75,PARIS,2524,147,2671,13,483,586,1069,3754
2017,75114,PARIS 14E ARRONDISSEMENT,200054781,METROPOLE DU GRAND PARIS,75,PARIS,2224,129,2353,51,391,484,875,3279
2017,75118,PARIS 18E ARRONDISSEMENT,200054781,METROPOLE DU GRAND PARIS,75,PARIS,3314,170,3484,114,523,935,1458,5055
2017,76057,BARENTIN,247600646,CC CAUX - AUSTREBERTHE,76,SEINE MARITIME,72,0,72,0,253,1,254,326
2017,76322,LE GRAND QUEVILLY,200023414,METROPOLE ROUEN NORMANDIE,76,SEINE MARITIME,127,11,138,28,410,8,418,584
2017,76476,PORT JEROME SUR SEINE,200010700,CA CAUX SEINE AGGLO,76,SEINE MARITIME,30,1,31,0,210,7,217,248
2017,76540,ROUEN,200023414,METROPOLE ROUEN NORMANDIE,76,SEINE MARITIME,1013,114,1127,94,989,84,1073,2294
2017,77053,BRIE COMTE ROBERT,247700644,CC L'OREE DE LA BRIE,77,SEINE ET MARNE,115,0,115,4,303,2,305,424
2017,77118,CLAYE SOUILLY,200055655,CA ROISSY PAYS DE FRANCE,77,SEINE ET MARNE,30,1,31,11,203,4,207,249
2017,77296,MOISSY CRAMAYEL,200059228,CA GRAND PARIS SUD SEINE ESSONNE SENART,77,SEINE ET MARNE,105,9,114,18,314,7,321,452
2017,77316,MORET LOING ET ORVANNE,247700032,CC MORET SEINE ET LOING,77,SEINE ET MARNE,185,1,186,7,186,2,188,381
2017,77379,PROVINS,200037133,CC DU PROVINOIS,77,SEINE ET MARNE,100,9,109,36,75,3,78,224
2017,77479,VAIRES SUR MARNE,200057958,CA PARIS - VALLEE DE LA MARNE,77,SEINE ET MARNE,136,0,136,0,179,3,182,318
2017,77514,VILLEPARISIS,200055655,CA ROISSY PAYS DE FRANCE,77,SEINE ET MARNE,138,1,139,7,461,7,468,614
2017,78123,CARRIERES SOUS POISSY,200059889,CU GRAND PARIS SEINE ET OISE,78,YVELINES,161,4,165,17,218,14,232,414
2017,78158,LE CHESNAY ROCQUENCOURT,247800584,CA VERSAILLES GRAND PARC (CAVGP),78,YVELINES,486,8,494,34,147,41,188,716
2017,78383,MAUREPAS,200058782,CA DE SAINT QUENTIN EN YVELINES,78,YVELINES,220,0,220,16,199,8,207,444
2017,78481,LE PECQ,200058519,CA SAINT GERMAIN BOUCLES DE SEINE,78,YVELINES,167,14,181,10,164,19,183,374
2017,78586,SARTROUVILLE,200058519,CA SAINT GERMAIN BOUCLES DE SEINE,78,YVELINES,352,164,516,67,617,94,711,1294
2017,78674,VILLEPREUX,200058782,CA DE SAINT QUENTIN EN YVELINES,78,YVELINES,65,19,84,0,176,14,190,274
2017,79049,BRESSUIRE,200040244,CA DU BOCAGE BRESSUIRAIS,79,DEUX SEVRES,70,0,70,15,325,4,329,414
2017,79329,THOUARS,247900798,CC DU THOUARSAIS,79,DEUX SEVRES,91,0,91,20,175,1,176,287
2017,80021,AMIENS,248000531,CA AMIENS METROPOLE,80,SOMME,1116,54,1170,414,1293,42,1335,2919
2017,81105,GRAULHET,200066124,CA GAILLAC-GRAULHET,81,TARN,96,0,96,57,56,4,60,213
2017,83061,FREJUS,200035319,CA VAR ESTEREL MEDITERRANEE (CAVEM),83,VAR,371,12,383,43,321,13,334,761
2017,83071,LA LONDE LES MAURES,200027100,CC MEDITERRANEE PORTE DES MAURES,83,VAR,80,0,80,0,53,1,54,134
2017,83107,ROQUEBRUNE SUR ARGENS,200035319,CA VAR ESTEREL MEDITERRANEE (CAVEM),83,VAR,99,1,100,0,100,7,107,207
2017,83126,LA SEYNE SUR MER,248300543,METROPOLE TOULON-PROVENCE-MEDITERRANEE,83,VAR,378,114,492,132,426,27,453,1077
2017,83144,LA VALETTE DU VAR,248300543,METROPOLE TOULON-PROVENCE-MEDITERRANEE,83,VAR,155,9,164,5,199,9,208,378
2017,84019,BOLLENE,200000628,CC RHONE LEZ PROVENCE,84,VAUCLUSE,70,0,70,43,137,1,138,251
2017,85047,CHALLANS,200071629,CC CHALLANS-GOIS COMMUNAUTE,85,VENDEE,76,7,83,19,348,3,351,453
2017,87085,LIMOGES,248719312,CU LIMOGES METROPOLE,87,HAUTE VIENNE,1018,31,1049,198,941,76,1017,2263
2017,89024,AUXERRE,200067114,CA DE L'AUXERROIS,89,YONNE,324,1,325,56,428,4,432,814
2017,90010,BELFORT,200069052,CA GRAND BELFORT,90,TERRITOIRE DE BELFORT,394,8,402,153,283,12,295,850
2017,91215,EPINAY SOUS SENART,200058477,CA VAL D'YERRES VAL DE SEINE,91,ESSONNE,101,1,102,37,131,1,132,271
2017,91223,ETAMPES,200017846,CA ETAMPOIS SUD ESSONNE,91,ESSONNE,238,13,251,41,221,8,229,521
2017,91312,IGNY,200056232,CA COMMUNAUTE PARIS-SACLAY,91,ESSONNE,112,4,116,0,123,9,132,248
2017,91377,MASSY,200056232,CA COMMUNAUTE PARIS-SACLAY,91,ESSONNE,857,9,866,16,785,34,819,1701
2017,91421,MONTGERON,200058477,CA VAL D'YERRES VAL DE SEINE,91,ESSONNE,210,2,212,19,300,8,308,539
2017,91521,RIS ORANGIS,200059228,CA GRAND PARIS SUD SEINE ESSONNE SENART,91,ESSONNE,311,3,314,16,300,11,311,641
2017,91552,SAINT GERMAIN LES ARPAJON,200057859,CA COEUR D'ESSONNE AGGLOMERATION,91,ESSONNE,14,3,17,0,172,2,174,191
2017,91691,YERRES,200058477,CA VAL D'YERRES VAL DE SEINE,91,ESSONNE,419,7,426,21,334,12,346,793
2017,92002,ANTONY,200054781,METROPOLE DU GRAND PARIS,92,HAUTS DE SEINE,817,26,843,29,503,135,638,1511
2017,92009,BOIS COLOMBES,200054781,METROPOLE DU GRAND PARIS,92,HAUTS DE SEINE,430,60,490,0,228,176,404,894
2017,92019,CHATENAY MALABRY,200054781,METROPOLE DU GRAND PARIS,92,HAUTS DE SEINE,424,1,425,58,244,38,282,765
2017,92023,CLAMART,200054781,METROPOLE DU GRAND PARIS,92,HAUTS DE SEINE,654,25,679,52,323,139,462,1193
2017,92032,FONTENAY AUX ROSES,200054781,METROPOLE DU GRAND PARIS,92,HAUTS DE SEINE,298,16,314,0,182,25,207,521
2017,92035,LA GARENNE COLOMBES,200054781,METROPOLE DU GRAND PARIS,92,HAUTS DE SEINE,586,27,613,33,121,153,274,920
2017,92044,LEVALLOIS PERRET,200054781,METROPOLE DU GRAND PARIS,92,HAUTS DE SEINE,1239,152,1391,56,280,696,976,2424
2017,92050,NANTERRE,200054781,METROPOLE DU GRAND PARIS,92,HAUTS DE SEINE,1283,17,1300,154,825,145,970,2424
2017,92062,PUTEAUX,200054781,METROPOLE DU GRAND PARIS,92,HAUTS DE SEINE,1049,33,1082,24,330,205,535,1640
2017,93007,LE BLANC MESNIL,200054781,METROPOLE DU GRAND PARIS,93,SEINE SAINT DENIS,322,4,326,24,223,8,231,581
2017,93014,CLICHY SOUS BOIS,200054781,METROPOLE DU GRAND PARIS,93,SEINE SAINT DENIS,185,3,188,48,105,5,110,346
2017,93045,LES LILAS,200054781,METROPOLE DU GRAND PARIS,93,SEINE SAINT DENIS,237,5,242,0,230,46,276,518
2017,93049,NEUILLY PLAISANCE,200054781,METROPOLE DU GRAND PARIS,93,SEINE SAINT DENIS,162,6,168,0,167,14,181,349
2017,93057,LES PAVILLONS SOUS BOIS,200054781,METROPOLE DU GRAND PARIS,93,SEINE SAINT DENIS,222,17,239,22,164,11,175,437
2017,93064,ROSNY SOUS BOIS,200054781,METROPOLE DU GRAND PARIS,93,SEINE SAINT DENIS,487,1,488,0,368,32,400,888
2017,94011,BONNEUIL SUR MARNE,200054781,METROPOLE DU GRAND PARIS,94,VAL DE MARNE,150,0,150,80,112,0,112,342
2017,94018,CHARENTON LE PONT,200054781,METROPOLE DU GRAND PARIS,94,VAL DE MARNE,525,19,544,1,153,117,270,815
2017,94021,CHEVILLY LARUE,200054781,METROPOLE DU GRAND PARIS,94,VAL DE MARNE,236,5,241,1,191,6,197,439
2017,94033,FONTENAY SOUS BOIS,200054781,METROPOLE DU GRAND PARIS,94,VAL DE MARNE,643,9,652,70,480,143,623,1345
2017,94034,FRESNES,200054781,METROPOLE DU GRAND PARIS,94,VAL DE MARNE,275,19,294,0,260,19,279,573
2017,94041,IVRY SUR SEINE,200054781,METROPOLE DU GRAND PARIS,94,VAL DE MARNE,783,43,826,115,342,58,400,1340
2017,94044,LIMEIL BREVANNES,200054781,METROPOLE DU GRAND PARIS,94,VAL DE MARNE,307,10,317,18,314,9,323,658
2017,94068,SAINT MAUR DES FOSSES,200054781,METROPOLE DU GRAND PARIS,94,VAL DE MARNE,765,60,825,35,516,110,626,1487
2017,94069,SAINT MAURICE,200054781,METROPOLE DU GRAND PARIS,94,VAL DE MARNE,232,4,236,0,82,32,114,350
2017,94080,VINCENNES,200054781,METROPOLE DU GRAND PARIS,94,VAL DE MARNE,908,59,967,0,225,428,653,1619
2017,95127,CERGY,249500109,CA DE CERGY-PONTOISE,95,VAL D OISE,650,28,678,81,791,19,810,1569
2017,95176,CORMEILLES EN PARISIS,200058485,CA VAL PARISIS,95,VAL D OISE,180,22,202,0,260,19,279,481
2017,95252,FRANCONVILLE,200058485,CA VAL PARISIS,95,VAL D OISE,292,7,299,0,494,14,508,806
2017,95277,GONESSE,200055655,CA ROISSY PAYS DE FRANCE,95,VAL D OISE,274,0,274,34,137,5,142,450
2017,95280,GOUSSAINVILLE,200055655,CA ROISSY PAYS DE FRANCE,95,VAL D OISE,111,1,112,25,208,2,210,347
2017,95313,L'ISLE ADAM,249500455,CC DE LA VALLEE DE L'OISE ET DES TROIS FORETS,95,VAL D OISE,80,31,111,0,103,4,107,218
2017,95323,JOUY LE MOUTIER,249500109,CA DE CERGY-PONTOISE,95,VAL D OISE,146,5,151,1,232,6,238,390
2017,95427,MONTMAGNY,200056380,CA PLAINE VALLEE,95,VAL D OISE,90,1,91,31,179,2,181,303
2017,95555,SAINT GRATIEN,200056380,CA PLAINE VALLEE,95,VAL D OISE,178,5,183,0,250,19,269,452
2017,95563,SAINT LEU LA FORET,200058485,CA VAL PARISIS,95,VAL D OISE,97,10,107,0,183,3,186,293
2017,95598,SOISY SOUS MONTMORENCY,200056380,CA PLAINE VALLEE,95,VAL D OISE,92,6,98,3,212,9,221,322
2017,97103,BAIE MAHAULT,200018653,CA CAP EXCELLENCE,971,GUADELOUPE,341,41,382,46,243,16,259,687
2017,97105,BASSE TERRE,249710070,CA GRAND SUD CARAIBE,971,GUADELOUPE,200,4,204,69,52,0,52,325
2017,97116,MORNE L EAU,200044691,CA DU NORD GRANDE TERRE,971,GUADELOUPE,0,5,5,54,63,3,66,126
2017,97117,LE MOULE,200044691,CA DU NORD GRANDE TERRE,971,GUADELOUPE,68,44,112,49,68,7,75,236
2017,97124,SAINT CLAUDE,249710070,CA GRAND SUD CARAIBE,971,GUADELOUPE,40,21,61,31,38,1,39,131
2017,97128,SAINTE ANNE,200041507,CA LA RIVIERA DU LEVANT,971,GUADELOUPE,90,36,126,6,105,3,108,240
2017,97129,SAINTE ROSE,249710062,CA DU NORD BASSE-TERRE,971,GUADELOUPE,133,10,143,51,70,3,73,266
2017,97220,RIVIERE PILOTE,249720053,CA DE L'ESPACE SUD DE LA MARTINIQUE,972,MARTINIQUE,35,9,44,48,29,2,31,123
2017,97221,RIVIERE SALEE,249720053,CA DE L'ESPACE SUD DE LA MARTINIQUE,972,MARTINIQUE,0,7,7,94,54,6,60,161
2017,97222,LE ROBERT,200041788,CA DU PAYS NORD MARTINIQUE,972,MARTINIQUE,195,54,249,60,70,6,76,386
2017,97229,SCHOELCHER,249720061,CA DU CENTRE DE LA MARTINIQUE,972,MARTINIQUE,172,11,183,58,70,8,78,319
2017,97305,MACOURIA,249730045,CA DU CENTRE LITTORAL,973,GUYANE,60,0,60,3,32,6,38,101
2017,97307,MATOURY,249730045,CA DU CENTRE LITTORAL,973,GUYANE,296,0,296,6,61,5,66,368
2017,97309,REMIRE MONTJOLY,249730045,CA DU CENTRE LITTORAL,973,GUYANE,210,4,214,5,96,19,115,335
2017,97402,BRAS PANON,249740093,CA INTERCOMMUNALE DE LA REUNION EST (CIREST),974,LA REUNION,52,31,83,75,42,10,52,210
2017,97404,L'ETANG SALE,249740077,CA CIVIS (COMMUNAUTE INTERCOMMUNALE DES VILLES SOLIDAIRES),974,LA REUNION,60,42,102,0,114,26,140,242
2017,97407,LE PORT,249740101,CA TERRITOIRE DE LA COTE OUEST (TCO),974,LA REUNION,265,28,293,95,81,10,91,479
2017,97411,SAINT DENIS,249740119,CA INTERCOMMUNALE DU NORD DE LA REUNION (CINOR),974,LA REUNION,1342,523,1865,337,450,94,544,2746
2017,97413,SAINT LEU,249740101,CA TERRITOIRE DE LA COTE OUEST (TCO),974,LA REUNION,147,74,221,54,203,31,234,509
2017,97414,SAINT LOUIS,249740077,CA CIVIS (COMMUNAUTE INTERCOMMUNALE DES VILLES SOLIDAIRES),974,LA REUNION,79,76,155,68,229,51,280,503
2017,97416,SAINT PIERRE,249740077,CA CIVIS (COMMUNAUTE INTERCOMMUNALE DES VILLES SOLIDAIRES),974,LA REUNION,488,264,752,92,425,49,474,1318
2018,01004,AMBERIEU EN BUGEY,240100883,CC DE LA PLAINE DE L'AIN,01,AIN,80,8,88,0,328,2,330,419
2018,01033,VALSERHONE,240100891,CC DU PAYS BELLEGARDIEN (CCPB),01,AIN,65,11,76,46,234,1,235,357
2018,01328,ROMANS,200069193,CC DE LA DOMBES,01,AIN,0,0,0,0,2,0,2,2
2018,01354,SAINT GENIS POUILLY,240100750,CA DU PAYS DE GEX,01,AIN,82,2,84,0,147,1,148,232
2018,02408,LAON,200043495,CA DU PAYS DE LAON,02,AISNE,116,2,118,33,248,3,251,402
2018,02691,SAINT QUENTIN,200071892,CA DU SAINT-QUENTINOIS,02,AISNE,181,48,229,195,445,12,457,881
2018,02722,SOISSONS,240200477,CA GRANDSOISSONS AGGLOMERATION,02,AISNE,141,20,161,77,256,4,260,498
2018,03095,CUSSET,200071363,CA VICHY COMMUNAUTE,03,ALLIER,29,0,29,51,119,4,123,203
2018,03185,MONTLUCON,200071082,CA MONTLUCON COMMUNAUTE,03,ALLIER,173,0,173,87,306,2,308,568
2018,03190,MOULINS,200071140,CA MOULINS COMMUNAUTE,03,ALLIER,120,0,120,70,154,4,158,348
2018,03310,VICHY,200071363,CA VICHY COMMUNAUTE,03,ALLIER,157,1,158,67,170,11,181,406
2018,04070,DIGNE LES BAINS,200067437,CA PROVENCE-ALPES-AGGLOMERATION,04,ALPES DE HAUTE PROVENCE,102,12,114,15,123,1,124,253
2018,04112,MANOSQUE,200034700,CA DURANCE-LUBERON-VERDON AGGLOMERATION,04,ALPES DE HAUTE PROVENCE,164,8,172,17,165,3,168,357
2018,05061,GAP,200067825,CA GAP-TALLARD-DURANCE,05,HAUTES ALPES,328,4,332,36,333,2,335,703
2018,06004,ANTIBES,240600585,CA DE SOPHIA ANTIPOLIS,06,ALPES MARITIMES,480,39,519,10,734,44,778,1307
2018,06012,BEAUSOLEIL,240600551,CA DE LA RIVIERA FRANCAISE,06,ALPES MARITIMES,47,1,48,8,46,0,46,102
2018,06029,CANNES,200039915,CA CANNES PAYS DE LERINS,06,ALPES MARITIMES,742,54,796,40,231,30,261,1097
2018,06079,MANDELIEU LA NAPOULE,200039915,CA CANNES PAYS DE LERINS,06,ALPES MARITIMES,222,18,240,9,117,9,126,375
2018,06083,MENTON,240600551,CA DE LA RIVIERA FRANCAISE,06,ALPES MARITIMES,189,0,189,6,223,7,230,425
2018,06123,SAINT LAURENT DU VAR,200030195,METROPOLE NICE COTE D'AZUR,06,ALPES MARITIMES,253,30,283,0,336,8,344,627
2018,06152,VALBONNE,240600585,CA DE SOPHIA ANTIPOLIS,06,ALPES MARITIMES,206,0,206,0,155,11,166,372
2018,06155,VALLAURIS,240600585,CA DE SOPHIA ANTIPOLIS,06,ALPES MARITIMES,226,8,234,34,135,8,143,410
2018,07010,ANNONAY,200072015,CA ANNONAY RHONE AGGLO,07,ARDECHE,122,7,129,65,91,0,91,286
2018,07102,GUILHERAND GRANGES,200041366,CC RHONE CRUSSOL,07,ARDECHE,39,6,45,4,180,6,186,235
2018,07324,TOURNON SUR RHONE,200073096,CA ARCHE AGGLO,07,ARDECHE,50,0,50,32,119,4,123,205
2018,08105,CHARLEVILLE MEZIERES,200041630,CA ARDENNE METROPOLE,08,ARDENNES,388,38,426,148,280,10,290,865
2018,09225,PAMIERS,200066231,CC DES PORTES D'ARIEGE PYRENEES,09,ARIEGE,178,0,178,15,100,3,103,296
2018,10333,SAINT ANDRE LES VERGERS,200069250,CA TROYES CHAMPAGNE METROPOLE,10,AUBE,116,0,116,0,121,11,132,248
2018,10362,SAINTE SAVINE,200069250,CA TROYES CHAMPAGNE METROPOLE,10,AUBE,65,0,65,0,157,5,162,227
2018,11262,NARBONNE,241100593,CA LE GRAND NARBONNE,11,AUDE,264,13,277,82,353,26,379,738
2018,12145,MILLAU,241200567,CC DE MILLAU GRANDS CAUSSES,12,AVEYRON,113,0,113,60,205,10,215,388
2018,12300,VILLEFRANCHE DE ROUERGUE,200069383,CC OUEST AVEYRON COMMUNAUTE,12,AVEYRON,44,0,44,36,133,1,134,214
2018,13002,ALLAUCH,200054807,METROPOLE D'AIX-MARSEILLE-PROVENCE,13,BOUCHES DU RHONE,181,16,197,0,187,11,198,395
2018,13027,CHATEAURENARD,200035087,CA TERRE DE PROVENCE,13,BOUCHES DU RHONE,66,6,72,3,191,7,198,273
2018,13041,GARDANNE,200054807,METROPOLE D'AIX-MARSEILLE-PROVENCE,13,BOUCHES DU RHONE,155,8,163,15,194,3,197,375
2018,13047,ISTRES,200054807,METROPOLE D'AIX-MARSEILLE-PROVENCE,13,BOUCHES DU RHONE,414,2,416,0,300,11,311,727
2018,13110,TRETS,200054807,METROPOLE D'AIX-MARSEILLE-PROVENCE,13,BOUCHES DU RHONE,98,6,104,0,85,6,91,195
2018,13117,VITROLLES,200054807,METROPOLE D'AIX-MARSEILLE-PROVENCE,13,BOUCHES DU RHONE,378,18,396,61,251,3,254,712
2018,13203,MARSEILLE 3E ARRONDISSEMENT,200054807,METROPOLE D'AIX-MARSEILLE-PROVENCE,13,BOUCHES DU RHONE,401,17,418,98,126,18,144,659
2018,13204,MARSEILLE 4E ARRONDISSEMENT,200054807,METROPOLE D'AIX-MARSEILLE-PROVENCE,13,BOUCHES DU RHONE,409,63,472,18,370,35,405,894
2018,13206,MARSEILLE 6E ARRONDISSEMENT,200054807,METROPOLE D'AIX-MARSEILLE-PROVENCE,13,BOUCHES DU RHONE,602,116,718,15,232,90,322,1055
2018,13211,MARSEILLE 11E ARRONDISSEMENT,200054807,METROPOLE D'AIX-MARSEILLE-PROVENCE,13,BOUCHES DU RHONE,434,47,481,55,385,20,405,941
2018,13213,MARSEILLE 13E ARRONDISSEMENT,200054807,METROPOLE D'AIX-MARSEILLE-PROVENCE,13,BOUCHES DU RHONE,771,42,813,263,377,39,416,1493
2018,13216,MARSEILLE 16E ARRONDISSEMENT,200054807,METROPOLE D'AIX-MARSEILLE-PROVENCE,13,BOUCHES DU RHONE,238,12,250,49,68,3,71,370
2018,14047,BAYEUX,241400555,CC DE BAYEUX INTERCOM,14,CALVADOS,48,7,55,25,203,4,207,287
2018,14327,HEROUVILLE SAINT CLAIR,200065597,CU CAEN LA MER,14,CALVADOS,255,5,260,70,262,6,268,597
2018,16102,COGNAC,200070514,CA DU GRAND COGNAC,16,CHARENTE,137,0,137,46,143,9,152,335
2018,17299,ROCHEFORT,200041762,CA ROCHEFORT OCEAN,17,CHARENTE MARITIME,205,0,205,38,223,4,227,470
2018,17306,ROYAN,241700640,CA ROYAN ATLANTIQUE,17,CHARENTE MARITIME,49,0,49,26,111,6,117,192
2018,17415,SAINTES,200036473,CA DE SAINTES,17,CHARENTE MARITIME,139,0,139,26,312,12,324,489
2018,18033,BOURGES,241800507,CA BOURGES PLUS,18,CHER,248,11,259,124,817,29,846,1229
2018,18279,VIERZON,200090561,CC VIERZON-SOLOGNE-BERRY ET VILLAGES DE LA FORET,18,CHER,75,0,75,37,264,3,267,379
2018,19031,BRIVE LA GAILLARDE,200043172,CA DU BASSIN DE BRIVE,19,CORREZE,352,3,355,138,326,37,363,857
2018,21171,CHEVIGNY SAINT SAUVEUR,242100410,DIJON METROPOLE,21,COTE D OR,36,8,44,12,178,1,179,236
2018,21231,DIJON,242100410,DIJON METROPOLE,21,COTE D OR,1632,129,1761,171,1162,92,1254,3186
2018,21617,TALANT,242100410,DIJON METROPOLE,21,COTE D OR,126,8,134,19,99,4,103,255
2018,22093,LAMBALLE ARMOR,200069391,CA LAMBALLE TERRE ET MER,22,COTES D ARMOR,46,4,50,34,355,4,359,443
2018,23096,GUERET,200034825,CA DU GRAND GUERET,23,CREUSE,82,0,82,26,151,1,152,260
2018,24053,BOULAZAC ISLE MANOIRE,200040392,CA LE GRAND PERIGUEUX,24,DORDOGNE,83,2,85,19,123,3,126,230
2018,24322,PERIGUEUX,200040392,CA LE GRAND PERIGUEUX,24,DORDOGNE,288,5,293,37,185,12,197,527
2018,26252,PORTES LES VALENCE,200068781,CA VALENCE ROMANS AGGLO,26,DROME,40,1,41,9,175,3,178,228
2018,26281,ROMANS SUR ISERE,200068781,CA VALENCE ROMANS AGGLO,26,DROME,210,5,215,93,318,6,324,632
2018,27284,GISORS,200071843,CC DU VEXIN NORMAND,27,EURE,109,6,115,0,164,1,165,280
2018,27681,VERNON,200072312,CA SEINE NORMANDIE AGGLOMERATION,27,EURE,170,38,208,14,252,4,256,478
2018,28229,MAINVILLIERS,200033181,CA CHARTRES METROPOLE,28,EURE ET LOIR,79,0,79,55,138,2,140,274
2018,29151,MORLAIX,242900835,CA MORLAIX COMMUNAUTE,29,FINISTERE,130,0,130,54,114,5,119,303
2018,29189,PLOUGASTEL DAOULAS,242900314,BREST METROPOLE,29,FINISTERE,52,0,52,58,251,10,261,372
2018,29212,PLOUZANE,242900314,BREST METROPOLE,29,FINISTERE,48,0,48,31,296,9,305,384
2018,2A004,AJACCIO,242010056,CA DU PAYS AJACCIEN,2A,CORSE DU SUD,495,0,495,41,187,30,217,753
2018,30007,ALES,200066918,CA ALES AGGLOMERATION,30,GARD,181,0,181,96,269,1,270,547
2018,30202,PONT SAINT ESPRIT,200034692,CA DU GARD RHODANIEN,30,GARD,60,0,60,15,66,1,67,142
2018,30258,SAINT GILLES,243000643,CA DE NIMES METROPOLE,30,GARD,41,2,43,44,128,3,131,218
2018,30351,VILLENEUVE LES AVIGNON,248400251,CA DU GRAND AVIGNON (COGA),30,GARD,89,9,98,14,68,5,73,185
2018,31069,BLAGNAC,243100518,TOULOUSE METROPOLE,31,HAUTE GARONNE,486,0,486,3,234,19,253,742
2018,31116,CASTELGINEST,243100518,TOULOUSE METROPOLE,31,HAUTE GARONNE,49,2,51,0,206,3,209,260
2018,31157,CUGNAUX,243100518,TOULOUSE METROPOLE,31,HAUTE GARONNE,208,14,222,0,228,17,245,466
2018,31395,MURET,200068641,CA LE MURETAIN AGGLO,31,HAUTE GARONNE,181,1,182,2,326,13,339,522
2018,31424,PLAISANCE DU TOUCH,243100781,CC DE LA SAVE AU TOUCH,31,HAUTE GARONNE,115,5,120,8,307,12,319,446
2018,31488,SAINT JEAN,243100518,TOULOUSE METROPOLE,31,HAUTE GARONNE,76,6,82,0,150,7,157,239
2018,31555,TOULOUSE,243100518,TOULOUSE METROPOLE,31,HAUTE GARONNE,5969,34,6003,556,0,777,777,7336
2018,31561,L'UNION,243100518,TOULOUSE METROPOLE,31,HAUTE GARONNE,107,4,111,0,123,11,134,245
2018,32013,AUCH,200066926,CA GRAND AUCH COEUR DE GASCOGNE,32,GERS,186,0,186,53,234,4,238,477
2018,33009,ARCACHON,243300563,CA BASSIN D'ARCACHON SUD-POLE ATLANTIQUE (COBAS),33,GIRONDE,88,0,88,14,16,2,18,120
2018,33039,BEGLES,243300316,BORDEAUX METROPOLE,33,GIRONDE,178,19,197,9,426,21,447,653
2018,33075,BRUGES,243300316,BORDEAUX METROPOLE,33,GIRONDE,253,11,264,0,327,16,343,607
2018,33119,CENON,243300316,BORDEAUX METROPOLE,33,GIRONDE,58,15,73,72,279,11,290,436
2018,33167,FLOIRAC,243300316,BORDEAUX METROPOLE,33,GIRONDE,155,2,157,46,296,9,305,509
2018,33200,LE HAILLAN,243300316,BORDEAUX METROPOLE,33,GIRONDE,135,3,138,0,164,6,170,308
2018,33238,LEOGNAN,243301264,CC DE MONTESQUIEU,33,GIRONDE,39,16,55,10,173,4,177,242
2018,33243,LIBOURNE,200070092,CA DU LIBOURNAIS,33,GIRONDE,222,3,225,0,232,5,237,462
2018,33249,LORMONT,243300316,BORDEAUX METROPOLE,33,GIRONDE,166,9,175,48,248,9,257,480
2018,33519,LE TAILLAN MEDOC,243300316,BORDEAUX METROPOLE,33,GIRONDE,25,10,35,1,184,3,187,223
2018,33529,LA TESTE DE BUCH,243300563,CA BASSIN D'ARCACHON SUD-POLE ATLANTIQUE (COBAS),33,GIRONDE,124,12,136,9,253,10,263,408
2018,34032,BEZIERS,243400769,CA DE BEZIERS-MEDITERRANEE,34,HERAULT,296,12,308,115,434,20,454,877
2018,34057,CASTELNAU LE LEZ,243400017,MONTPELLIER MEDITERRANEE METROPOLE,34,HERAULT,219,14,233,18,156,28,184,435
2018,34129,LATTES,243400017,MONTPELLIER MEDITERRANEE METROPOLE,34,HERAULT,188,4,192,0,135,9,144,336
2018,34145,LUNEL,243400520,CC DU PAYS DE LUNEL,34,HERAULT,100,4,104,31,269,8,277,412
2018,34172,MONTPELLIER,243400017,MONTPELLIER MEDITERRANEE METROPOLE,34,HERAULT,2631,138,2769,260,1785,265,2050,5079
2018,34270,SAINT JEAN DE VEDAS,243400017,MONTPELLIER MEDITERRANEE METROPOLE,34,HERAULT,70,20,90,1,132,14,146,238
2018,34301,SETE,200066355,CA SETE AGGLOPOLE MEDITERRANEE,34,HERAULT,223,38,261,35,169,16,185,481
2018,35024,BETTON,243500139,RENNES METROPOLE,35,ILLE ET VILAINE,56,31,87,13,230,4,234,334
2018,35047,BRUZ,243500139,RENNES METROPOLE,35,ILLE ET VILAINE,75,29,104,38,291,10,301,443
2018,35051,CESSON SEVIGNE,243500139,RENNES METROPOLE,35,ILLE ET VILAINE,176,17,193,27,254,9,263,483
2018,35281,SAINT JACQUES DE LA LANDE,243500139,RENNES METROPOLE,35,ILLE ET VILAINE,133,14,147,27,200,12,212,385
2018,36088,ISSOUDUN,243600236,CC DU PAYS D'ISSOUDUN,36,INDRE,54,0,54,31,137,0,137,222
2018,37050,CHAMBRAY LES TOURS,243700754,TOURS METROPOLE VAL DE LOIRE,37,INDRE ET LOIRE,103,5,108,0,193,7,200,308
2018,37109,FONDETTES,243700754,TOURS METROPOLE VAL DE LOIRE,37,INDRE ET LOIRE,70,0,70,5,173,12,185,260
2018,37122,JOUE LES TOURS,243700754,TOURS METROPOLE VAL DE LOIRE,37,INDRE ET LOIRE,240,20,260,34,596,14,610,904
2018,37156,MONTLOUIS SUR LOIRE,200073161,CC TOURAINE-EST VALLEES,37,INDRE ET LOIRE,35,1,36,0,248,6,254,290
2018,37208,SAINT AVERTIN,243700754,TOURS METROPOLE VAL DE LOIRE,37,INDRE ET LOIRE,131,4,135,1,201,15,216,352
2018,37214,SAINT CYR SUR LOIRE,243700754,TOURS METROPOLE VAL DE LOIRE,37,INDRE ET LOIRE,77,10,87,3,202,12,214,304
2018,37261,TOURS,243700754,TOURS METROPOLE VAL DE LOIRE,37,INDRE ET LOIRE,1121,124,1245,142,1406,89,1495,2882
2018,38193,L'ISLE D ABEAU,243800604,CA PORTE DE L'ISERE (CAPI),38,ISERE,123,24,147,20,260,5,265,432
2018,38474,SASSENAGE,200040715,GRENOBLE-ALPES-METROPOLE,38,ISERE,88,4,92,0,206,3,209,301
2018,38485,SEYSSINET PARISET,200040715,GRENOBLE-ALPES-METROPOLE,38,ISERE,104,15,119,0,174,5,179,298
2018,38563,VOIRON,243800984,CA DU PAYS VOIRONNAIS,38,ISERE,170,7,177,2,272,13,285,464
2018,39198,DOLE,200010650,CA DU GRAND DOLE,39,JURA,219,0,219,35,232,7,239,493
2018,39300,LONS LE SAUNIER,200071116,CA ECLA  (ESPACE COMMUNAUTAIRE LONS AGGLOMERATION),39,JURA,160,2,162,41,135,3,138,341
2018,40046,BISCARROSSE,244000873,CC DES GRANDS LACS,40,LANDES,84,1,85,0,173,5,178,263
2018,40312,TARNOS,244000659,CC DU SEIGNANX,40,LANDES,60,41,101,6,132,3,135,241
2018,41018,BLOIS,200030385,CA DE BLOIS ''AGGLOPOLYS'',41,LOIR ET CHER,340,0,340,136,460,23,483,959
2018,42044,LE CHAMBON FEUGEROLLES,244200770,SAINT-ETIENNE METROPOLE,42,LOIRE,86,1,87,62,96,1,97,246
2018,42095,FIRMINY,244200770,SAINT-ETIENNE METROPOLE,42,LOIRE,50,15,65,59,161,2,163,287
2018,42147,MONTBRISON,200065886,CA LOIRE FOREZ AGGLOMERATION (LFA),42,LOIRE,111,2,113,0,209,10,219,332
2018,42279,SAINT JUST SAINT RAMBERT,200065886,CA LOIRE FOREZ AGGLOMERATION (LFA),42,LOIRE,96,2,98,10,210,11,221,329
2018,43157,LE PUY EN VELAY,200073419,CA DU PUY-EN-VELAY,43,HAUTE LOIRE,80,2,82,124,170,10,180,386
2018,44020,BOUGUENAIS,244400404,NANTES METROPOLE,44,LOIRE ATLANTIQUE,161,17,178,18,427,9,436,632
2018,44035,LA CHAPELLE SUR ERDRE,244400404,NANTES METROPOLE,44,LOIRE ATLANTIQUE,170,9,179,8,392,24,416,603
2018,44114,ORVAULT,244400404,NANTES METROPOLE,44,LOIRE ATLANTIQUE,184,22,206,18,448,32,480,704
2018,44129,PONTCHATEAU,200000438,CC DU PAYS DE PONTCHATEAU ST-GILDAS-DES-BOIS,44,LOIRE ATLANTIQUE,23,4,27,20,276,7,283,330
2018,44162,SAINT HERBLAIN,244400404,NANTES METROPOLE,44,LOIRE ATLANTIQUE,491,36,527,73,881,31,912,1512
2018,44204,THOUARE SUR LOIRE,244400404,NANTES METROPOLE,44,LOIRE ATLANTIQUE,50,14,64,0,239,4,243,306
2018,44215,VERTOU,244400404,NANTES METROPOLE,44,LOIRE ATLANTIQUE,90,45,135,8,477,23,500,643
2018,45147,FLEURY LES AUBRAIS,244500468,ORLEANS METROPOLE,45,LOIRET,141,18,159,0,322,11,333,492
2018,45232,OLIVET,244500468,ORLEANS METROPOLE,45,LOIRET,236,14,250,13,197,10,207,470
2018,45234,ORLEANS,244500468,ORLEANS METROPOLE,45,LOIRET,1135,91,1226,137,1022,112,1134,2496
2018,45302,SARAN,244500468,ORLEANS METROPOLE,45,LOIRET,182,5,187,0,233,4,237,424
2018,47001,AGEN,200035459,CA D'AGEN,47,LOT ET GARONNE,229,0,229,87,287,5,292,608
2018,49015,AVRILLE,244900015,CU ANGERS LOIRE METROPOLE,49,MAINE ET LOIRE,79,24,103,12,244,10,254,369
2018,49018,BAUGE EN ANJOU,244900882,CC BAUGEOIS VALLEE,49,MAINE ET LOIRE,63,10,73,18,156,6,162,253
2018,49050,BRISSAC LOIRE AUBANCE,200071553,CC LOIRE LAYON AUBANCE,49,MAINE ET LOIRE,48,2,50,2,227,3,230,282
2018,49099,CHOLET,200071678,CA AGGLOMERATION DU CHOLETAIS,49,MAINE ET LOIRE,292,5,297,168,730,21,751,1217
2018,49125,DOUE EN ANJOU,200071876,CA SAUMUR VAL DE LOIRE,49,MAINE ET LOIRE,20,0,20,1,196,3,199,220
2018,49307,LOIRE AUTHION,244900015,CU ANGERS LOIRE METROPOLE,49,MAINE ET LOIRE,30,5,35,40,351,3,354,429
2018,50099,CARENTAN LES MARAIS,200042729,CC DE LA BAIE DU COTENTIN,50,MANCHE,24,0,24,25,159,1,160,210
2018,52121,CHAUMONT,200068658,CA DE CHAUMONT,52,HAUTE MARNE,112,9,121,47,281,3,284,452
2018,53147,MAYENNE,200055887,CC MAYENNE COMMUNAUTE,53,MAYENNE,80,8,88,47,192,2,194,329
2018,54323,LONGWY,245400262,CA DE LONGWY,54,MEURTHE ET MOSELLE,85,0,85,34,61,1,62,181
2018,54395,NANCY,245400676,METROPOLE DU GRAND NANCY,54,MEURTHE ET MOSELLE,1013,46,1059,131,508,113,621,1811
2018,54431,PONT A MOUSSON,200041515,CC DU BASSIN DE PONT-A-MOUSSON,54,MEURTHE ET MOSELLE,50,0,50,26,156,2,158,234
2018,54528,TOUL,200070563,CC TERRES TOULOISES,54,MEURTHE ET MOSELLE,110,0,110,15,199,5,204,329
2018,54547,VANDOEUVRE LES NANCY,245400676,METROPOLE DU GRAND NANCY,54,MEURTHE ET MOSELLE,284,1,285,90,202,15,217,593
2018,55545,VERDUN,200049187,CA DU GRAND VERDUN,55,MEUSE,82,4,86,30,164,7,171,287
2018,56007,AURAY,200043123,CC AURAY QUIBERON TERRE ATLANTIQUE,56,MORBIHAN,45,0,45,73,152,4,156,274
2018,56098,LANESTER,200042174,CA LORIENT AGGLOMERATION,56,MORBIHAN,104,9,113,111,327,6,333,556
2018,56206,SAINT AVE,200067932,CA GOLFE DU MORBIHAN - VANNES AGGLOMERATION,56,MORBIHAN,45,3,48,69,214,12,226,343
2018,57160,CREUTZWALD,245701164,CC DU WARNDT,57,MOSELLE,58,2,60,21,77,2,79,160
2018,57227,FORBACH,245700372,CA DE FORBACH PORTE DE FRANCE,57,MOSELLE,81,0,81,27,95,2,97,205
2018,57433,MAIZIERES LES METZ,200039949,CC RIVES DE MOSELLE,57,MOSELLE,30,3,33,0,237,1,238,271
2018,57447,MARLY,200039865,METZ METROPOLE,57,MOSELLE,25,7,32,0,147,2,149,181
2018,57606,SAINT AVOLD,200067502,CA SAINT-AVOLD SYNERGIE,57,MOSELLE,44,0,44,16,158,2,160,221
2018,57630,SARREBOURG,200068146,CC SARREBOURG MOSELLE SUD,57,MOSELLE,50,2,52,7,161,3,164,223
2018,59008,ANICHE,245901152,CC COEUR D'OSTREVENT (CCCO),59,NORD,19,5,24,35,70,1,71,130
2018,59122,CAMBRAI,200068500,CA DE CAMBRAI,59,NORD,122,6,128,155,302,6,308,591
2018,59163,CROIX,245900410,METROPOLE EUROPEENNE DE LILLE,59,NORD,119,24,143,60,305,14,319,522
2018,59172,DENAIN,200042190,CA DE LA PORTE DU HAINAUT,59,NORD,55,1,56,134,110,3,113,303
2018,59183,DUNKERQUE,245900428,CU DE DUNKERQUE,59,NORD,451,32,483,372,771,28,799,1654
2018,59273,GRAVELINES,245900428,CU DE DUNKERQUE,59,NORD,65,2,67,58,148,3,151,276
2018,59279,HALLUIN,245900410,METROPOLE EUROPEENNE DE LILLE,59,NORD,102,24,126,52,249,4,253,431
2018,59291,HAUTMONT,200043396,CA MAUBEUGE VAL DE SAMBRE,59,NORD,26,0,26,77,80,1,81,184
2018,59295,HAZEBROUCK,200040947,CC DE FLANDRE INTERIEURE,59,NORD,87,0,87,82,314,6,320,489
2018,59324,JEUMONT,200043396,CA MAUBEUGE VAL DE SAMBRE,59,NORD,20,0,20,52,78,1,79,151
2018,59383,MARLY,245901160,CA VALENCIENNES METROPOLE,59,NORD,90,13,103,44,142,1,143,290
2018,59386,MARQUETTE LEZ LILLE,245900410,METROPOLE EUROPEENNE DE LILLE,59,NORD,115,7,122,31,265,3,268,421
2018,59508,RONCQ,245900410,METROPOLE EUROPEENNE DE LILLE,59,NORD,82,10,92,49,153,9,162,303
2018,59512,ROUBAIX,245900410,METROPOLE EUROPEENNE DE LILLE,59,NORD,935,33,968,443,405,32,437,1847
2018,60141,CHANTILLY,246000764,CC DE L'AIRE CANTILIENNE,60,OISE,138,4,142,6,193,7,200,348
2018,60175,CREIL,200068047,CA CREIL SUD OISE,60,OISE,249,4,253,69,175,5,180,502
2018,60176,CREPY EN VALOIS,246000871,CC DU PAYS DE VALOIS,60,OISE,137,9,146,14,236,8,244,404
2018,60395,MERU,246000582,CC DES SABLONS,60,OISE,80,0,80,30,154,2,156,266
2018,60612,SENLIS,200066975,CC SENLIS SUD OISE,60,OISE,144,5,149,25,235,14,249,422
2018,62108,BERCK,200069029,CA DES DEUX BAIES EN MONTREUILLOIS,62,PAS DE CALAIS,136,3,139,32,72,3,75,246
2018,62160,BOULOGNE SUR MER,246200729,CA DU BOULONNAIS,62,PAS DE CALAIS,259,6,265,169,147,8,155,589
2018,62215,CARVIN,246200299,CA D'HENIN-CARVIN,62,PAS DE CALAIS,60,7,67,29,256,4,260,355
2018,62548,MARCK,200090751,CA GRAND CALAIS TERRES ET MERS,62,PAS DE CALAIS,47,0,47,28,105,0,105,180
2018,62765,SAINT OMER,200069037,CA DU PAYS DE SAINT-OMER,62,PAS DE CALAIS,25,4,29,94,118,4,122,245
2018,63014,AUBIERE,246300701,CLERMONT AUVERGNE METROPOLE,63,PUY DE DOME,92,5,97,0,111,4,115,212
2018,63032,BEAUMONT,246300701,CLERMONT AUVERGNE METROPOLE,63,PUY DE DOME,55,26,81,0,159,8,167,247
2018,63284,PONT DU CHATEAU,246300701,CLERMONT AUVERGNE METROPOLE,63,PUY DE DOME,30,20,50,3,235,2,237,289
2018,63300,RIOM,200070753,CA RIOM LIMAGNE ET VOLCANS,63,PUY DE DOME,113,15,128,21,220,9,229,379
2018,63430,THIERS,200070712,CC THIERS DORE ET MONTAGNE,63,PUY DE DOME,15,1,16,18,116,2,118,152
2018,64122,BIARRITZ,200067106,CA DU PAYS BASQUE,64,PYRENEES ATLANTIQUES,170,29,199,23,126,24,150,373
2018,64129,BILLERE,200067254,CA PAU BEARN PYRENEES,64,PYRENEES ATLANTIQUES,94,13,107,10,145,4,149,266
2018,64260,HENDAYE,200067106,CA DU PAYS BASQUE,64,PYRENEES ATLANTIQUES,86,12,98,21,92,5,97,216
2018,66037,CANET EN ROUSSILLON,200027183,CU PERPIGNAN MEDITERRANEE METROPOLE,66,PYRENEES ORIENTALES,79,15,94,0,75,1,76,170
2018,66136,PERPIGNAN,200027183,CU PERPIGNAN MEDITERRANEE METROPOLE,66,PYRENEES ORIENTALES,792,74,866,338,468,30,498,1702
2018,66172,SAINT ESTEVE,200027183,CU PERPIGNAN MEDITERRANEE METROPOLE,66,PYRENEES ORIENTALES,40,14,54,15,117,4,121,190
2018,66180,SAINT LAURENT DE LA SALANQUE,200027183,CU PERPIGNAN MEDITERRANEE METROPOLE,66,PYRENEES ORIENTALES,50,3,53,14,93,1,94,161
2018,67180,HAGUENAU,200067874,CA DE HAGUENAU,67,BAS RHIN,338,87,425,0,220,2,222,646
2018,67204,HOENHEIM,246700488,EUROMETROPOLE DE STRASBOURG,67,BAS RHIN,120,20,140,0,93,5,98,238
2018,67218,ILLKIRCH GRAFFENSTADEN,246700488,EUROMETROPOLE DE STRASBOURG,67,BAS RHIN,380,27,407,0,282,6,288,695
2018,67267,LINGOLSHEIM,246700488,EUROMETROPOLE DE STRASBOURG,67,BAS RHIN,149,24,173,0,200,1,201,374
2018,67437,SAVERNE,200068112,CC DU PAYS DE SAVERNE,67,BAS RHIN,111,15,126,18,89,3,92,236
2018,67447,SCHILTIGHEIM,246700488,EUROMETROPOLE DE STRASBOURG,67,BAS RHIN,397,66,463,83,352,15,367,912
2018,68066,COLMAR,246800726,CA COLMAR AGGLOMERATION,68,HAUT RHIN,664,36,700,52,418,17,435,1187
2018,68375,WITTELSHEIM,200066009,CA MULHOUSE ALSACE AGGLOMERATION,68,HAUT RHIN,40,7,47,0,131,1,132,179
2018,68376,WITTENHEIM,200066009,CA MULHOUSE ALSACE AGGLOMERATION,68,HAUT RHIN,85,4,89,0,113,5,118,207
2018,69027,BRIGNAIS,246900757,CC DE LA VALLEE DU GARON (CCVG),69,RHONE,85,17,102,20,243,1,244,366
2018,69029,BRON,200046977,METROPOLE DE LYON,69,RHONE,381,32,413,88,321,18,339,840
2018,69034,CALUIRE ET CUIRE,200046977,METROPOLE DE LYON,69,RHONE,339,107,446,63,514,69,583,1092
2018,69149,OULLINS,200046977,METROPOLE DE LYON,69,RHONE,204,37,241,28,374,26,400,669
2018,69244,TASSIN LA DEMI LUNE,200046977,METROPOLE DE LYON,69,RHONE,173,74,247,6,280,28,308,561
2018,69266,VILLEURBANNE,200046977,METROPOLE DE LYON,69,RHONE,836,241,1077,449,2076,77,2153,3679
2018,69384,LYON 4E ARRONDISSEMENT,200046977,METROPOLE DE LYON,69,RHONE,382,94,476,31,443,83,526,1033
2018,69386,LYON 6E ARRONDISSEMENT,200046977,METROPOLE DE LYON,69,RHONE,568,178,746,41,408,248,656,1443
2018,69389,LYON 9E ARRONDISSEMENT,200046977,METROPOLE DE LYON,69,RHONE,613,54,667,160,569,64,633,1460
2018,71076,CHALON SUR SAONE,247100589,CA LE GRAND CHALON,71,SAONE ET LOIRE,329,44,373,59,375,12,387,819
2018,71270,MACON,200070308,CA MACONNAIS BEAUJOLAIS AGGLOMERATION,71,SAONE ET LOIRE,261,11,272,63,320,9,329,664
2018,72154,LA FLECHE,247200348,CC DU PAYS FLECHOIS,72,SARTHE,80,0,80,37,215,4,219,336
2018,72264,SABLE SUR SARTHE,247200090,CC DE SABLE-SUR-SARTHE,72,SARTHE,45,0,45,24,156,1,157,226
2018,73011,ALBERTVILLE,200068997,CA ARLYSERE,73,SAVOIE,69,7,76,28,252,4,256,360
2018,74010,ANNECY,200066793,CA DU GRAND ANNECY,74,HAUTE SAVOIE,1245,67,1312,41,1326,83,1409,2761
2018,74042,BONNEVILLE,200000172,CC FAUCIGNY-GLIERES,74,HAUTE SAVOIE,52,19,71,0,210,1,211,282
2018,74133,GAILLARD,200011773,CA ANNEMASSE-LES VOIRONS-AGGLOMERATION,74,HAUTE SAVOIE,101,0,101,24,85,1,86,211
2018,74281,THONON LES BAINS,200067551,CA THONON AGGLOMERATION,74,HAUTE SAVOIE,165,16,181,1,396,13,409,590
2018,75101,PARIS 1ER ARRONDISSEMENT,200054781,METROPOLE DU GRAND PARIS,75,PARIS,234,1,235,11,24,103,127,373
2018,75103,PARIS 3E ARRONDISSEMENT,200054781,METROPOLE DU GRAND PARIS,75,PARIS,648,19,667,11,50,180,230,908
2018,75104,PARIS 4E ARRONDISSEMENT,200054781,METROPOLE DU GRAND PARIS,75,PARIS,602,3,605,21,33,99,132,758
2018,75106,PARIS 6E ARRONDISSEMENT,200054781,METROPOLE DU GRAND PARIS,75,PARIS,591,8,599,8,22,221,243,850
2018,75109,PARIS 9E ARRONDISSEMENT,200054781,METROPOLE DU GRAND PARIS,75,PARIS,1089,85,1174,3,101,644,745,1922
2018,75116,PARIS 16E ARRONDISSEMENT,200054781,METROPOLE DU GRAND PARIS,75,PARIS,1548,187,1735,73,75,1244,1319,3128
2018,76114,BOLBEC,200010700,CA CAUX SEINE AGGLO,76,SEINE MARITIME,38,2,40,37,162,3,165,243
2018,76451,MONT SAINT AIGNAN,200023414,METROPOLE ROUEN NORMANDIE,76,SEINE MARITIME,258,17,275,8,176,28,204,486
2018,76476,PORT JEROME SUR SEINE,200010700,CA CAUX SEINE AGGLO,76,SEINE MARITIME,30,3,33,0,211,1,212,244
2018,76498,LE PETIT QUEVILLY,200023414,METROPOLE ROUEN NORMANDIE,76,SEINE MARITIME,114,13,127,68,332,7,339,533
2018,77014,AVON,200072346,CA DU PAYS DE FONTAINEBLEAU,77,SEINE ET MARNE,78,6,84,2,189,3,192,277
2018,77058,BUSSY SAINT GEORGES,247700594,CA MARNE ET GONDOIRE,77,SEINE ET MARNE,370,15,385,17,241,5,246,648
2018,77122,COMBS LA VILLE,200059228,CA GRAND PARIS SUD SEINE ESSONNE SENART,77,SEINE ET MARNE,163,1,164,24,354,6,360,548
2018,77131,COULOMMIERS,200090504,CA COULOMMIERS PAYS DE BRIE,77,SEINE ET MARNE,147,5,152,20,165,1,166,339
2018,77186,FONTAINEBLEAU,200072346,CA DU PAYS DE FONTAINEBLEAU,77,SEINE ET MARNE,99,13,112,12,121,10,131,255
2018,77294,MITRY MORY,200055655,CA ROISSY PAYS DE FRANCE,77,SEINE ET MARNE,40,0,40,0,299,1,300,340
2018,77296,MOISSY CRAMAYEL,200059228,CA GRAND PARIS SUD SEINE ESSONNE SENART,77,SEINE ET MARNE,105,7,112,20,293,2,295,427
2018,77307,MONTEVRAIN,247700594,CA MARNE ET GONDOIRE,77,SEINE ET MARNE,116,23,139,0,214,4,218,357
2018,77316,MORET LOING ET ORVANNE,247700032,CC MORET SEINE ET LOING,77,SEINE ET MARNE,185,1,186,0,172,4,176,362
2018,77333,NEMOURS,200023240,CC PAYS DE NEMOURS,77,SEINE ET MARNE,0,6,6,0,184,3,187,192
2018,77350,OZOIR LA FERRIERE,200023125,CC LES PORTES BRIARDES ENTRE VILLES ET FORETS,77,SEINE ET MARNE,160,5,165,6,246,5,251,422
2018,77445,SAVIGNY LE TEMPLE,200059228,CA GRAND PARIS SUD SEINE ESSONNE SENART,77,SEINE ET MARNE,250,3,253,47,334,7,341,641
2018,78073,BOIS D ARCY,247800584,CA VERSAILLES GRAND PARC (CAVGP),78,YVELINES,222,6,228,0,175,16,191,419
2018,78126,LA CELLE SAINT CLOUD,247800584,CA VERSAILLES GRAND PARC (CAVGP),78,YVELINES,248,11,259,0,150,39,189,448
2018,78158,LE CHESNAY ROCQUENCOURT,247800584,CA VERSAILLES GRAND PARC (CAVGP),78,YVELINES,486,15,501,12,142,39,181,694
2018,78165,LES CLAYES SOUS BOIS,200058782,CA DE SAINT QUENTIN EN YVELINES,78,YVELINES,153,26,179,24,212,11,223,427
2018,78297,GUYANCOURT,200058782,CA DE SAINT QUENTIN EN YVELINES,78,YVELINES,668,6,674,212,331,8,339,1225
2018,78311,HOUILLES,200058519,CA SAINT GERMAIN BOUCLES DE SEINE,78,YVELINES,287,87,374,0,515,59,574,948
2018,78335,LIMAY,200059889,CU GRAND PARIS SEINE ET OISE,78,YVELINES,165,14,179,0,219,1,220,399
2018,78358,MAISONS LAFFITTE,200058519,CA SAINT GERMAIN BOUCLES DE SEINE,78,YVELINES,335,68,403,0,122,96,218,621
2018,78362,MANTES LA VILLE,200059889,CU GRAND PARIS SEINE ET OISE,78,YVELINES,100,55,155,0,214,3,217,372
2018,78372,MARLY LE ROI,200058519,CA SAINT GERMAIN BOUCLES DE SEINE,78,YVELINES,232,13,245,8,178,22,200,453
2018,78383,MAUREPAS,200058782,CA DE SAINT QUENTIN EN YVELINES,78,YVELINES,220,1,221,13,215,5,220,454
2018,78418,MONTESSON,200058519,CA SAINT GERMAIN BOUCLES DE SEINE,78,YVELINES,195,5,200,2,119,30,149,351
2018,78490,PLAISIR,200058782,CA DE SAINT QUENTIN EN YVELINES,78,YVELINES,243,58,301,28,346,16,362,691
2018,78498,POISSY,200059889,CU GRAND PARIS SEINE ET OISE,78,YVELINES,604,43,647,20,350,25,375,1042
2018,78517,RAMBOUILLET,200073344,CA RAMBOUILLET TERRITOIRES,78,YVELINES,282,6,288,0,274,18,292,580
2018,78640,VELIZY VILLACOUBLAY,247800584,CA VERSAILLES GRAND PARC (CAVGP),78,YVELINES,555,9,564,0,237,9,246,809
2018,78643,VERNOUILLET,200059889,CU GRAND PARIS SEINE ET OISE,78,YVELINES,82,11,93,17,92,5,97,207
2018,78650,LE VESINET,200058519,CA SAINT GERMAIN BOUCLES DE SEINE,78,YVELINES,233,5,238,20,48,63,111,369
2018,78686,VIROFLAY,247800584,CA VERSAILLES GRAND PARC (CAVGP),78,YVELINES,222,29,251,0,78,72,150,401
2018,78688,VOISINS LE BRETONNEUX,200058782,CA DE SAINT QUENTIN EN YVELINES,78,YVELINES,110,2,112,3,125,4,129,244
2018,79191,NIORT,200041317,CA DU NIORTAIS,79,DEUX SEVRES,409,0,409,98,645,32,677,1184
2018,80001,ABBEVILLE,200070993,CA DE LA BAIE DE SOMME,80,SOMME,54,9,63,64,316,5,321,448
2018,81004,ALBI,248100737,CA DE L'ALBIGEOIS (C2A),81,TARN,399,49,448,38,250,22,272,759
2018,81065,CASTRES,248100430,CA DE CASTRES MAZAMET,81,TARN,293,36,329,71,189,25,214,614
2018,82033,CASTELSARRASIN,200066322,CC TERRES DES CONFLUENCES,82,TARN ET GARONNE,90,0,90,13,129,0,129,232
2018,83047,LA CRAU,248300543,METROPOLE TOULON-PROVENCE-MEDITERRANEE,83,VAR,97,9,106,0,217,10,227,332
2018,83049,CUERS,200027100,CC MEDITERRANEE PORTE DES MAURES,83,VAR,50,2,52,0,168,8,176,228
2018,83061,FREJUS,200035319,CA VAR ESTEREL MEDITERRANEE (CAVEM),83,VAR,378,16,394,24,334,22,356,774
2018,83069,HYERES,248300543,METROPOLE TOULON-PROVENCE-MEDITERRANEE,83,VAR,393,26,419,10,311,25,336,765
2018,83071,LA LONDE LES MAURES,200027100,CC MEDITERRANEE PORTE DES MAURES,83,VAR,80,0,80,0,52,2,54,134
2018,83090,OLLIOULES,248300543,METROPOLE TOULON-PROVENCE-MEDITERRANEE,83,VAR,94,24,118,2,115,6,121,241
2018,83137,TOULON,248300543,METROPOLE TOULON-PROVENCE-MEDITERRANEE,83,VAR,1305,74,1379,337,969,180,1149,2865
2018,84007,AVIGNON,248400251,CA DU GRAND AVIGNON (COGA),84,VAUCLUSE,797,98,895,73,395,43,438,1406
2018,84019,BOLLENE,200000628,CC RHONE LEZ PROVENCE,84,VAUCLUSE,70,2,72,45,117,4,121,238
2018,84035,CAVAILLON,200040442,CA LUBERON MONTS DE VAUCLUSE,84,VAUCLUSE,215,2,217,0,132,4,136,353
2018,84054,L'ISLE SUR LA SORGUE,248400319,CC DU PAYS DES SORGUES ET DES MONTS DE VAUCLUSE,84,VAUCLUSE,105,7,112,0,134,7,141,253
2018,84080,MONTEUX,248400293,CC DES SORGUES DU COMTAT,84,VAUCLUSE,71,6,77,0,167,3,170,247
2018,84092,LE PONTET,248400251,CA DU GRAND AVIGNON (COGA),84,VAUCLUSE,67,14,81,0,158,4,162,244
2018,85092,FONTENAY LE COMTE,200071934,CC DU PAYS DE FONTENAY-VENDEE,85,VENDEE,24,0,24,16,177,2,179,219
2018,85194,LES SABLES D OLONNE,200071165,CA LES SABLES D'OLONNE AGGLOMERATION,85,VENDEE,100,29,129,48,447,13,460,637
2018,85226,SAINT HILAIRE DE RIEZ,200023778,CC DU PAYS DE SAINT GILLES-CROIX-DE-VIE,85,VENDEE,35,1,36,23,168,1,169,228
2018,86066,CHATELLERAULT,248600413,CA GRAND CHATELLERAULT,86,VIENNE,125,0,125,87,261,5,266,478
2018,87085,LIMOGES,248719312,CU LIMOGES METROPOLE,87,HAUTE VIENNE,948,48,996,183,905,70,975,2153
2018,87114,PANAZOL,248719312,CU LIMOGES METROPOLE,87,HAUTE VIENNE,38,8,46,0,132,7,139,185
2018,88413,SAINT DIE DES VOSGES,200071066,CA DE SAINT-DIE-DES-VOSGES,88,VOSGES,126,0,126,57,155,1,156,339
2018,89024,AUXERRE,200067114,CA DE L'AUXERROIS,89,YONNE,324,4,328,41,412,6,418,787
2018,91021,ARPAJON,200057859,CA COEUR D'ESSONNE AGGLOMERATION,91,ESSONNE,90,4,94,11,113,2,115,220
2018,91027,ATHIS MONS,200054781,METROPOLE DU GRAND PARIS,91,ESSONNE,312,7,319,53,388,8,396,768
2018,91114,BRUNOY,200058477,CA VAL D'YERRES VAL DE SEINE,91,ESSONNE,270,4,274,0,261,12,273,547
2018,91161,CHILLY MAZARIN,200056232,CA COMMUNAUTE PARIS-SACLAY,91,ESSONNE,258,0,258,0,274,2,276,534
2018,91272,GIF SUR YVETTE,200056232,CA COMMUNAUTE PARIS-SACLAY,91,ESSONNE,216,0,216,4,184,12,196,416
2018,91377,MASSY,200056232,CA COMMUNAUTE PARIS-SACLAY,91,ESSONNE,853,22,875,10,706,35,741,1626
2018,91386,MENNECY,249100546,CC DU VAL D'ESSONNE (CCVE),91,ESSONNE,80,2,82,0,162,6,168,250
2018,91432,MORANGIS,200054781,METROPOLE DU GRAND PARIS,91,ESSONNE,125,1,126,0,184,2,186,313
2018,91471,ORSAY,200056232,CA COMMUNAUTE PARIS-SACLAY,91,ESSONNE,202,3,205,0,96,12,108,313
2018,91521,RIS ORANGIS,200059228,CA GRAND PARIS SUD SEINE ESSONNE SENART,91,ESSONNE,311,5,316,19,320,9,329,663
2018,91570,SAINT MICHEL SUR ORGE,200057859,CA COEUR D'ESSONNE AGGLOMERATION,91,ESSONNE,156,7,163,1,292,6,298,462
2018,91573,SAINT PIERRE DU PERRAY,200059228,CA GRAND PARIS SUD SEINE ESSONNE SENART,91,ESSONNE,97,5,102,0,235,3,238,340
2018,91657,VIGNEUX SUR SEINE,200058477,CA VAL D'YERRES VAL DE SEINE,91,ESSONNE,228,4,232,0,361,16,377,609
2018,91661,VILLEBON SUR YVETTE,200056232,CA COMMUNAUTE PARIS-SACLAY,91,ESSONNE,240,8,248,0,63,6,69,317
2018,92009,BOIS COLOMBES,200054781,METROPOLE DU GRAND PARIS,92,HAUTS DE SEINE,401,87,488,0,201,150,351,839
2018,92012,BOULOGNE BILLANCOURT,200054781,METROPOLE DU GRAND PARIS,92,HAUTS DE SEINE,2334,167,2501,90,534,968,1502,4094
2018,92023,CLAMART,200054781,METROPOLE DU GRAND PARIS,92,HAUTS DE SEINE,656,64,720,51,320,150,470,1241
2018,92025,COLOMBES,200054781,METROPOLE DU GRAND PARIS,92,HAUTS DE SEINE,1193,69,1262,52,633,275,908,2221
2018,92051,NEUILLY SUR SEINE,200054781,METROPOLE DU GRAND PARIS,92,HAUTS DE SEINE,770,25,795,18,28,597,625,1438
2018,92060,LE PLESSIS ROBINSON,200054781,METROPOLE DU GRAND PARIS,92,HAUTS DE SEINE,463,7,470,13,287,50,337,820
2018,92062,PUTEAUX,200054781,METROPOLE DU GRAND PARIS,92,HAUTS DE SEINE,954,26,980,17,332,224,556,1553
2018,92075,VANVES,200054781,METROPOLE DU GRAND PARIS,92,HAUTS DE SEINE,315,4,319,5,174,74,248,572
2018,92077,VILLE D AVRAY,200054781,METROPOLE DU GRAND PARIS,92,HAUTS DE SEINE,171,0,171,0,72,25,97,268
2018,92078,VILLENEUVE LA GARENNE,200054781,METROPOLE DU GRAND PARIS,92,HAUTS DE SEINE,354,1,355,32,81,11,92,478
2018,93005,AULNAY SOUS BOIS,200054781,METROPOLE DU GRAND PARIS,93,SEINE SAINT DENIS,745,17,762,115,361,27,388,1265
2018,93006,BAGNOLET,200054781,METROPOLE DU GRAND PARIS,93,SEINE SAINT DENIS,361,18,379,34,174,39,213,626
2018,93007,LE BLANC MESNIL,200054781,METROPOLE DU GRAND PARIS,93,SEINE SAINT DENIS,322,5,327,21,178,15,193,540
2018,93008,BOBIGNY,200054781,METROPOLE DU GRAND PARIS,93,SEINE SAINT DENIS,588,0,588,69,167,21,188,845
2018,93027,LA COURNEUVE,200054781,METROPOLE DU GRAND PARIS,93,SEINE SAINT DENIS,336,3,339,53,124,9,133,525
2018,93030,DUGNY,200054781,METROPOLE DU GRAND PARIS,93,SEINE SAINT DENIS,80,0,80,0,80,4,84,164
2018,93048,MONTREUIL,200054781,METROPOLE DU GRAND PARIS,93,SEINE SAINT DENIS,1287,97,1384,72,648,406,1054,2511
2018,93049,NEUILLY PLAISANCE,200054781,METROPOLE DU GRAND PARIS,93,SEINE SAINT DENIS,162,14,176,0,152,14,166,343
2018,93050,NEUILLY SUR MARNE,200054781,METROPOLE DU GRAND PARIS,93,SEINE SAINT DENIS,399,4,403,40,332,19,351,795
2018,93051,NOISY LE GRAND,200054781,METROPOLE DU GRAND PARIS,93,SEINE SAINT DENIS,662,8,670,65,622,28,650,1385
2018,93059,PIERREFITTE SUR SEINE,200054781,METROPOLE DU GRAND PARIS,93,SEINE SAINT DENIS,220,4,224,20,112,6,118,362
2018,93070,SAINT OUEN SUR SEINE,200054781,METROPOLE DU GRAND PARIS,93,SEINE SAINT DENIS,592,40,632,36,395,121,516,1184
2018,93078,VILLEPINTE,200054781,METROPOLE DU GRAND PARIS,93,SEINE SAINT DENIS,264,1,265,0,190,5,195,460
2018,94011,BONNEUIL SUR MARNE,200054781,METROPOLE DU GRAND PARIS,94,VAL DE MARNE,150,1,151,87,118,3,121,359
2018,94021,CHEVILLY LARUE,200054781,METROPOLE DU GRAND PARIS,94,VAL DE MARNE,236,5,241,0,176,8,184,424
2018,94028,CRETEIL,200054781,METROPOLE DU GRAND PARIS,94,VAL DE MARNE,1501,13,1514,77,422,45,467,2058
2018,94034,FRESNES,200054781,METROPOLE DU GRAND PARIS,94,VAL DE MARNE,280,27,307,0,262,21,283,590
2018,94044,LIMEIL BREVANNES,200054781,METROPOLE DU GRAND PARIS,94,VAL DE MARNE,307,7,314,18,313,7,320,652
2018,94054,ORLY,200054781,METROPOLE DU GRAND PARIS,94,VAL DE MARNE,240,4,244,80,161,7,168,492
2018,94058,LE PERREUX SUR MARNE,200054781,METROPOLE DU GRAND PARIS,94,VAL DE MARNE,397,37,434,4,247,97,344,782
2018,94067,SAINT MANDE,200054781,METROPOLE DU GRAND PARIS,94,VAL DE MARNE,455,36,491,1,42,201,243,735
2018,94071,SUCY EN BRIE,200054781,METROPOLE DU GRAND PARIS,94,VAL DE MARNE,160,10,170,0,204,14,218,388
2018,94073,THIAIS,200054781,METROPOLE DU GRAND PARIS,94,VAL DE MARNE,385,26,411,11,198,10,208,630
2018,94075,VILLECRESNES,200054781,METROPOLE DU GRAND PARIS,94,VAL DE MARNE,36,17,53,3,114,7,121,177
2018,94076,VILLEJUIF,200054781,METROPOLE DU GRAND PARIS,94,VAL DE MARNE,668,20,688,74,396,30,426,1187
2018,95203,EAUBONNE,200058485,CA VAL PARISIS,95,VAL D OISE,274,13,287,0,357,17,374,661
2018,95252,FRANCONVILLE,200058485,CA VAL PARISIS,95,VAL D OISE,310,5,315,0,488,21,509,824
2018,95280,GOUSSAINVILLE,200055655,CA ROISSY PAYS DE FRANCE,95,VAL D OISE,111,1,112,26,197,5,202,340
2018,95323,JOUY LE MOUTIER,249500109,CA DE CERGY-PONTOISE,95,VAL D OISE,132,9,141,0,244,3,247,388
2018,95572,SAINT OUEN L AUMONE,249500109,CA DE CERGY-PONTOISE,95,VAL D OISE,236,21,257,30,290,8,298,585
2018,95598,SOISY SOUS MONTMORENCY,200056380,CA PLAINE VALLEE,95,VAL D OISE,92,11,103,4,211,10,221,328
2018,95637,VAUREAL,249500109,CA DE CERGY-PONTOISE,95,VAL D OISE,113,7,120,0,243,1,244,365
2018,97101,LES ABYMES,200018653,CA CAP EXCELLENCE,971,GUADELOUPE,473,28,501,164,249,7,256,921
2018,97115,LAMENTIN,249710062,CA DU NORD BASSE-TERRE,971,GUADELOUPE,56,16,72,30,98,9,107,209
2018,97125,SAINT FRANCOIS,200041507,CA LA RIVIERA DU LEVANT,971,GUADELOUPE,53,29,82,40,83,1,84,205
2018,97210,LE FRANCOIS,249720053,CA DE L'ESPACE SUD DE LA MARTINIQUE,972,MARTINIQUE,123,23,146,53,53,5,58,257
2018,97224,SAINT JOSEPH,249720061,CA DU CENTRE DE LA MARTINIQUE,972,MARTINIQUE,112,38,150,79,22,4,26,255
2018,97401,LES AVIRONS,249740077,CA CIVIS (COMMUNAUTE INTERCOMMUNALE DES VILLES SOLIDAIRES),974,LA REUNION,0,58,58,6,96,7,103,167
2018,97405,PETITE ILE,249740077,CA CIVIS (COMMUNAUTE INTERCOMMUNALE DES VILLES SOLIDAIRES),974,LA REUNION,55,30,85,16,38,4,42,143
2019,01322,REYRIEUX,200042497,CC DOMBES SAONE VALLEE,01,AIN,35,1,36,6,91,3,94,137
2019,02722,SOISSONS,240200477,CA GRANDSOISSONS AGGLOMERATION,02,AISNE,141,31,172,81,251,3,254,507
2019,04112,MANOSQUE,200034700,CA DURANCE-LUBERON-VERDON AGGLOMERATION,04,ALPES DE HAUTE PROVENCE,164,11,175,15,161,2,163,353
2019,06004,ANTIBES,240600585,CA DE SOPHIA ANTIPOLIS,06,ALPES MARITIMES,480,48,528,19,724,34,758,1305
2019,06029,CANNES,200039915,CA CANNES PAYS DE LERINS,06,ALPES MARITIMES,732,50,782,27,245,35,280,1089
2019,06079,MANDELIEU LA NAPOULE,200039915,CA CANNES PAYS DE LERINS,06,ALPES MARITIMES,216,18,234,2,123,14,137,373
2019,06083,MENTON,240600551,CA DE LA RIVIERA FRANCAISE,06,ALPES MARITIMES,175,0,175,6,223,9,232,413
2019,06085,MOUGINS,200039915,CA CANNES PAYS DE LERINS,06,ALPES MARITIMES,276,27,303,0,140,14,154,457
2019,06088,NICE,200030195,METROPOLE NICE COTE D'AZUR,06,ALPES MARITIMES,3065,136,3201,343,1789,169,1958,5501
2019,06123,SAINT LAURENT DU VAR,200030195,METROPOLE NICE COTE D'AZUR,06,ALPES MARITIMES,249,34,283,0,351,11,362,645
2019,06149,LA TRINITE,200030195,METROPOLE NICE COTE D'AZUR,06,ALPES MARITIMES,83,3,86,3,63,3,66,155
2019,07019,AUBENAS,200073245,CC DU BASSIN D'AUBENAS,07,ARDECHE,80,0,80,20,68,5,73,173
2019,10323,ROMILLY SUR SEINE,200000545,CC DES PORTES DE ROMILLY SUR SEINE,10,AUBE,55,0,55,30,148,2,150,235
2019,11206,LIMOUX,200071926,CC DU LIMOUXIN,11,AUDE,55,0,55,31,50,1,51,137
2019,12145,MILLAU,241200567,CC DE MILLAU GRANDS CAUSSES,12,AVEYRON,121,0,121,59,208,2,210,390
2019,12176,ONET LE CHATEAU,241200187,CA RODEZ AGGLOMERATION,12,AVEYRON,55,18,73,33,150,1,151,257
2019,13002,ALLAUCH,200054807,METROPOLE D'AIX-MARSEILLE-PROVENCE,13,BOUCHES DU RHONE,181,17,198,0,181,8,189,387
2019,13005,AUBAGNE,200054807,METROPOLE D'AIX-MARSEILLE-PROVENCE,13,BOUCHES DU RHONE,330,22,352,18,410,12,422,792
2019,13014,BERRE L ETANG,200054807,METROPOLE D'AIX-MARSEILLE-PROVENCE,13,BOUCHES DU RHONE,72,3,75,10,60,2,62,146
2019,13015,BOUC BEL AIR,200054807,METROPOLE D'AIX-MARSEILLE-PROVENCE,13,BOUCHES DU RHONE,129,23,152,7,169,7,176,335
2019,13026,CHATEAUNEUF LES MARTIGUES,200054807,METROPOLE D'AIX-MARSEILLE-PROVENCE,13,BOUCHES DU RHONE,125,36,161,4,178,7,185,350
2019,13027,CHATEAURENARD,200035087,CA TERRE DE PROVENCE,13,BOUCHES DU RHONE,66,18,84,0,171,7,178,261
2019,13063,MIRAMAS,200054807,METROPOLE D'AIX-MARSEILLE-PROVENCE,13,BOUCHES DU RHONE,162,3,165,37,146,7,153,355
2019,13081,ROGNAC,200054807,METROPOLE D'AIX-MARSEILLE-PROVENCE,13,BOUCHES DU RHONE,81,9,90,0,134,5,139,228
2019,13103,SALON DE PROVENCE,200054807,METROPOLE D'AIX-MARSEILLE-PROVENCE,13,BOUCHES DU RHONE,352,42,394,0,382,37,419,813
2019,13201,MARSEILLE 1ER ARRONDISSEMENT,200054807,METROPOLE D'AIX-MARSEILLE-PROVENCE,13,BOUCHES DU RHONE,359,35,394,17,136,35,171,581
2019,13202,MARSEILLE 2E ARRONDISSEMENT,200054807,METROPOLE D'AIX-MARSEILLE-PROVENCE,13,BOUCHES DU RHONE,309,17,326,64,67,14,81,471
2019,13204,MARSEILLE 4E ARRONDISSEMENT,200054807,METROPOLE D'AIX-MARSEILLE-PROVENCE,13,BOUCHES DU RHONE,409,60,469,12,347,36,383,864
2019,13205,MARSEILLE 5E ARRONDISSEMENT,200054807,METROPOLE D'AIX-MARSEILLE-PROVENCE,13,BOUCHES DU RHONE,583,96,679,0,324,32,356,1035
2019,13208,MARSEILLE 8E ARRONDISSEMENT,200054807,METROPOLE D'AIX-MARSEILLE-PROVENCE,13,BOUCHES DU RHONE,776,169,945,8,574,207,781,1734
2019,13209,MARSEILLE 9E ARRONDISSEMENT,200054807,METROPOLE D'AIX-MARSEILLE-PROVENCE,13,BOUCHES DU RHONE,907,77,984,30,485,65,550,1564
2019,13210,MARSEILLE 10E ARRONDISSEMENT,200054807,METROPOLE D'AIX-MARSEILLE-PROVENCE,13,BOUCHES DU RHONE,358,71,429,40,349,29,378,847
2019,13214,MARSEILLE 14E ARRONDISSEMENT,200054807,METROPOLE D'AIX-MARSEILLE-PROVENCE,13,BOUCHES DU RHONE,377,17,394,145,165,17,182,720
2019,13216,MARSEILLE 16E ARRONDISSEMENT,200054807,METROPOLE D'AIX-MARSEILLE-PROVENCE,13,BOUCHES DU RHONE,232,16,248,40,56,7,63,351
2019,14118,CAEN,200065597,CU CAEN LA MER,14,CALVADOS,1091,56,1147,209,691,75,766,2122
2019,14341,IFS,200065597,CU CAEN LA MER,14,CALVADOS,58,13,71,0,201,1,202,273
2019,14366,LISIEUX,200069532,CA LISIEUX NORMANDIE,14,CALVADOS,97,1,98,49,272,4,276,423
2019,14762,VIRE NORMANDIE,200068799,CC INTERCOM DE LA VIRE AU NOIREAU,14,CALVADOS,45,0,45,29,267,3,270,344
2019,16015,ANGOULEME,200071827,CA DU GRAND ANGOULEME,16,CHARENTE,348,9,357,62,195,16,211,631
2019,17306,ROYAN,241700640,CA ROYAN ATLANTIQUE,17,CHARENTE MARITIME,49,0,49,25,103,5,108,182
2019,17415,SAINTES,200036473,CA DE SAINTES,17,CHARENTE MARITIME,144,0,144,23,306,13,319,486
2019,18033,BOURGES,241800507,CA BOURGES PLUS,18,CHER,267,12,279,92,748,13,761,1132
2019,18279,VIERZON,200090561,CC VIERZON-SOLOGNE-BERRY ET VILLAGES DE LA FORET,18,CHER,75,0,75,37,271,1,272,384
2019,19031,BRIVE LA GAILLARDE,200043172,CA DU BASSIN DE BRIVE,19,CORREZE,362,1,363,100,289,43,332,795
2019,19272,TULLE,241927201,CA TULLE AGGLO,19,CORREZE,153,2,155,45,70,4,74,274
2019,21231,DIJON,242100410,DIJON METROPOLE,21,COTE D OR,1634,157,1791,185,1013,112,1125,3101
2019,21617,TALANT,242100410,DIJON METROPOLE,21,COTE D OR,126,11,137,16,103,1,104,257
2019,22187,PLERIN,200069409,CA SAINT-BRIEUC ARMOR AGGLOMERATION,22,COTES D ARMOR,109,4,113,47,207,6,213,373
2019,24037,BERGERAC,200070647,CA BERGERACOISE,24,DORDOGNE,155,0,155,61,184,6,190,406
2019,24053,BOULAZAC ISLE MANOIRE,200040392,CA LE GRAND PERIGUEUX,24,DORDOGNE,83,3,86,5,114,5,119,210
2019,25388,MONTBELIARD,200065647,CA PAYS DE MONTBELIARD AGGLOMERATION,25,DOUBS,159,1,160,66,149,4,153,380
2019,25462,PONTARLIER,242500338,CC DU GRAND PONTARLIER,25,DOUBS,123,18,141,0,209,2,211,353
2019,26235,PIERRELATTE,200042901,CC DROME SUD PROVENCE,26,DROME,50,6,56,17,178,3,181,254
2019,26362,VALENCE,200068781,CA VALENCE ROMANS AGGLO,26,DROME,713,28,741,156,453,45,498,1395
2019,27701,VAL DE REUIL,200089456,CA SEINE-EURE,27,EURE,115,0,115,49,122,3,125,289
2019,28085,CHARTRES,200033181,CA CHARTRES METROPOLE,28,EURE ET LOIR,365,15,380,25,399,31,430,835
2019,29019,BREST,242900314,BREST METROPOLE,29,FINISTERE,1033,34,1067,424,1426,120,1546,3037
2019,29151,MORLAIX,242900835,CA MORLAIX COMMUNAUTE,29,FINISTERE,130,0,130,36,112,5,117,283
2019,29233,QUIMPERLE,242900694,CA QUIMPERLE COMMUNAUTE,29,FINISTERE,43,0,43,42,188,0,188,273
2019,30028,BAGNOLS SUR CEZE,200034692,CA DU GARD RHODANIEN,30,GARD,112,0,112,39,83,5,88,239
2019,30189,NIMES,243000643,CA DE NIMES METROPOLE,30,GARD,1150,7,1157,187,603,116,719,2063
2019,30258,SAINT GILLES,243000643,CA DE NIMES METROPOLE,30,GARD,41,1,42,46,127,0,127,216
2019,31149,COLOMIERS,243100518,TOULOUSE METROPOLE,31,HAUTE GARONNE,397,5,402,17,410,21,431,851
2019,31506,SAINT ORENS DE GAMEVILLE,243100518,TOULOUSE METROPOLE,31,HAUTE GARONNE,101,11,112,0,145,14,159,271
2019,32013,AUCH,200066926,CA GRAND AUCH COEUR DE GASCOGNE,32,GERS,186,0,186,52,220,6,226,464
2019,33075,BRUGES,243300316,BORDEAUX METROPOLE,33,GIRONDE,253,20,273,0,288,11,299,572
2019,33199,GUJAN MESTRAS,243300563,CA BASSIN D'ARCACHON SUD-POLE ATLANTIQUE (COBAS),33,GIRONDE,108,7,115,1,220,6,226,342
2019,33200,LE HAILLAN,243300316,BORDEAUX METROPOLE,33,GIRONDE,140,7,147,0,159,3,162,309
2019,33249,LORMONT,243300316,BORDEAUX METROPOLE,33,GIRONDE,166,9,175,49,238,23,261,484
2019,33519,LE TAILLAN MEDOC,243300316,BORDEAUX METROPOLE,33,GIRONDE,41,23,64,5,192,4,196,265
2019,33529,LA TESTE DE BUCH,243300563,CA BASSIN D'ARCACHON SUD-POLE ATLANTIQUE (COBAS),33,GIRONDE,124,13,137,12,269,12,281,430
2019,34057,CASTELNAU LE LEZ,243400017,MONTPELLIER MEDITERRANEE METROPOLE,34,HERAULT,219,13,232,5,156,46,202,440
2019,34145,LUNEL,243400520,CC DU PAYS DE LUNEL,34,HERAULT,95,2,97,32,251,7,258,388
2019,34154,MAUGUIO,243400470,CA DU PAYS DE L'OR,34,HERAULT,150,3,153,4,186,12,198,355
2019,34270,SAINT JEAN DE VEDAS,243400017,MONTPELLIER MEDITERRANEE METROPOLE,34,HERAULT,70,29,99,2,142,10,152,254
2019,35024,BETTON,243500139,RENNES METROPOLE,35,ILLE ET VILAINE,56,31,87,21,233,6,239,347
2019,35093,DINARD,243500725,CC COTE D'EMERAUDE,35,ILLE ET VILAINE,38,1,39,10,62,2,64,113
2019,35115,FOUGERES,200072452,CA FOUGERES AGGLOMERATION,35,ILLE ET VILAINE,84,18,102,58,226,5,231,391
2019,35281,SAINT JACQUES DE LA LANDE,243500139,RENNES METROPOLE,35,ILLE ET VILAINE,126,11,137,21,193,8,201,359
2019,37050,CHAMBRAY LES TOURS,243700754,TOURS METROPOLE VAL DE LOIRE,37,INDRE ET LOIRE,103,6,109,0,195,5,200,309
2019,37122,JOUE LES TOURS,243700754,TOURS METROPOLE VAL DE LOIRE,37,INDRE ET LOIRE,229,21,250,36,586,13,599,885
2019,37156,MONTLOUIS SUR LOIRE,200073161,CC TOURAINE-EST VALLEES,37,INDRE ET LOIRE,40,3,43,0,229,5,234,277
2019,37208,SAINT AVERTIN,243700754,TOURS METROPOLE VAL DE LOIRE,37,INDRE ET LOIRE,124,2,126,0,215,8,223,350
2019,37214,SAINT CYR SUR LOIRE,243700754,TOURS METROPOLE VAL DE LOIRE,37,INDRE ET LOIRE,77,11,88,7,193,6,199,294
2019,38193,L'ISLE D ABEAU,243800604,CA PORTE DE L'ISERE (CAPI),38,ISERE,123,29,152,14,278,1,279,445
2019,38317,LE PONT DE CLAIX,200040715,GRENOBLE-ALPES-METROPOLE,38,ISERE,122,2,124,45,155,2,157,326
2019,38382,SAINT EGREVE,200040715,GRENOBLE-ALPES-METROPOLE,38,ISERE,209,6,215,2,252,8,260,477
2019,38421,SAINT MARTIN D HERES,200040715,GRENOBLE-ALPES-METROPOLE,38,ISERE,268,37,305,29,461,6,467,800
2019,38544,VIENNE,200077014,CA VIENNE CONDRIEU,38,ISERE,179,25,204,36,449,9,458,699
2019,38563,VOIRON,243800984,CA DU PAYS VOIRONNAIS,38,ISERE,166,17,183,4,255,13,268,455
2019,39198,DOLE,200010650,CA DU GRAND DOLE,39,JURA,189,0,189,31,216,6,222,442
2019,39300,LONS LE SAUNIER,200071116,CA ECLA  (ESPACE COMMUNAUTAIRE LONS AGGLOMERATION),39,JURA,160,3,163,43,127,3,130,336
2019,40192,MONT DE MARSAN,244000808,CA MONT DE MARSAN AGGLOMERATION,40,LANDES,176,4,180,23,364,5,369,572
2019,40279,SAINT PAUL LES DAX,244000675,CA DU GRAND DAX,40,LANDES,60,5,65,0,131,1,132,197
2019,41018,BLOIS,200030385,CA DE BLOIS ''AGGLOPOLYS'',41,LOIR ET CHER,340,8,348,100,473,17,490,938
2019,41194,ROMORANTIN LANTHENAY,200018406,CC DU ROMORANTINAIS ET DU MONESTOIS,41,LOIR ET CHER,85,0,85,30,203,0,203,318
2019,42279,SAINT JUST SAINT RAMBERT,200065886,CA LOIRE FOREZ AGGLOMERATION (LFA),42,LOIRE,111,4,115,12,199,8,207,334
2019,44026,CARQUEFOU,244400404,NANTES METROPOLE,44,LOIRE ATLANTIQUE,183,6,189,22,349,22,371,581
2019,44035,LA CHAPELLE SUR ERDRE,244400404,NANTES METROPOLE,44,LOIRE ATLANTIQUE,170,11,181,7,361,20,381,570
2019,44047,COUERON,244400404,NANTES METROPOLE,44,LOIRE ATLANTIQUE,104,39,143,0,546,15,561,704
2019,44114,ORVAULT,244400404,NANTES METROPOLE,44,LOIRE ATLANTIQUE,184,29,213,20,411,34,445,679
2019,44129,PONTCHATEAU,200000438,CC DU PAYS DE PONTCHATEAU ST-GILDAS-DES-BOIS,44,LOIRE ATLANTIQUE,23,5,28,18,299,7,306,352
2019,44131,PORNIC,200067346,CA PORNIC AGGLO PAYS DE RETZ,44,LOIRE ATLANTIQUE,35,9,44,11,223,9,232,286
2019,44190,SAINT SEBASTIEN SUR LOIRE,244400404,NANTES METROPOLE,44,LOIRE ATLANTIQUE,126,24,150,4,510,21,531,685
2019,45155,GIEN,244500211,CC GIENNOISES,45,LOIRET,80,9,89,21,130,2,132,242
2019,45208,MONTARGIS,244500203,CA MONTARGOISE ET RIVES DU LOING (AME),45,LOIRET,131,2,133,28,75,5,80,241
2019,45232,OLIVET,244500468,ORLEANS METROPOLE,45,LOIRET,236,28,264,10,206,9,215,489
2019,45234,ORLEANS,244500468,ORLEANS METROPOLE,45,LOIRET,1134,109,1243,122,983,95,1078,2443
2019,45302,SARAN,244500468,ORLEANS METROPOLE,45,LOIRET,182,9,191,0,225,6,231,421
2019,47157,MARMANDE,200030674,CA VAL DE GARONNE AGGLOMERATION,47,LOT ET GARONNE,136,0,136,8,140,4,144,288
2019,49018,BAUGE EN ANJOU,244900882,CC BAUGEOIS VALLEE,49,MAINE ET LOIRE,63,10,73,15,166,1,167,255
2019,49050,BRISSAC LOIRE AUBANCE,200071553,CC LOIRE LAYON AUBANCE,49,MAINE ET LOIRE,48,1,49,3,220,0,220,272
2019,49125,DOUE EN ANJOU,200071876,CA SAUMUR VAL DE LOIRE,49,MAINE ET LOIRE,20,0,20,4,186,4,190,214
2019,49331,SEGRE EN ANJOU BLEU,244900809,CC ANJOU BLEU COMMUNAUTE,49,MAINE ET LOIRE,69,1,70,39,286,4,290,399
2019,50025,AVRANCHES,200069425,CA MONT-SAINT-MICHEL-NORMANDIE,50,MANCHE,45,0,45,34,115,0,115,194
2019,50099,CARENTAN LES MARAIS,200042729,CC DE LA BAIE DU COTENTIN,50,MANCHE,23,0,23,22,151,3,154,199
2019,50129,CHERBOURG EN COTENTIN,200067205,CA DU COTENTIN,50,MANCHE,571,0,571,179,989,37,1026,1776
2019,50502,SAINT LO,200066389,CA SAINT-LO AGGLO,50,MANCHE,90,13,103,39,250,3,253,395
2019,52121,CHAUMONT,200068658,CA DE CHAUMONT,52,HAUTE MARNE,112,14,126,26,268,4,272,424
2019,53062,CHATEAU GONTIER SUR MAYENNE,245300447,CC DU PAYS DE CHATEAU-GONTIER,53,MAYENNE,75,0,75,36,341,10,351,462
2019,53130,LAVAL,200083392,CA LAVAL AGGLOMERATION,53,MAYENNE,345,25,370,101,508,34,542,1013
2019,53147,MAYENNE,200055887,CC MAYENNE COMMUNAUTE,53,MAYENNE,80,7,87,44,161,0,161,292
2019,54304,LAXOU,245400676,METROPOLE DU GRAND NANCY,54,MEURTHE ET MOSELLE,194,4,198,19,64,2,66,284
2019,54395,NANCY,245400676,METROPOLE DU GRAND NANCY,54,MEURTHE ET MOSELLE,1019,48,1067,121,446,96,542,1730
2019,54482,SAINT MAX,245400676,METROPOLE DU GRAND NANCY,54,MEURTHE ET MOSELLE,34,7,41,0,94,7,101,142
2019,54547,VANDOEUVRE LES NANCY,245400676,METROPOLE DU GRAND NANCY,54,MEURTHE ET MOSELLE,284,4,288,80,199,12,211,579
2019,54578,VILLERS LES NANCY,245400676,METROPOLE DU GRAND NANCY,54,MEURTHE ET MOSELLE,45,2,47,12,148,5,153,212
2019,55545,VERDUN,200049187,CA DU GRAND VERDUN,55,MEUSE,82,17,99,34,146,6,152,285
2019,56121,LORIENT,200042174,CA LORIENT AGGLOMERATION,56,MORBIHAN,288,10,298,258,546,25,571,1127
2019,56162,PLOEMEUR,200042174,CA LORIENT AGGLOMERATION,56,MORBIHAN,100,9,109,64,173,9,182,354
2019,57221,FLORANGE,245701222,CA DU VAL DE FENSCH,57,MOSELLE,35,9,44,26,100,0,100,170
2019,57240,FREYMING MERLEBACH,245700398,CC DE FREYMING-MERLEBACH,57,MOSELLE,0,1,1,24,107,1,108,134
2019,57306,HAYANGE,245701222,CA DU VAL DE FENSCH,57,MOSELLE,55,8,63,0,118,2,120,184
2019,57433,MAIZIERES LES METZ,200039949,CC RIVES DE MOSELLE,57,MOSELLE,30,1,31,0,216,2,218,249
2022,37122,JOUE LES TOURS,243700754,TOURS METROPOLE VAL DE LOIRE,37,INDRE ET LOIRE,229,44,273,38,577,2,579,889
2022,38151,ECHIROLLES,200040715,GRENOBLE-ALPES-METROPOLE,38,ISERE,311,37,348,71,336,12,348,767
2022,38169,FONTAINE,200040715,GRENOBLE-ALPES-METROPOLE,38,ISERE,140,18,158,19,253,11,264,441
2022,38485,SEYSSINET PARISET,200040715,GRENOBLE-ALPES-METROPOLE,38,ISERE,99,19,118,0,146,7,153,272
2022,38563,VOIRON,243800984,CA DU PAYS VOIRONNAIS,38,ISERE,150,27,177,0,271,4,275,452
2022,42095,FIRMINY,244200770,SAINT-ETIENNE METROPOLE,42,LOIRE,65,13,78,11,137,1,138,227
2022,42184,RIORGES,200035731,CA ROANNAIS AGGLOMERATION,42,LOIRE,42,6,48,4,149,5,154,205
2022,44020,BOUGUENAIS,244400404,NANTES METROPOLE,44,LOIRE ATLANTIQUE,161,35,196,19,372,6,378,594
2022,44055,LA BAULE ESCOUBLAC,244400610,CA DE LA PRESQU'ILE DE GUERANDE ATLANTIQUE (CAP ATLANTIQUE),44,LOIRE ATLANTIQUE,60,6,66,10,104,8,112,188
2022,44154,SAINT BREVIN LES PINS,244400586,CC DU SUD ESTUAIRE,44,LOIRE ATLANTIQUE,42,13,55,4,165,10,175,233
2022,44172,SAINTE LUCE SUR LOIRE,244400404,NANTES METROPOLE,44,LOIRE ATLANTIQUE,122,15,137,0,291,9,300,437
2022,44184,SAINT NAZAIRE,244400644,CA DE LA REGION NAZAIRIENNE ET DE L'ESTUAIRE (CARENE),44,LOIRE ATLANTIQUE,380,66,446,174,714,56,770,1390
2022,44204,THOUARE SUR LOIRE,244400404,NANTES METROPOLE,44,LOIRE ATLANTIQUE,50,23,73,0,198,3,201,274
2022,45004,AMILLY,244500203,CA MONTARGOISE ET RIVES DU LOING (AME),45,LOIRET,70,10,80,0,170,3,173,254
2022,45068,CHALETTE SUR LOING,244500203,CA MONTARGOISE ET RIVES DU LOING (AME),45,LOIRET,99,7,106,53,83,2,85,244
2022,45155,GIEN,244500211,CC GIENNOISES,45,LOIRET,80,6,86,19,120,0,120,224
2022,45232,OLIVET,244500468,ORLEANS METROPOLE,45,LOIRET,224,42,266,14,178,11,189,469
2022,45285,SAINT JEAN DE LA RUELLE,244500468,ORLEANS METROPOLE,45,LOIRET,120,15,135,33,218,8,226,393
2022,45302,SARAN,244500468,ORLEANS METROPOLE,45,LOIRET,182,13,195,0,264,11,275,470
2022,47001,AGEN,200096956,CA AGGLOMERATION D'AGEN,47,LOT ET GARONNE,229,1,230,56,273,11,284,570
2022,47323,VILLENEUVE SUR LOT,200023307,CA DU GRAND VILLENEUVOIS,47,LOT ET GARONNE,147,0,147,50,181,4,185,382
2022,48095,MENDE,244800405,CC COEUR DE LOZERE,48,LOZERE,112,0,112,43,104,1,105,260
2022,49007,ANGERS,244900015,CU ANGERS LOIRE METROPOLE,49,MAINE ET LOIRE,1121,246,1367,202,1214,129,1343,2912
2022,49328,SAUMUR,200071876,CA SAUMUR VAL DE LOIRE,49,MAINE ET LOIRE,160,34,194,74,204,23,227,495
2022,49353,TRELAZE,244900015,CU ANGERS LOIRE METROPOLE,49,MAINE ET LOIRE,84,62,146,60,337,8,345,551
2022,50041,LA HAGUE,200067205,CA DU COTENTIN,50,MANCHE,22,0,22,14,200,6,206,242
2022,53062,CHATEAU GONTIER SUR MAYENNE,245300447,CC DU PAYS DE CHATEAU-GONTIER,53,MAYENNE,75,1,76,28,298,10,308,412
2022,53130,LAVAL,200083392,CA LAVAL AGGLOMERATION,53,MAYENNE,345,61,406,113,490,24,514,1033
2022,54304,LAXOU,245400676,METROPOLE DU GRAND NANCY,54,MEURTHE ET MOSELLE,199,15,214,22,51,13,64,300
2022,54395,NANCY,245400676,METROPOLE DU GRAND NANCY,54,MEURTHE ET MOSELLE,1004,106,1110,113,385,97,482,1705
2022,54431,PONT A MOUSSON,200041515,CC DU BASSIN DE PONT-A-MOUSSON,54,MEURTHE ET MOSELLE,50,2,52,26,133,2,135,213
2022,54578,VILLERS LES NANCY,245400676,METROPOLE DU GRAND NANCY,54,MEURTHE ET MOSELLE,45,18,63,15,141,3,144,222
2022,55029,BAR LE DUC,200033025,CA DE BAR-LE-DUC - SUD MEUSE,55,MEUSE,131,1,132,38,121,2,123,293
2022,56078,GUIDEL,200042174,CA LORIENT AGGLOMERATION,56,MORBIHAN,30,13,43,46,133,12,145,234
2022,56121,LORIENT,200042174,CA LORIENT AGGLOMERATION,56,MORBIHAN,299,35,334,256,482,33,515,1105
2022,56206,SAINT AVE,200067932,CA GOLFE DU MORBIHAN - VANNES AGGLOMERATION,56,MORBIHAN,45,7,52,60,196,10,206,318
2022,56260,VANNES,200067932,CA GOLFE DU MORBIHAN - VANNES AGGLOMERATION,56,MORBIHAN,419,51,470,225,272,78,350,1045
2022,57206,FAMECK,245701222,CA DU VAL DE FENSCH,57,MOSELLE,50,26,76,37,94,0,94,206
2022,57227,FORBACH,245700372,CA DE FORBACH PORTE DE FRANCE,57,MOSELLE,47,0,47,40,99,0,99,186
2022,57447,MARLY,200039865,METZ METROPOLE,57,MOSELLE,25,29,54,0,106,1,107,161
2022,57463,METZ,200039865,METZ METROPOLE,57,MOSELLE,1155,132,1287,66,746,39,785,2138
2022,57480,MONTIGNY LES METZ,200039865,METZ METROPOLE,57,MOSELLE,90,21,111,0,237,6,243,354
2022,57672,THIONVILLE,245701362,CA PORTES DE FRANCE-THIONVILLE,57,MOSELLE,238,85,323,5,260,13,273,601
2022,59011,ANNOEULLIN,200093201,METROPOLE EUROPEENNE DE LILLE,59,NORD,54,20,74,12,161,6,167,252
2022,59017,ARMENTIERES,200093201,METROPOLE EUROPEENNE DE LILLE,59,NORD,101,53,154,100,242,4,246,500
2022,59043,BAILLEUL,200040947,CC DE FLANDRE INTERIEURE,59,NORD,75,19,94,50,199,0,199,343
2022,59172,DENAIN,200042190,CA DE LA PORTE DU HAINAUT,59,NORD,55,2,57,98,108,2,110,264
2022,59183,DUNKERQUE,245900428,CU DE DUNKERQUE,59,NORD,414,84,498,304,685,18,703,1505
2022,59220,FACHES THUMESNIL,200093201,METROPOLE EUROPEENNE DE LILLE,59,NORD,130,35,165,23,261,11,272,460
2022,59273,GRAVELINES,245900428,CU DE DUNKERQUE,59,NORD,64,13,77,64,135,4,139,280
2022,59295,HAZEBROUCK,200040947,CC DE FLANDRE INTERIEURE,59,NORD,87,6,93,68,264,6,270,431
2022,59328,LAMBERSART,200093201,METROPOLE EUROPEENNE DE LILLE,59,NORD,205,148,353,40,280,46,326,720
2022,59350,LILLE,200093201,METROPOLE EUROPEENNE DE LILLE,59,NORD,2170,563,2733,614,1633,177,1810,5157
2022,59367,LYS LEZ LANNOY,200093201,METROPOLE EUROPEENNE DE LILLE,59,NORD,44,38,82,47,167,2,169,299
2022,59368,LA MADELEINE,200093201,METROPOLE EUROPEENNE DE LILLE,59,NORD,191,107,298,38,183,48,231,567
2022,59392,MAUBEUGE,200043396,CA MAUBEUGE VAL DE SAMBRE,59,NORD,94,2,96,139,124,2,126,361
2022,59410,MONS EN BAROEUL,200093201,METROPOLE EUROPEENNE DE LILLE,59,NORD,140,18,158,77,234,10,244,479
2022,59507,RONCHIN,200093201,METROPOLE EUROPEENNE DE LILLE,59,NORD,102,76,178,21,221,3,224,423
2022,59512,ROUBAIX,200093201,METROPOLE EUROPEENNE DE LILLE,59,NORD,950,93,1043,358,401,28,429,1830
2022,59526,SAINT AMAND LES EAUX,200042190,CA DE LA PORTE DU HAINAUT,59,NORD,80,21,101,32,188,5,193,327
2022,59599,TOURCOING,200093201,METROPOLE EUROPEENNE DE LILLE,59,NORD,548,216,764,353,767,26,793,1910
2022,59616,VIEUX CONDE,245901160,CA VALENCIENNES METROPOLE,59,NORD,25,1,26,33,59,3,62,122
2022,59650,WATTRELOS,200093201,METROPOLE EUROPEENNE DE LILLE,59,NORD,184,58,242,127,429,7,436,805
2022,60395,MERU,246000582,CC DES SABLONS,60,OISE,80,4,84,32,160,1,161,277
2022,60463,NOGENT SUR OISE,200068047,CA CREIL SUD OISE,60,OISE,103,5,108,47,156,4,160,315
2022,60471,NOYON,246000756,CC DU PAYS NOYONNAIS,60,OISE,122,0,122,42,85,2,87,251
2022,61169,FLERS,200035814,CA FLERS AGGLO,61,ORNE,66,6,72,32,103,3,106,210
2022,62065,AVION,246200364,CA DE LENS - LIEVIN,62,PAS DE CALAIS,24,30,54,59,142,1,143,255
2022,62160,BOULOGNE SUR MER,246200729,CA DU BOULONNAIS,62,PAS DE CALAIS,276,10,286,137,126,14,140,563
2022,62193,CALAIS,200090751,CA GRAND CALAIS TERRES ET MERS,62,PAS DE CALAIS,378,17,395,277,363,16,379,1051
2022,62498,LENS,246200364,CA DE LENS - LIEVIN,62,PAS DE CALAIS,115,52,167,145,147,3,150,461
2022,62510,LIEVIN,246200364,CA DE LENS - LIEVIN,62,PAS DE CALAIS,155,57,212,75,180,3,183,470
2022,62587,MONTIGNY EN GOHELLE,246200299,CA D'HENIN-CARVIN,62,PAS DE CALAIS,30,16,46,36,81,0,81,163
2022,63032,BEAUMONT,246300701,CLERMONT AUVERGNE METROPOLE,63,PUY DE DOME,44,26,70,0,130,4,134,203
2022,63113,CLERMONT FERRAND,246300701,CLERMONT AUVERGNE METROPOLE,63,PUY DE DOME,981,97,1078,103,1169,86,1255,2435
2022,63284,PONT DU CHATEAU,246300701,CLERMONT AUVERGNE METROPOLE,63,PUY DE DOME,30,26,56,5,239,4,243,304
2022,64024,ANGLET,200067106,CA DU PAYS BASQUE,64,PYRENEES ATLANTIQUES,145,110,255,26,383,27,410,691
2022,64129,BILLERE,200067254,CA PAU BEARN PYRENEES,64,PYRENEES ATLANTIQUES,94,6,100,0,147,6,153,253
2022,64422,OLORON SAINTE MARIE,200067262,CC DU HAUT BEARN,64,PYRENEES ATLANTIQUES,91,1,92,25,58,0,58,175
2022,65440,TARBES,200069300,CA TARBES-LOURDES-PYRENEES,65,HAUTES PYRENEES,315,22,337,83,157,17,174,594
2022,67067,BRUMATH,200067874,CA DE HAGUENAU,67,BAS RHIN,89,38,127,0,112,0,112,239
2022,67180,HAGUENAU,200067874,CA DE HAGUENAU,67,BAS RHIN,266,160,426,0,226,4,230,656
2022,67218,ILLKIRCH GRAFFENSTADEN,246700488,EUROMETROPOLE DE STRASBOURG,67,BAS RHIN,389,53,442,0,207,7,214,656
2022,67267,LINGOLSHEIM,246700488,EUROMETROPOLE DE STRASBOURG,67,BAS RHIN,184,70,254,0,184,10,194,448
2022,67462,SELESTAT,246700967,CC DE SELESTAT,67,BAS RHIN,147,70,217,0,122,4,126,343
2022,68066,COLMAR,246800726,CA COLMAR AGGLOMERATION,68,HAUT RHIN,705,52,757,30,329,12,341,1128
2022,68154,ILLZACH,200066009,CA MULHOUSE ALSACE AGGLOMERATION,68,HAUT RHIN,85,4,89,14,64,1,65,168
2022,68166,KINGERSHEIM,200066009,CA MULHOUSE ALSACE AGGLOMERATION,68,HAUT RHIN,60,6,66,0,110,2,112,178
2022,69277,GENAS,246900575,CC DE L'EST LYONNAIS (CCEL),69D,RHONE,144,31,175,2,153,15,168,344
2022,69089,FRANCHEVILLE,200046977,METROPOLE DE LYON,69M,RHONE,159,85,244,0,134,5,139,383
2022,69244,TASSIN LA DEMI LUNE,200046977,METROPOLE DE LYON,69M,RHONE,131,91,222,4,235,14,249,474
2022,69256,VAULX EN VELIN,200046977,METROPOLE DE LYON,69M,RHONE,420,35,455,194,328,21,349,998
2022,69275,DECINES CHARPIEU,200046977,METROPOLE DE LYON,69M,RHONE,179,81,260,35,314,12,326,621
2022,69283,MIONS,200046977,METROPOLE DE LYON,69M,RHONE,59,31,90,0,221,6,227,317
2022,69290,SAINT PRIEST,200046977,METROPOLE DE LYON,69M,RHONE,567,80,647,17,557,13,570,1235
2022,69382,LYON 2E ARRONDISSEMENT,200046977,METROPOLE DE LYON,69M,RHONE,386,124,510,8,226,112,338,856
2022,69383,LYON 3E ARRONDISSEMENT,200046977,METROPOLE DE LYON,69M,RHONE,1401,288,1689,19,886,200,1086,2795
2022,69384,LYON 4E ARRONDISSEMENT,200046977,METROPOLE DE LYON,69M,RHONE,408,127,535,8,384,61,445,987
2022,69385,LYON 5E ARRONDISSEMENT,200046977,METROPOLE DE LYON,69M,RHONE,451,103,554,36,330,58,388,978
2022,69388,LYON 8E ARRONDISSEMENT,200046977,METROPOLE DE LYON,69M,RHONE,949,101,1050,174,644,80,724,1948
2022,69389,LYON 9E ARRONDISSEMENT,200046977,METROPOLE DE LYON,69M,RHONE,631,65,696,139,443,94,537,1371
2022,70285,HERICOURT,247000722,CC DU PAYS D'HERICOURT,70,HAUTE SAONE,35,8,43,15,124,1,125,182
2022,71076,CHALON SUR SAONE,247100589,CA LE GRAND CHALON,71,SAONE ET LOIRE,322,84,406,84,272,18,290,780
2022,71270,MACON,200070308,CA MACONNAIS BEAUJOLAIS AGGLOMERATION,71,SAONE ET LOIRE,286,19,305,42,255,8,263,610
2022,72181,LE MANS,247200132,CU LE MANS METROPOLE,72,SARTHE,632,74,706,226,1902,101,2003,2935
2022,74012,ANNEMASSE,200011773,CA ANNEMASSE-LES VOIRONS-AGGLOMERATION,74,HAUTE SAVOIE,186,13,199,36,367,9,376,611
2022,74225,RUMILLY,247400740,CC RUMILLY TERRE DE SAVOIE,74,HAUTE SAVOIE,128,42,170,1,184,3,187,357
2022,74281,THONON LES BAINS,200067551,CA THONON AGGLOMERATION,74,HAUTE SAVOIE,165,31,196,0,385,15,400,596
2022,75101,PARIS 1ER ARRONDISSEMENT,200054781,METROPOLE DU GRAND PARIS,75,PARIS,338,3,341,8,27,74,101,450
2022,75109,PARIS 9E ARRONDISSEMENT,200054781,METROPOLE DU GRAND PARIS,75,PARIS,1200,112,1312,11,70,507,577,1900
2022,75110,PARIS 10E ARRONDISSEMENT,200054781,METROPOLE DU GRAND PARIS,75,PARIS,1933,184,2117,21,185,536,721,2859
2022,75112,PARIS 12E ARRONDISSEMENT,200054781,METROPOLE DU GRAND PARIS,75,PARIS,2998,290,3288,22,388,448,836,4147
2022,75114,PARIS 14E ARRONDISSEMENT,200054781,METROPOLE DU GRAND PARIS,75,PARIS,2393,198,2591,43,281,338,619,3253
2022,75115,PARIS 15E ARRONDISSEMENT,200054781,METROPOLE DU GRAND PARIS,75,PARIS,4066,466,4532,94,365,1176,1541,6167
2022,75116,PARIS 16E ARRONDISSEMENT,200054781,METROPOLE DU GRAND PARIS,75,PARIS,1590,384,1974,140,68,1268,1336,3450
2022,75117,PARIS 17E ARRONDISSEMENT,200054781,METROPOLE DU GRAND PARIS,75,PARIS,2486,549,3035,36,372,1507,1879,4950
2022,75118,PARIS 18E ARRONDISSEMENT,200054781,METROPOLE DU GRAND PARIS,75,PARIS,3670,374,4044,63,376,904,1280,5388
2022,76114,BOLBEC,200010700,CA CAUX SEINE AGGLO,76,SEINE MARITIME,38,4,42,17,143,5,148,207
2022,76157,CANTELEU,200023414,METROPOLE ROUEN NORMANDIE,76,SEINE MARITIME,157,11,168,20,129,3,132,319
2022,76259,FECAMP,200069821,CA FECAMP CAUX LITTORAL AGGLOMERATION,76,SEINE MARITIME,126,10,136,24,143,2,145,305
2022,76322,LE GRAND QUEVILLY,200023414,METROPOLE ROUEN NORMANDIE,76,SEINE MARITIME,127,20,147,17,383,6,389,553
2022,76351,LE HAVRE,200084952,CU LE HAVRE SEINE METROPOLE,76,SEINE MARITIME,920,235,1155,132,1709,82,1791,3078
2022,76447,MONTIVILLIERS,200084952,CU LE HAVRE SEINE METROPOLE,76,SEINE MARITIME,40,25,65,0,238,9,247,312
2022,76451,MONT SAINT AIGNAN,200023414,METROPOLE ROUEN NORMANDIE,76,SEINE MARITIME,285,37,322,1,131,27,158,482
2022,76498,LE PETIT QUEVILLY,200023414,METROPOLE ROUEN NORMANDIE,76,SEINE MARITIME,114,37,151,24,263,4,267,442
2022,76575,SAINT ETIENNE DU ROUVRAY,200023414,METROPOLE ROUEN NORMANDIE,76,SEINE MARITIME,121,21,142,67,360,6,366,574
2022,76758,YVETOT,247600620,CC YVETOT NORMANDIE,76,SEINE MARITIME,62,13,75,8,193,5,198,282
2022,77053,BRIE COMTE ROBERT,247700644,CC L'OREE DE LA BRIE,77,SEINE ET MARNE,164,4,168,13,266,6,272,453
2022,77083,CHAMPS SUR MARNE,200057958,CA PARIS - VALLEE DE LA MARNE,77,SEINE ET MARNE,280,9,289,0,190,4,194,483
2022,77118,CLAYE SOUILLY,200055655,CA ROISSY PAYS DE FRANCE,77,SEINE ET MARNE,30,5,35,0,152,7,159,194
2022,77122,COMBS LA VILLE,200059228,CA GRAND PARIS SUD SEINE ESSONNE SENART,77,SEINE ET MARNE,161,6,167,19,302,7,309,494
2022,77243,LAGNY SUR MARNE,247700594,CA MARNE ET GONDOIRE,77,SEINE ET MARNE,96,24,120,2,270,8,278,400
2022,77251,LIEUSAINT,200059228,CA GRAND PARIS SUD SEINE ESSONNE SENART,77,SEINE ET MARNE,110,14,124,0,243,4,247,371
2022,77285,LE MEE SUR SEINE,247700057,CA MELUN VAL DE SEINE,77,SEINE ET MARNE,179,3,182,63,178,6,184,429
2022,77307,MONTEVRAIN,247700594,CA MARNE ET GONDOIRE,77,SEINE ET MARNE,156,26,182,0,193,5,198,380
2022,77316,MORET LOING ET ORVANNE,247700032,CC MORET SEINE ET LOING,77,SEINE ET MARNE,152,10,162,0,141,6,147,308
2022,77373,PONTAULT COMBAULT,200057958,CA PARIS - VALLEE DE LA MARNE,77,SEINE ET MARNE,175,28,203,18,533,12,545,766
2022,77379,PROVINS,200037133,CC DU PROVINOIS,77,SEINE ET MARNE,100,13,113,38,71,3,74,225
2022,77390,ROISSY EN BRIE,200057958,CA PARIS - VALLEE DE LA MARNE,77,SEINE ET MARNE,156,14,170,17,237,4,241,428
2022,77468,TORCY,200057958,CA PARIS - VALLEE DE LA MARNE,77,SEINE ET MARNE,294,30,324,13,216,13,229,566
2022,78029,AUBERGENVILLE,200059889,CU GRAND PARIS SEINE ET OISE,78,YVELINES,85,32,117,0,99,3,102,219
2022,78073,BOIS D ARCY,247800584,CA VERSAILLES GRAND PARC (CAVGP),78,YVELINES,222,12,234,0,148,6,154,387
2022,78126,LA CELLE SAINT CLOUD,247800584,CA VERSAILLES GRAND PARC (CAVGP),78,YVELINES,273,25,298,5,129,21,150,453
2022,78146,CHATOU,200058519,CA SAINT GERMAIN BOUCLES DE SEINE,78,YVELINES,453,29,482,10,221,103,324,817
2022,78242,FONTENAY LE FLEURY,247800584,CA VERSAILLES GRAND PARC (CAVGP),78,YVELINES,156,24,180,0,143,17,160,340
2022,78311,HOUILLES,200058519,CA SAINT GERMAIN BOUCLES DE SEINE,78,YVELINES,320,142,462,0,433,68,501,964
2022,78358,MAISONS LAFFITTE,200058519,CA SAINT GERMAIN BOUCLES DE SEINE,78,YVELINES,347,93,440,0,96,94,190,630
2022,78440,LES MUREAUX,200059889,CU GRAND PARIS SEINE ET OISE,78,YVELINES,258,51,309,76,154,11,165,550
2022,78490,PLAISIR,200058782,CA DE SAINT QUENTIN EN YVELINES,78,YVELINES,214,112,326,41,331,15,346,713
2022,78621,TRAPPES,200058782,CA DE SAINT QUENTIN EN YVELINES,78,YVELINES,250,34,284,91,290,10,300,675
2022,78646,VERSAILLES,247800584,CA VERSAILLES GRAND PARC (CAVGP),78,YVELINES,1136,195,1331,64,493,356,849,2245
2022,78650,LE VESINET,200058519,CA SAINT GERMAIN BOUCLES DE SEINE,78,YVELINES,213,16,229,29,57,63,120,377
2022,78688,VOISINS LE BRETONNEUX,200058782,CA DE SAINT QUENTIN EN YVELINES,78,YVELINES,95,14,109,0,85,7,92,200
2022,79049,BRESSUIRE,200040244,CA DU BOCAGE BRESSUIRAIS,79,DEUX SEVRES,70,14,84,12,285,3,288,384
2022,81099,GAILLAC,200066124,CA GAILLAC-GRAULHET,81,TARN,62,11,73,13,153,2,155,240
2022,82033,CASTELSARRASIN,200066322,CC TERRES DES CONFLUENCES,82,TARN ET GARONNE,95,9,104,5,117,0,117,226
2022,83050,DRAGUIGNAN,248300493,CA DRACENIE PROVENCE VERDON AGGLOMERATION,83,VAR,236,12,248,16,302,26,328,591
2022,83098,LE PRADET,248300543,METROPOLE TOULON-PROVENCE-MEDITERRANEE,83,VAR,76,11,87,0,90,2,92,178
2022,83115,SAINTE MAXIME,200036077,CC DU GOLFE DE SAINT-TROPEZ,83,VAR,135,0,135,0,55,4,59,194
2022,83116,SAINT MAXIMIN LA SAINTE BAUME,200068104,CA DE LA PROVENCE VERTE,83,VAR,146,22,168,1,182,4,186,356
2022,83118,SAINT RAPHAEL,200035319,CA ESTEREL COTE D'AZUR AGGLOMERATION,83,VAR,237,17,254,14,138,13,151,419
2022,83123,SANARY SUR MER,248300394,CA SUD SAINTE BAUME,83,VAR,112,25,137,0,95,6,101,238
2022,83137,TOULON,248300543,METROPOLE TOULON-PROVENCE-MEDITERRANEE,83,VAR,1212,129,1341,243,963,188,1151,2734
2022,84003,APT,200040624,CC PAYS D'APT-LUBERON,84,VAUCLUSE,80,0,80,36,70,2,72,189
2022,84019,BOLLENE,200000628,CC RHONE LEZ PROVENCE,84,VAUCLUSE,70,17,87,33,102,2,104,224
2022,84054,L'ISLE SUR LA SORGUE,248400319,CC DU PAYS DES SORGUES ET DES MONTS DE VAUCLUSE,84,VAUCLUSE,105,12,117,0,153,5,158,275
2022,84141,VEDENE,248400251,CA DU GRAND AVIGNON (COGA),84,VAUCLUSE,65,35,100,0,153,2,155,256
2022,85047,CHALLANS,200071629,CC CHALLANS-GOIS COMMUNAUTE,85,VENDEE,62,18,80,40,372,5,377,498
2022,85226,SAINT HILAIRE DE RIEZ,200023778,CA DU PAYS DE SAINT-GILLES-CROIX-DE-VIE,85,VENDEE,35,4,39,11,163,1,164,214
2022,86194,POITIERS,200069854,CU DU GRAND POITIERS,86,VIENNE,701,13,714,74,510,46,556,1344
2022,87085,LIMOGES,248719312,CU LIMOGES METROPOLE,87,HAUTE VIENNE,896,70,966,139,704,80,784,1889
2022,87114,PANAZOL,248719312,CU LIMOGES METROPOLE,87,HAUTE VIENNE,38,17,55,0,128,8,136,192
2022,89387,SENS,248900334,CA DU GRAND SENONAIS,89,YONNE,262,0,262,0,172,9,181,443
2022,90010,BELFORT,200069052,CA GRAND BELFORT,90,TERRITOIRE DE BELFORT,339,17,356,114,246,17,263,733
2022,91027,ATHIS MONS,200054781,METROPOLE DU GRAND PARIS,91,ESSONNE,303,37,340,54,397,20,417,811
2022,91086,BONDOUFLE,200059228,CA GRAND PARIS SUD SEINE ESSONNE SENART,91,ESSONNE,110,24,134,1,154,4,158,292
2022,91161,CHILLY MAZARIN,200056232,CA COMMUNAUTE PARIS-SACLAY,91,ESSONNE,198,17,215,0,212,3,215,430
2022,91200,DOURDAN,249100595,CC LE DOURDANNAIS EN HUREPOIX (CCDH),91,ESSONNE,70,13,83,15,128,0,128,226
2022,91223,ETAMPES,200017846,CA ETAMPOIS SUD ESSONNE,91,ESSONNE,207,21,228,17,227,12,239,485
2022,91286,GRIGNY,200059228,CA GRAND PARIS SUD SEINE ESSONNE SENART,91,ESSONNE,192,2,194,145,147,6,153,492
2022,91345,LONGJUMEAU,200056232,CA COMMUNAUTE PARIS-SACLAY,91,ESSONNE,215,23,238,3,241,9,250,491
2022,91386,MENNECY,249100546,CC DU VAL D'ESSONNE (CCVE),91,ESSONNE,100,9,109,0,188,8,196,305
2022,91421,MONTGERON,200058477,CA VAL D'YERRES VAL DE SEINE,91,ESSONNE,182,13,195,15,255,14,269,479
2022,91570,SAINT MICHEL SUR ORGE,200057859,CA COEUR D'ESSONNE AGGLOMERATION,91,ESSONNE,123,30,153,1,264,3,267,421
2022,91661,VILLEBON SUR YVETTE,200056232,CA COMMUNAUTE PARIS-SACLAY,91,ESSONNE,220,14,234,0,70,6,76,311
2022,91692,LES ULIS,200056232,CA COMMUNAUTE PARIS-SACLAY,91,ESSONNE,292,11,303,14,273,13,286,603
2022,92009,BOIS COLOMBES,200054781,METROPOLE DU GRAND PARIS,92,HAUTS DE SEINE,372,154,526,13,160,158,318,856
2022,92020,CHATILLON,200054781,METROPOLE DU GRAND PARIS,92,HAUTS DE SEINE,528,112,640,0,233,128,361,1001
2022,92022,CHAVILLE,200054781,METROPOLE DU GRAND PARIS,92,HAUTS DE SEINE,241,47,288,6,123,87,210,504
2022,92025,COLOMBES,200054781,METROPOLE DU GRAND PARIS,92,HAUTS DE SEINE,1188,210,1398,58,570,282,852,2308
2022,92026,COURBEVOIE,200054781,METROPOLE DU GRAND PARIS,92,HAUTS DE SEINE,1791,117,1908,17,560,293,853,2778
2022,92033,GARCHES,200054781,METROPOLE DU GRAND PARIS,92,HAUTS DE SEINE,379,32,411,0,62,74,136,546
2022,92036,GENNEVILLIERS,200054781,METROPOLE DU GRAND PARIS,92,HAUTS DE SEINE,698,14,712,181,221,38,259,1152
2022,92044,LEVALLOIS PERRET,200054781,METROPOLE DU GRAND PARIS,92,HAUTS DE SEINE,1349,204,1553,80,219,603,822,2455
2022,92046,MALAKOFF,200054781,METROPOLE DU GRAND PARIS,92,HAUTS DE SEINE,330,36,366,3,218,53,271,640
2022,92049,MONTROUGE,200054781,METROPOLE DU GRAND PARIS,92,HAUTS DE SEINE,1099,71,1170,0,198,165,363,1534
2022,92051,NEUILLY SUR SEINE,200054781,METROPOLE DU GRAND PARIS,92,HAUTS DE SEINE,779,69,848,40,23,663,686,1574
2022,92060,LE PLESSIS ROBINSON,200054781,METROPOLE DU GRAND PARIS,92,HAUTS DE SEINE,512,15,527,9,233,39,272,808
2022,92062,PUTEAUX,200054781,METROPOLE DU GRAND PARIS,92,HAUTS DE SEINE,1013,112,1125,18,297,189,486,1629
2022,92075,VANVES,200054781,METROPOLE DU GRAND PARIS,92,HAUTS DE SEINE,350,19,369,0,143,78,221,590
2022,93001,AUBERVILLIERS,200054781,METROPOLE DU GRAND PARIS,93,SEINE SAINT DENIS,649,17,666,70,251,54,305,1041
2022,93006,BAGNOLET,200054781,METROPOLE DU GRAND PARIS,93,SEINE SAINT DENIS,381,35,416,36,187,62,249,701
2022,93010,BONDY,200054781,METROPOLE DU GRAND PARIS,93,SEINE SAINT DENIS,611,22,633,78,259,30,289,1000
2022,93013,LE BOURGET,200054781,METROPOLE DU GRAND PARIS,93,SEINE SAINT DENIS,201,4,205,0,41,6,47,252
2022,93014,CLICHY SOUS BOIS,200054781,METROPOLE DU GRAND PARIS,93,SEINE SAINT DENIS,206,4,210,52,82,9,91,353
2022,93030,DUGNY,200054781,METROPOLE DU GRAND PARIS,93,SEINE SAINT DENIS,120,4,124,9,46,2,48,180
2022,93045,LES LILAS,200054781,METROPOLE DU GRAND PARIS,93,SEINE SAINT DENIS,222,5,227,0,210,68,278,504
2022,93046,LIVRY GARGAN,200054781,METROPOLE DU GRAND PARIS,93,SEINE SAINT DENIS,405,69,474,1,275,22,297,772
2022,93053,NOISY LE SEC,200054781,METROPOLE DU GRAND PARIS,93,SEINE SAINT DENIS,315,12,327,8,180,26,206,541
2022,93057,LES PAVILLONS SOUS BOIS,200054781,METROPOLE DU GRAND PARIS,93,SEINE SAINT DENIS,267,27,294,29,115,20,135,458
2022,93059,PIERREFITTE SUR SEINE,200054781,METROPOLE DU GRAND PARIS,93,SEINE SAINT DENIS,220,15,235,17,125,5,130,383
2022,93070,SAINT OUEN SUR SEINE,200054781,METROPOLE DU GRAND PARIS,93,SEINE SAINT DENIS,557,83,640,53,390,202,592,1285
2022,93072,STAINS,200054781,METROPOLE DU GRAND PARIS,93,SEINE SAINT DENIS,341,21,362,24,107,15,122,508
2022,93073,TREMBLAY EN FRANCE,200054781,METROPOLE DU GRAND PARIS,93,SEINE SAINT DENIS,335,6,341,47,275,18,293,681
2022,93078,VILLEPINTE,200054781,METROPOLE DU GRAND PARIS,93,SEINE SAINT DENIS,310,14,324,0,165,6,171,495
2022,94004,BOISSY SAINT LEGER,200054781,METROPOLE DU GRAND PARIS,94,VAL DE MARNE,168,15,183,0,147,14,161,344
2022,94011,BONNEUIL SUR MARNE,200054781,METROPOLE DU GRAND PARIS,94,VAL DE MARNE,184,3,187,70,112,17,129,386
2022,94016,CACHAN,200054781,METROPOLE DU GRAND PARIS,94,VAL DE MARNE,319,22,341,17,239,39,278,636
2022,94021,CHEVILLY LARUE,200054781,METROPOLE DU GRAND PARIS,94,VAL DE MARNE,280,11,291,4,148,13,161,456
2022,94033,FONTENAY SOUS BOIS,200054781,METROPOLE DU GRAND PARIS,94,VAL DE MARNE,500,82,582,54,385,165,550,1186
2022,94034,FRESNES,200054781,METROPOLE DU GRAND PARIS,94,VAL DE MARNE,312,46,358,0,230,13,243,601
2022,94038,L'HAY LES ROSES,200054781,METROPOLE DU GRAND PARIS,94,VAL DE MARNE,312,61,373,17,224,27,251,641
2022,94041,IVRY SUR SEINE,200054781,METROPOLE DU GRAND PARIS,94,VAL DE MARNE,726,111,837,82,328,51,379,1298
2022,94042,JOINVILLE LE PONT,200054781,METROPOLE DU GRAND PARIS,94,VAL DE MARNE,296,34,330,0,130,63,193,523
2022,94043,LE KREMLIN BICETRE,200054781,METROPOLE DU GRAND PARIS,94,VAL DE MARNE,483,14,497,6,202,23,225,728
2022,94046,MAISONS ALFORT,200054781,METROPOLE DU GRAND PARIS,94,VAL DE MARNE,678,92,770,0,472,149,621,1391
2022,94052,NOGENT SUR MARNE,200054781,METROPOLE DU GRAND PARIS,94,VAL DE MARNE,464,77,541,17,141,178,319,877
2022,94058,LE PERREUX SUR MARNE,200054781,METROPOLE DU GRAND PARIS,94,VAL DE MARNE,409,87,496,1,213,89,302,799
2022,94059,LE PLESSIS TREVISE,200054781,METROPOLE DU GRAND PARIS,94,VAL DE MARNE,205,7,212,5,168,5,173,390
2022,94069,SAINT MAURICE,200054781,METROPOLE DU GRAND PARIS,94,VAL DE MARNE,277,24,301,0,74,62,136,437
2022,94071,SUCY EN BRIE,200054781,METROPOLE DU GRAND PARIS,94,VAL DE MARNE,160,26,186,0,212,25,237,423
2022,94073,THIAIS,200054781,METROPOLE DU GRAND PARIS,94,VAL DE MARNE,392,77,469,16,190,21,211,696
2022,94075,VILLECRESNES,200054781,METROPOLE DU GRAND PARIS,94,VAL DE MARNE,36,21,57,1,134,7,141,199
2022,94080,VINCENNES,200054781,METROPOLE DU GRAND PARIS,94,VAL DE MARNE,982,115,1097,4,200,337,537,1638
2022,95018,ARGENTEUIL,200054781,METROPOLE DU GRAND PARIS,95,VAL D OISE,1050,65,1115,73,745,52,797,1984
2022,95019,ARNOUVILLE,200055655,CA ROISSY PAYS DE FRANCE,95,VAL D OISE,110,1,111,4,60,3,63,178
2022,95063,BEZONS,200058519,CA SAINT GERMAIN BOUCLES DE SEINE,95,VAL D OISE,199,101,300,40,280,37,317,657
2022,95210,ENGHIEN LES BAINS,200056380,CA PLAINE VALLEE,95,VAL D OISE,85,10,95,0,45,13,58,154
2022,95218,ERAGNY,249500109,CA DE CERGY-PONTOISE,95,VAL D OISE,105,58,163,0,251,15,266,429
2022,95268,GARGES LES GONESSE,200055655,CA ROISSY PAYS DE FRANCE,95,VAL D OISE,267,5,272,157,132,5,137,567
2022,95277,GONESSE,200055655,CA ROISSY PAYS DE FRANCE,95,VAL D OISE,298,2,300,28,115,13,128,455
2022,95280,GOUSSAINVILLE,200055655,CA ROISSY PAYS DE FRANCE,95,VAL D OISE,121,2,123,24,154,3,157,305
2022,95306,HERBLAY SUR SEINE,200058485,CA VAL PARISIS,95,VAL D OISE,223,38,261,0,414,23,437,698
2022,95313,L'ISLE ADAM,249500455,CC DE LA VALLEE DE L'OISE ET DES TROIS FORETS,95,VAL D OISE,58,37,95,8,95,12,107,211
2022,95487,PERSAN,249500489,CC DU HAUT VAL D'OISE,95,VAL D OISE,58,9,67,19,154,3,157,243
2022,95555,SAINT GRATIEN,200056380,CA PLAINE VALLEE,95,VAL D OISE,163,11,174,0,198,17,215,389
2022,95637,VAUREAL,249500109,CA DE CERGY-PONTOISE,95,VAL D OISE,117,15,132,0,212,9,221,353
2022,97101,LES ABYMES,200018653,CA CAP EXCELLENCE,971,GUADELOUPE,463,44,507,145,335,21,356,1008
2022,97113,LE GOSIER,200041507,CA LA RIVIERA DU LEVANT,971,GUADELOUPE,175,74,249,68,120,27,147,464
2022,97115,LAMENTIN,249710062,CA DU NORD BASSE-TERRE,971,GUADELOUPE,66,29,95,49,135,10,145,289
2022,97117,LE MOULE,200044691,CA DU NORD GRANDE TERRE,971,GUADELOUPE,68,76,144,45,95,4,99,288
2022,97128,SAINTE ANNE,200041507,CA LA RIVIERA DU LEVANT,971,GUADELOUPE,55,78,133,28,132,9,141,302
2022,97210,LE FRANCOIS,249720053,CA DE L'ESPACE SUD DE LA MARTINIQUE,972,MARTINIQUE,123,19,142,49,65,15,80,271
2022,97221,RIVIERE SALEE,249720053,CA DE L'ESPACE SUD DE LA MARTINIQUE,972,MARTINIQUE,0,12,12,89,55,5,60,161
2022,97228,SAINTE MARIE,200041788,CA DU PAYS NORD MARTINIQUE,972,MARTINIQUE,55,28,83,41,36,2,38,162
2022,97230,LA TRINITE,200041788,CA DU PAYS NORD MARTINIQUE,972,MARTINIQUE,100,15,115,15,36,8,44,174
2022,97304,KOUROU,200027548,CC DES SAVANES,973,GUYANE,300,1,301,0,65,35,100,400
2022,97309,REMIRE MONTJOLY,249730045,CA DU CENTRE LITTORAL,973,GUYANE,296,16,312,0,115,15,130,442
2022,97311,SAINT LAURENT DU MARONI,249730037,CC DE L'OUEST GUYANAIS,973,GUYANE,170,0,170,0,66,19,85,255
2022,97404,L'ETANG SALE,249740077,CA CIVIS (COMMUNAUTE INTERCOMMUNALE DES VILLES SOLIDAIRES),974,LA REUNION,60,86,146,0,165,32,197,343
2022,97405,PETITE ILE,249740077,CA CIVIS (COMMUNAUTE INTERCOMMUNALE DES VILLES SOLIDAIRES),974,LA REUNION,55,31,86,18,58,15,73,178
2022,97408,LA POSSESSION,249740101,CA TERRITOIRE DE LA COTE OUEST (TCO),974,LA REUNION,190,327,517,31,208,34,242,790
2022,97409,SAINT ANDRE,249740093,CA INTERCOMMUNALE DE LA REUNION EST (CIREST),974,LA REUNION,480,235,715,85,190,24,214,1014
2022,97412,SAINT JOSEPH,249740085,CA DU SUD,974,LA REUNION,167,155,322,23,114,31,145,490
2022,97413,SAINT LEU,249740101,CA TERRITOIRE DE LA COTE OUEST (TCO),974,LA REUNION,151,183,334,28,215,58,273,635
2022,97414,SAINT LOUIS,249740077,CA CIVIS (COMMUNAUTE INTERCOMMUNALE DES VILLES SOLIDAIRES),974,LA REUNION,260,112,372,108,279,84,363,843
2022,97420,SAINTE SUZANNE,249740119,CA INTERCOMMUNALE DU NORD DE LA REUNION (CINOR),974,LA REUNION,221,115,336,1,106,19,125,462
2017,62510,LIEVIN,246200364,CA DE LENS - LIEVIN,62,PAS DE CALAIS,166,11,177,122,199,5,204,504
2017,63014,AUBIERE,246300701,CLERMONT AUVERGNE METROPOLE,63,PUY DE DOME,95,4,99,0,119,0,119,218
2017,63124,COURNON D AUVERGNE,246300701,CLERMONT AUVERGNE METROPOLE,63,PUY DE DOME,126,5,131,12,270,6,276,419
2017,63430,THIERS,200070712,CC THIERS DORE ET MONTAGNE,63,PUY DE DOME,15,4,19,22,105,1,106,147
2017,64102,BAYONNE,200067106,CA DU PAYS BASQUE,64,PYRENEES ATLANTIQUES,258,101,359,101,439,40,479,939
2017,64348,LONS,200067254,CA PAU BEARN PYRENEES,64,PYRENEES ATLANTIQUES,74,13,87,0,234,8,242,329
2017,64422,OLORON SAINTE MARIE,200067262,CC DU HAUT BEARN,64,PYRENEES ATLANTIQUES,89,0,89,25,94,2,96,210
2017,64430,ORTHEZ,200039204,CC DE LACQ-ORTHEZ,64,PYRENEES ATLANTIQUES,40,0,40,10,101,3,104,154
2017,66037,CANET EN ROUSSILLON,200027183,CU PERPIGNAN MEDITERRANEE METROPOLE,66,PYRENEES ORIENTALES,79,17,96,2,66,1,67,165
2017,67043,BISCHHEIM,246700488,EUROMETROPOLE DE STRASBOURG,67,BAS RHIN,221,25,246,37,149,2,151,434
2017,68112,GUEBWILLER,246800569,CC DE LA REGION DE GUEBWILLER,68,HAUT RHIN,110,5,115,0,62,5,67,183
2017,68224,MULHOUSE,200066009,CA MULHOUSE ALSACE AGGLOMERATION,68,HAUT RHIN,1117,11,1128,232,415,15,430,1790
2017,68376,WITTENHEIM,200066009,CA MULHOUSE ALSACE AGGLOMERATION,68,HAUT RHIN,75,1,76,0,107,4,111,187
2017,69034,CALUIRE ET CUIRE,200046977,METROPOLE DE LYON,69,RHONE,308,114,422,68,469,60,529,1019
2017,69149,OULLINS,200046977,METROPOLE DE LYON,69,RHONE,230,29,259,20,380,27,407,686
2017,69202,SAINTE FOY LES LYON,200046977,METROPOLE DE LYON,69,RHONE,170,46,216,0,246,31,277,493
2017,69243,TARARE,200040566,CA DE L'OUEST RHODANIEN,69,RHONE,98,0,98,29,114,2,116,244
2017,69290,SAINT PRIEST,200046977,METROPOLE DE LYON,69,RHONE,492,36,528,95,482,13,495,1118
2017,69389,LYON 9E ARRONDISSEMENT,200046977,METROPOLE DE LYON,69,RHONE,608,48,656,170,543,84,627,1453
2017,71014,AUTUN,200070530,CC DU GRAND AUTUNOIS MORVAN,71,SAONE ET LOIRE,91,0,91,41,128,3,131,263
2017,72264,SABLE SUR SARTHE,247200090,CC DE SABLE-SUR-SARTHE,72,SARTHE,45,0,45,35,204,1,205,285
2017,75106,PARIS 6E ARRONDISSEMENT,200054781,METROPOLE DU GRAND PARIS,75,PARIS,571,7,578,27,16,200,216,821
2017,75113,PARIS 13E ARRONDISSEMENT,200054781,METROPOLE DU GRAND PARIS,75,PARIS,3678,50,3728,66,402,402,804,4598
2017,75117,PARIS 17E ARRONDISSEMENT,200054781,METROPOLE DU GRAND PARIS,75,PARIS,2243,284,2527,71,460,1638,2098,4696
2017,75120,PARIS 20E ARRONDISSEMENT,200054781,METROPOLE DU GRAND PARIS,75,PARIS,3739,89,3828,140,552,499,1051,5019
2017,76351,LE HAVRE,200084952,CU LE HAVRE SEINE METROPOLE,76,SEINE MARITIME,838,108,946,156,2236,67,2303,3406
2017,76498,LE PETIT QUEVILLY,200023414,METROPOLE ROUEN NORMANDIE,76,SEINE MARITIME,114,11,125,47,337,5,342,514
2017,76575,SAINT ETIENNE DU ROUVRAY,200023414,METROPOLE ROUEN NORMANDIE,76,SEINE MARITIME,124,5,129,72,418,4,422,623
2017,77083,CHAMPS SUR MARNE,200057958,CA PARIS - VALLEE DE LA MARNE,77,SEINE ET MARNE,281,5,286,6,277,3,280,572
2017,77285,LE MEE SUR SEINE,247700057,CA MELUN VAL DE SEINE,77,SEINE ET MARNE,246,0,246,78,236,7,243,567
2017,77288,MELUN,247700057,CA MELUN VAL DE SEINE,77,SEINE ET MARNE,421,2,423,15,374,9,383,820
2017,77305,MONTEREAU FAULT YONNE,247700107,CC PAYS DE MONTEREAU,77,SEINE ET MARNE,100,0,100,24,176,5,181,305
2017,77350,OZOIR LA FERRIERE,200023125,CC LES PORTES BRIARDES ENTRE VILLES ET FORETS,77,SEINE ET MARNE,160,1,161,0,270,4,274,435
2017,77464,THORIGNY SUR MARNE,247700594,CA MARNE ET GONDOIRE,77,SEINE ET MARNE,81,2,83,0,117,3,120,203
2017,77487,VAUX LE PENIL,247700057,CA MELUN VAL DE SEINE,77,SEINE ET MARNE,137,0,137,1,135,1,136,274
2017,78029,AUBERGENVILLE,200059889,CU GRAND PARIS SEINE ET OISE,78,YVELINES,97,15,112,1,118,4,122,235
2017,78124,CARRIERES SUR SEINE,200058519,CA SAINT GERMAIN BOUCLES DE SEINE,78,YVELINES,220,19,239,14,149,33,182,434
2017,78242,FONTENAY LE FLEURY,247800584,CA VERSAILLES GRAND PARC (CAVGP),78,YVELINES,156,3,159,0,186,11,197,356
2017,78418,MONTESSON,200058519,CA SAINT GERMAIN BOUCLES DE SEINE,78,YVELINES,195,12,207,1,115,35,150,358
2017,78517,RAMBOUILLET,200073344,CA RAMBOUILLET TERRITOIRES,78,YVELINES,282,3,285,0,279,21,300,586
2017,78621,TRAPPES,200058782,CA DE SAINT QUENTIN EN YVELINES,78,YVELINES,293,5,298,152,290,6,296,746
2017,79202,PARTHENAY,200041333,CC DE PARTHENAY-GATINE,79,DEUX SEVRES,72,0,72,2,100,2,102,176
2017,80001,ABBEVILLE,200070993,CA DE LA BAIE DE SOMME,80,SOMME,54,10,64,56,299,1,300,420
2017,81065,CASTRES,248100430,CA DE CASTRES MAZAMET,81,TARN,303,24,327,52,188,23,211,589
2017,83023,BRIGNOLES,200068104,CA DE LA PROVENCE VERTE,83,VAR,110,2,112,0,190,1,191,303
2017,83062,LA GARDE,248300543,METROPOLE TOULON-PROVENCE-MEDITERRANEE,83,VAR,260,12,272,9,162,17,179,460
2017,83090,OLLIOULES,248300543,METROPOLE TOULON-PROVENCE-MEDITERRANEE,83,VAR,74,20,94,1,108,6,114,209
2017,83116,SAINT MAXIMIN LA SAINTE BAUME,200068104,CA DE LA PROVENCE VERTE,83,VAR,121,5,126,2,177,4,181,309
2017,83130,SOLLIES PONT,248300410,CC DE LA VALLEE DU GAPEAU,83,VAR,75,3,78,11,128,4,132,221
2017,84007,AVIGNON,248400251,CA DU GRAND AVIGNON (COGA),84,VAUCLUSE,797,78,875,75,399,38,437,1387
2017,84035,CAVAILLON,200040442,CA LUBERON MONTS DE VAUCLUSE,84,VAUCLUSE,210,1,211,0,120,9,129,340
2017,85092,FONTENAY LE COMTE,200071934,CC DU PAYS DE FONTENAY-VENDEE,85,VENDEE,24,0,24,22,169,0,169,215
2017,88413,SAINT DIE DES VOSGES,200071066,CA DE SAINT-DIE-DES-VOSGES,88,VOSGES,131,0,131,65,164,0,164,360
2017,89387,SENS,248900334,CA DU GRAND SENONAIS,89,YONNE,238,0,238,0,243,6,249,487
2017,91027,ATHIS MONS,200054781,METROPOLE DU GRAND PARIS,91,ESSONNE,332,1,333,50,436,23,459,842
2017,91216,EPINAY SUR ORGE,200056232,CA COMMUNAUTE PARIS-SACLAY,91,ESSONNE,155,2,157,0,106,4,110,268
2017,91235,FLEURY MEROGIS,200057859,CA COEUR D'ESSONNE AGGLOMERATION,91,ESSONNE,144,4,148,17,109,3,112,276
2017,91326,JUVISY SUR ORGE,200054781,METROPOLE DU GRAND PARIS,91,ESSONNE,165,17,182,7,151,22,173,362
2017,91386,MENNECY,249100546,CC DU VAL D'ESSONNE (CCVE),91,ESSONNE,80,2,82,1,161,2,163,246
2017,91471,ORSAY,200056232,CA COMMUNAUTE PARIS-SACLAY,91,ESSONNE,202,0,202,0,110,12,122,324
2017,91570,SAINT MICHEL SUR ORGE,200057859,CA COEUR D'ESSONNE AGGLOMERATION,91,ESSONNE,156,3,159,2,308,6,314,475
2017,91657,VIGNEUX SUR SEINE,200058477,CA VAL D'YERRES VAL DE SEINE,91,ESSONNE,228,2,230,0,336,9,345,574
2017,91661,VILLEBON SUR YVETTE,200056232,CA COMMUNAUTE PARIS-SACLAY,91,ESSONNE,240,12,252,0,67,5,72,324
2017,92007,BAGNEUX,200054781,METROPOLE DU GRAND PARIS,92,HAUTS DE SEINE,360,23,383,108,442,33,475,966
2017,92012,BOULOGNE BILLANCOURT,200054781,METROPOLE DU GRAND PARIS,92,HAUTS DE SEINE,2363,152,2515,59,586,1028,1614,4188
2017,92022,CHAVILLE,200054781,METROPOLE DU GRAND PARIS,92,HAUTS DE SEINE,248,25,273,0,135,87,222,495
2017,92024,CLICHY,200054781,METROPOLE DU GRAND PARIS,92,HAUTS DE SEINE,846,13,859,19,481,182,663,1541
2017,92033,GARCHES,200054781,METROPOLE DU GRAND PARIS,92,HAUTS DE SEINE,336,3,339,0,79,83,162,501
2017,92040,ISSY LES MOULINEAUX,200054781,METROPOLE DU GRAND PARIS,92,HAUTS DE SEINE,1380,40,1420,19,654,336,990,2429
2017,92046,MALAKOFF,200054781,METROPOLE DU GRAND PARIS,92,HAUTS DE SEINE,407,6,413,15,227,63,290,718
2017,92051,NEUILLY SUR SEINE,200054781,METROPOLE DU GRAND PARIS,92,HAUTS DE SEINE,757,24,781,18,26,605,631,1430
2017,92064,SAINT CLOUD,200054781,METROPOLE DU GRAND PARIS,92,HAUTS DE SEINE,503,19,522,2,163,193,356,880
2017,93008,BOBIGNY,200054781,METROPOLE DU GRAND PARIS,93,SEINE SAINT DENIS,528,1,529,66,186,15,201,797
2017,93030,DUGNY,200054781,METROPOLE DU GRAND PARIS,93,SEINE SAINT DENIS,80,0,80,0,78,4,82,162
2017,93046,LIVRY GARGAN,200054781,METROPOLE DU GRAND PARIS,93,SEINE SAINT DENIS,330,25,355,0,330,19,349,704
2017,93055,PANTIN,200054781,METROPOLE DU GRAND PARIS,93,SEINE SAINT DENIS,636,22,658,75,331,114,445,1177
2017,93061,LE PRE SAINT GERVAIS,200054781,METROPOLE DU GRAND PARIS,93,SEINE SAINT DENIS,193,1,194,17,121,22,143,354
2017,93071,SEVRAN,200054781,METROPOLE DU GRAND PARIS,93,SEINE SAINT DENIS,327,2,329,96,235,6,241,665
2017,93073,TREMBLAY EN FRANCE,200054781,METROPOLE DU GRAND PARIS,93,SEINE SAINT DENIS,315,4,319,57,266,5,271,647
2017,93077,VILLEMOMBLE,200054781,METROPOLE DU GRAND PARIS,93,SEINE SAINT DENIS,230,11,241,0,233,16,249,490
2017,93079,VILLETANEUSE,200054781,METROPOLE DU GRAND PARIS,93,SEINE SAINT DENIS,65,0,65,47,54,2,56,168
2017,94017,CHAMPIGNY SUR MARNE,200054781,METROPOLE DU GRAND PARIS,94,VAL DE MARNE,539,6,545,97,706,32,738,1380
2018,94077,VILLENEUVE LE ROI,200054781,METROPOLE DU GRAND PARIS,94,VAL DE MARNE,194,3,197,0,132,6,138,335
2018,95268,GARGES LES GONESSE,200055655,CA ROISSY PAYS DE FRANCE,95,VAL D OISE,257,0,257,164,183,1,184,606
2018,95306,HERBLAY SUR SEINE,200058485,CA VAL PARISIS,95,VAL D OISE,218,6,224,1,443,22,465,690
2018,95427,MONTMAGNY,200056380,CA PLAINE VALLEE,95,VAL D OISE,90,2,92,12,168,3,171,275
2018,95585,SARCELLES,200055655,CA ROISSY PAYS DE FRANCE,95,VAL D OISE,386,29,415,255,278,22,300,970
2018,95607,TAVERNY,200058485,CA VAL PARISIS,95,VAL D OISE,187,6,193,1,397,8,405,599
2018,97105,BASSE TERRE,249710070,CA GRAND SUD CARAIBE,971,GUADELOUPE,200,1,201,66,51,0,51,319
2018,97120,POINTE A PITRE,200018653,CA CAP EXCELLENCE,971,GUADELOUPE,150,2,152,69,40,1,41,262
2018,97207,DUCOS,249720053,CA DE L'ESPACE SUD DE LA MARTINIQUE,972,MARTINIQUE,26,34,60,36,104,4,108,204
2018,97220,RIVIERE PILOTE,249720053,CA DE L'ESPACE SUD DE LA MARTINIQUE,972,MARTINIQUE,35,9,44,44,25,1,26,114
2018,97404,L'ETANG SALE,249740077,CA CIVIS (COMMUNAUTE INTERCOMMUNALE DES VILLES SOLIDAIRES),974,LA REUNION,60,39,99,0,103,20,123,222
2018,97420,SAINTE SUZANNE,249740119,CA INTERCOMMUNALE DU NORD DE LA REUNION (CINOR),974,LA REUNION,183,79,262,14,87,14,101,376
2019,01354,SAINT GENIS POUILLY,240100750,CA DU PAYS DE GEX,01,AIN,82,3,85,0,157,2,159,244
2019,03310,VICHY,200071363,CA VICHY COMMUNAUTE,03,ALLIER,162,1,163,64,146,14,160,388
2019,06027,CAGNES SUR MER,200030195,METROPOLE NICE COTE D'AZUR,06,ALPES MARITIMES,375,32,407,19,443,14,457,883
2019,06030,LE CANNET,200039915,CA CANNES PAYS DE LERINS,06,ALPES MARITIMES,271,28,299,11,270,10,280,591
2017,01325,RIGNIEUX LE FRANC,240100883,CC DE LA PLAINE DE L'AIN,01,AIN,0,0,0,0,31,0,31,31
2017,02173,CHAUNY,200071785,CA CHAUNY TERGNIER LA FERE,02,AISNE,68,8,76,8,160,0,160,244
2017,03185,MONTLUCON,200071082,CA MONTLUCON COMMUNAUTE,03,ALLIER,171,0,171,73,299,6,305,549
2017,06004,ANTIBES,240600585,CA DE SOPHIA ANTIPOLIS,06,ALPES MARITIMES,480,25,505,5,721,40,761,1271
2017,06027,CAGNES SUR MER,200030195,METROPOLE NICE COTE D'AZUR,06,ALPES MARITIMES,399,41,440,20,455,14,469,928
2017,06085,MOUGINS,200039915,CA CANNES PAYS DE LERINS,06,ALPES MARITIMES,231,17,248,0,138,5,143,391
2017,06155,VALLAURIS,240600585,CA DE SOPHIA ANTIPOLIS,06,ALPES MARITIMES,220,7,227,33,145,6,151,411
2017,11262,NARBONNE,241100593,CA LE GRAND NARBONNE,11,AUDE,262,11,273,100,358,19,377,750
2017,13007,AURIOL,200054807,METROPOLE D'AIX-MARSEILLE-PROVENCE,13,BOUCHES DU RHONE,101,2,103,1,120,3,123,226
2017,13040,FUVEAU,200054807,METROPOLE D'AIX-MARSEILLE-PROVENCE,13,BOUCHES DU RHONE,75,7,82,0,123,5,128,210
2017,13075,PLAN DE CUQUES,200054807,METROPOLE D'AIX-MARSEILLE-PROVENCE,13,BOUCHES DU RHONE,109,4,113,0,73,3,76,189
2017,13097,SAINT MARTIN DE CRAU,241300417,CA D'ARLES-CRAU-CAMARGUE-MONTAGNETTE,13,BOUCHES DU RHONE,112,1,113,0,142,5,147,260
2017,13103,SALON DE PROVENCE,200054807,METROPOLE D'AIX-MARSEILLE-PROVENCE,13,BOUCHES DU RHONE,355,28,383,0,410,25,435,818
2017,13106,SEPTEMES LES VALLONS,200054807,METROPOLE D'AIX-MARSEILLE-PROVENCE,13,BOUCHES DU RHONE,110,6,116,18,75,4,79,213
2017,13110,TRETS,200054807,METROPOLE D'AIX-MARSEILLE-PROVENCE,13,BOUCHES DU RHONE,98,5,103,0,92,6,98,200
2017,13202,MARSEILLE 2E ARRONDISSEMENT,200054807,METROPOLE D'AIX-MARSEILLE-PROVENCE,13,BOUCHES DU RHONE,334,14,348,63,80,12,92,503
2017,13209,MARSEILLE 9E ARRONDISSEMENT,200054807,METROPOLE D'AIX-MARSEILLE-PROVENCE,13,BOUCHES DU RHONE,1093,56,1149,37,543,44,587,1773
2017,13213,MARSEILLE 13E ARRONDISSEMENT,200054807,METROPOLE D'AIX-MARSEILLE-PROVENCE,13,BOUCHES DU RHONE,758,38,796,283,402,27,429,1508
2017,14047,BAYEUX,241400555,CC DE BAYEUX INTERCOM,14,CALVADOS,58,8,66,15,245,9,254,335
2017,16015,ANGOULEME,200071827,CA DU GRAND ANGOULEME,16,CHARENTE,348,12,360,72,214,10,224,656
2017,17300,LA ROCHELLE,241700434,CA DE LA ROCHELLE,17,CHARENTE MARITIME,538,13,551,97,597,56,653,1302
2017,18033,BOURGES,241800507,CA BOURGES PLUS,18,CHER,249,8,257,112,832,27,859,1228
2017,19031,BRIVE LA GAILLARDE,200043172,CA DU BASSIN DE BRIVE,19,CORREZE,367,1,368,130,320,33,353,851
2017,24037,BERGERAC,200070647,CA BERGERACOISE,24,DORDOGNE,165,0,165,67,180,6,186,418
2017,25056,BESANCON,242500361,CA DU GRAND BESANCON,25,DOUBS,841,95,936,196,1251,54,1305,2438
2017,27701,VAL DE REUIL,200035665,CA SEINE EURE,27,EURE,145,1,146,51,88,4,92,289
2017,29019,BREST,242900314,BREST METROPOLE,29,FINISTERE,1088,23,1111,477,1560,80,1640,3228
2017,29075,GUIPAVAS,242900314,BREST METROPOLE,29,FINISTERE,167,0,167,39,334,3,337,543
2017,29151,MORLAIX,242900835,CA MORLAIX COMMUNAUTE,29,FINISTERE,142,0,142,46,126,4,130,318
2017,29232,QUIMPER,200068120,CA QUIMPER BRETAGNE OCCIDENTALE,29,FINISTERE,288,16,304,225,756,27,783,1312
2017,2B033,BASTIA,242000354,CA DE BASTIA,2B,HAUTE CORSE,263,20,283,37,153,15,168,488
2017,31149,COLOMIERS,243100518,TOULOUSE METROPOLE,31,HAUTE GARONNE,452,2,454,26,447,21,468,948
2017,31561,L'UNION,243100518,TOULOUSE METROPOLE,31,HAUTE GARONNE,109,3,112,0,124,2,126,238
2017,33051,BIGANOS,243301504,CA DU BASSIN D'ARCACHON NORD,33,GIRONDE,50,12,62,0,167,5,172,234
2017,33167,FLOIRAC,243300316,BORDEAUX METROPOLE,33,GIRONDE,155,2,157,31,272,9,281,469
2017,33199,GUJAN MESTRAS,243300563,CA BASSIN D'ARCACHON SUD-POLE ATLANTIQUE (COBAS),33,GIRONDE,108,6,114,4,224,3,227,345
2017,33200,LE HAILLAN,243300316,BORDEAUX METROPOLE,33,GIRONDE,105,3,108,0,158,5,163,271
2017,33281,MERIGNAC,243300316,BORDEAUX METROPOLE,33,GIRONDE,570,30,600,9,1014,51,1065,1674
2017,33366,SAINT ANDRE DE CUBZAC,243301223,CC DU GRAND CUBZAGUAIS,33,GIRONDE,46,4,50,0,318,2,320,369
2017,33529,LA TESTE DE BUCH,243300563,CA BASSIN D'ARCACHON SUD-POLE ATLANTIQUE (COBAS),33,GIRONDE,124,8,132,15,235,12,247,394
2017,34108,FRONTIGNAN,200066355,CA SETE AGGLOPOLE MEDITERRANEE,34,HERAULT,150,11,161,19,189,7,196,376
2017,34270,SAINT JEAN DE VEDAS,243400017,MONTPELLIER MEDITERRANEE METROPOLE,34,HERAULT,70,11,81,0,120,7,127,208
2017,35047,BRUZ,243500139,RENNES METROPOLE,35,ILLE ET VILAINE,69,22,91,37,310,9,319,447
2017,35055,CHANTEPIE,243500139,RENNES METROPOLE,35,ILLE ET VILAINE,42,4,46,26,201,2,203,275
2017,35093,DINARD,243500725,CC COTE D'EMERAUDE,35,ILLE ET VILAINE,45,0,45,27,72,3,75,148
2017,35238,RENNES,243500139,RENNES METROPOLE,35,ILLE ET VILAINE,1812,136,1948,668,2199,226,2425,5041
2017,37208,SAINT AVERTIN,243700754,TOURS METROPOLE VAL DE LOIRE,37,INDRE ET LOIRE,121,2,123,0,205,10,215,337
2017,37261,TOURS,243700754,TOURS METROPOLE VAL DE LOIRE,37,INDRE ET LOIRE,1147,88,1235,155,1455,81,1536,2926
2017,38474,SASSENAGE,200040715,GRENOBLE-ALPES-METROPOLE,38,ISERE,88,3,91,0,216,2,218,309
2017,38563,VOIRON,243800984,CA DU PAYS VOIRONNAIS,38,ISERE,170,1,171,4,253,13,266,441
2017,40192,MONT DE MARSAN,244000808,CA MONT DE MARSAN AGGLOMERATION,40,LANDES,186,0,186,22,403,3,406,614
2017,42095,FIRMINY,244200770,SAINT-ETIENNE METROPOLE,42,LOIRE,50,14,64,63,154,2,156,283
2017,42207,SAINT CHAMOND,244200770,SAINT-ETIENNE METROPOLE,42,LOIRE,196,14,210,163,353,7,360,733
2017,42279,SAINT JUST SAINT RAMBERT,200065886,CA LOIRE FOREZ AGGLOMERATION (LFA),42,LOIRE,96,4,100,18,213,10,223,341
2017,44055,LA BAULE ESCOUBLAC,244400610,CA DE LA PRESQU'ILE DE GUERANDE ATLANTIQUE (CAP ATLANTIQUE),44,LOIRE ATLANTIQUE,60,0,60,18,111,8,119,197
2017,44131,PORNIC,200067346,CA PORNIC AGGLO PAYS DE RETZ,44,LOIRE ATLANTIQUE,35,1,36,9,240,14,254,300
2017,44190,SAINT SEBASTIEN SUR LOIRE,244400404,NANTES METROPOLE,44,LOIRE ATLANTIQUE,142,22,164,11,490,20,510,685
2017,44215,VERTOU,244400404,NANTES METROPOLE,44,LOIRE ATLANTIQUE,90,41,131,19,488,30,518,668
2017,45285,SAINT JEAN DE LA RUELLE,244500468,ORLEANS METROPOLE,45,LOIRET,168,4,172,49,190,5,195,416
2017,47323,VILLENEUVE SUR LOT,200023307,CA DU GRAND VILLENEUVOIS,47,LOT ET GARONNE,147,0,147,51,161,1,162,360
2017,49125,DOUE EN ANJOU,200071876,CA SAUMUR VAL DE LOIRE,49,MAINE ET LOIRE,20,0,20,3,228,4,232,255
2017,49244,MAUGES SUR LOIRE,200060010,CA MAUGES COMMUNAUTE,49,MAINE ET LOIRE,36,1,37,45,417,2,419,500
2017,49301,SEVREMOINE,200060010,CA MAUGES COMMUNAUTE,49,MAINE ET LOIRE,50,15,65,53,702,5,707,825
2017,49331,SEGRE EN ANJOU BLEU,244900809,CC ANJOU BLEU COMMUNAUTE,49,MAINE ET LOIRE,69,1,70,20,336,5,341,432
2017,50025,AVRANCHES,200069425,CA MONT-SAINT-MICHEL-NORMANDIE,50,MANCHE,45,0,45,35,145,3,148,228
2017,50129,CHERBOURG EN COTENTIN,200067205,CA DU COTENTIN,50,MANCHE,512,0,512,191,1214,39,1253,1956
2017,50502,SAINT LO,200066389,CA SAINT-LO AGGLO,50,MANCHE,90,0,90,49,273,1,274,413
2017,52448,SAINT DIZIER,200068666,CA DE SAINT-DIZIER DER ET BLAISE,52,HAUTE MARNE,137,0,137,77,251,7,258,472
2017,53130,LAVAL,200083392,CA LAVAL AGGLOMERATION,53,MAYENNE,343,28,371,123,525,34,559,1053
2017,54304,LAXOU,245400676,METROPOLE DU GRAND NANCY,54,MEURTHE ET MOSELLE,196,3,199,26,78,8,86,311
2017,55029,BAR LE DUC,200033025,CA DE BAR-LE-DUC - SUD MEUSE,55,MEUSE,131,0,131,51,138,3,141,323
2017,56178,PONTIVY,245614433,CC PONTIVY COMMUNAUTE,56,MORBIHAN,45,0,45,76,201,0,201,322
2017,56260,VANNES,200067932,CA GOLFE DU MORBIHAN - VANNES AGGLOMERATION,56,MORBIHAN,378,12,390,235,393,28,421,1046
2017,57227,FORBACH,245700372,CA DE FORBACH PORTE DE FRANCE,57,MOSELLE,74,0,74,33,79,3,82,189
2017,57447,MARLY,200039865,METZ METROPOLE,57,MOSELLE,25,7,32,0,129,1,130,163
2017,01323,REYSSOUZE,200071371,CC BRESSE ET SAONE,01,AIN,0,0,0,0,9,0,9,9
2017,02738,TERGNIER,200071785,CA CHAUNY TERGNIER LA FERE,02,AISNE,30,12,42,41,168,4,172,256
2017,02810,VILLERS COTTERETS,200071991,CC RETZ EN VALOIS,02,AISNE,24,11,35,0,187,3,190,225
2017,03310,VICHY,200071363,CA VICHY COMMUNAUTE,03,ALLIER,169,0,169,58,196,13,209,436
2017,03321,YZEURE,200071140,CA MOULINS COMMUNAUTE,03,ALLIER,116,0,116,16,121,6,127,259
2017,04112,MANOSQUE,200034700,CA DURANCE-LUBERON-VERDON AGGLOMERATION,04,ALPES DE HAUTE PROVENCE,164,5,169,12,174,0,174,356
2017,06157,VENCE,200030195,METROPOLE NICE COTE D'AZUR,06,ALPES MARITIMES,159,1,160,11,80,6,86,257
2017,07102,GUILHERAND GRANGES,200041366,CC RHONE CRUSSOL,07,ARDECHE,39,5,44,16,180,6,186,246
2017,08409,SEDAN,200041630,CA ARDENNE METROPOLE,08,ARDENNES,90,6,96,70,92,2,94,259
2017,10387,TROYES,200069250,CA TROYES CHAMPAGNE METROPOLE,10,AUBE,460,0,460,124,344,32,376,960
2017,11206,LIMOUX,200071926,CC DU LIMOUXIN,11,AUDE,53,0,53,51,51,1,52,156
2017,12145,MILLAU,241200567,CC DE MILLAU GRANDS CAUSSES,12,AVEYRON,113,0,113,70,205,6,211,394
2017,12176,ONET LE CHATEAU,241200187,CA RODEZ AGGLOMERATION,12,AVEYRON,55,10,65,31,166,5,171,266
2017,13002,ALLAUCH,200054807,METROPOLE D'AIX-MARSEILLE-PROVENCE,13,BOUCHES DU RHONE,181,14,195,1,166,13,179,375
2017,13004,ARLES,241300417,CA D'ARLES-CRAU-CAMARGUE-MONTAGNETTE,13,BOUCHES DU RHONE,212,8,220,110,362,15,377,707
2017,13005,AUBAGNE,200054807,METROPOLE D'AIX-MARSEILLE-PROVENCE,13,BOUCHES DU RHONE,298,11,309,2,403,8,411,721
2017,13014,BERRE L ETANG,200054807,METROPOLE D'AIX-MARSEILLE-PROVENCE,13,BOUCHES DU RHONE,72,2,74,13,55,5,60,148
2017,13015,BOUC BEL AIR,200054807,METROPOLE D'AIX-MARSEILLE-PROVENCE,13,BOUCHES DU RHONE,129,15,144,13,164,8,172,329
2017,13026,CHATEAUNEUF LES MARTIGUES,200054807,METROPOLE D'AIX-MARSEILLE-PROVENCE,13,BOUCHES DU RHONE,125,14,139,1,175,5,180,320
2017,13027,CHATEAURENARD,200035087,CA TERRE DE PROVENCE,13,BOUCHES DU RHONE,66,5,71,0,175,2,177,247
2017,13056,MARTIGUES,200054807,METROPOLE D'AIX-MARSEILLE-PROVENCE,13,BOUCHES DU RHONE,569,4,573,17,248,10,258,847
2017,13077,PORT DE BOUC,200054807,METROPOLE D'AIX-MARSEILLE-PROVENCE,13,BOUCHES DU RHONE,113,0,113,56,85,6,91,260
2017,13207,MARSEILLE 7E ARRONDISSEMENT,200054807,METROPOLE D'AIX-MARSEILLE-PROVENCE,13,BOUCHES DU RHONE,350,55,405,19,273,60,333,757
2017,13211,MARSEILLE 11E ARRONDISSEMENT,200054807,METROPOLE D'AIX-MARSEILLE-PROVENCE,13,BOUCHES DU RHONE,403,27,430,68,397,19,416,914
2017,14327,HEROUVILLE SAINT CLAIR,200065597,CU CAEN LA MER,14,CALVADOS,243,2,245,78,267,6,273,596
2017,14762,VIRE NORMANDIE,200068799,CC INTERCOM DE LA VIRE AU NOIREAU,14,CALVADOS,45,1,46,36,314,4,318,399
2017,22050,DINAN,200068989,CA DINAN AGGLOMERATION,22,COTES D ARMOR,70,7,77,36,104,4,108,221
2017,22187,PLERIN,200069409,CA SAINT-BRIEUC ARMOR AGGLOMERATION,22,COTES D ARMOR,89,0,89,43,206,7,213,345
2017,24322,PERIGUEUX,200040392,CA LE GRAND PERIGUEUX,24,DORDOGNE,288,3,291,43,175,10,185,519
2017,25462,PONTARLIER,242500338,CC DU GRAND PONTARLIER,25,DOUBS,123,21,144,6,212,3,215,366
2017,26281,ROMANS SUR ISERE,200068781,CA VALENCE ROMANS AGGLO,26,DROME,210,3,213,86,315,7,322,621
2017,27056,BERNAY,200066413,CC INTERCOM BERNAY TERRES DE NORMANDIE,27,EURE,102,0,102,16,62,0,62,180
2017,28134,DREUX,200040277,CA AGGLO DU PAYS DE DREUX,28,EURE ET LOIR,306,12,318,37,213,16,229,584
2017,29233,QUIMPERLE,242900694,CA QUIMPERLE COMMUNAUTE,29,FINISTERE,43,0,43,48,214,2,216,307
2017,30007,ALES,200066918,CA ALES AGGLOMERATION,30,GARD,181,0,181,134,160,10,170,485
2017,30202,PONT SAINT ESPRIT,200034692,CA DU GARD RHODANIEN,30,GARD,60,0,60,19,50,1,51,130
2017,30351,VILLENEUVE LES AVIGNON,248400251,CA DU GRAND AVIGNON (COGA),30,GARD,109,5,114,14,48,11,59,188
2017,31113,CASTANET TOLOSAN,243100633,CA DU SICOVAL,31,HAUTE GARONNE,139,0,139,3,205,6,211,353
2017,31187,FONSORBES,200068641,CA LE MURETAIN AGGLO,31,HAUTE GARONNE,83,0,83,0,231,4,235,318
2017,31555,TOULOUSE,243100518,TOULOUSE METROPOLE,31,HAUTE GARONNE,5715,24,5739,545,3184,709,3893,10177
2017,33056,BLANQUEFORT,243300316,BORDEAUX METROPOLE,33,GIRONDE,122,7,129,0,244,5,249,377
2017,33069,LE BOUSCAT,243300316,BORDEAUX METROPOLE,33,GIRONDE,264,23,287,0,252,45,297,584
2017,33162,EYSINES,243300316,BORDEAUX METROPOLE,33,GIRONDE,168,5,173,1,410,7,417,590
2017,33318,PESSAC,243300316,BORDEAUX METROPOLE,33,GIRONDE,513,30,543,33,902,38,940,1515
2017,34003,AGDE,243400819,CA HERAULT-MEDITERRANEE,34,HERAULT,167,0,167,38,103,22,125,331
2017,34032,BEZIERS,243400769,CA DE BEZIERS-MEDITERRANEE,34,HERAULT,313,14,327,117,441,13,454,898
2017,34057,CASTELNAU LE LEZ,243400017,MONTPELLIER MEDITERRANEE METROPOLE,34,HERAULT,174,20,194,13,138,23,161,368
2017,34172,MONTPELLIER,243400017,MONTPELLIER MEDITERRANEE METROPOLE,34,HERAULT,2530,143,2673,268,1757,264,2021,4962
2017,36088,ISSOUDUN,243600236,CC DU PAYS D'ISSOUDUN,36,INDRE,55,0,55,18,148,0,148,221
2017,37050,CHAMBRAY LES TOURS,243700754,TOURS METROPOLE VAL DE LOIRE,37,INDRE ET LOIRE,103,6,109,0,196,2,198,307
2017,37214,SAINT CYR SUR LOIRE,243700754,TOURS METROPOLE VAL DE LOIRE,37,INDRE ET LOIRE,77,8,85,1,186,9,195,281
2017,38151,ECHIROLLES,200040715,GRENOBLE-ALPES-METROPOLE,38,ISERE,318,17,335,92,438,18,456,884
2017,38421,SAINT MARTIN D HERES,200040715,GRENOBLE-ALPES-METROPOLE,38,ISERE,268,21,289,43,525,8,533,865
2017,39198,DOLE,200010650,CA DU GRAND DOLE,39,JURA,189,0,189,57,250,6,256,502
2017,41194,ROMORANTIN LANTHENAY,200018406,CC DU ROMORANTINAIS ET DU MONESTOIS,41,LOIR ET CHER,85,1,86,25,192,6,198,309
2017,42147,MONTBRISON,200065886,CA LOIRE FOREZ AGGLOMERATION (LFA),42,LOIRE,111,3,114,0,201,5,206,320
2017,44003,ANCENIS SAINT GEREON,244400552,CC DU PAYS D'ANCENIS,44,LOIRE ATLANTIQUE,44,2,46,20,243,1,244,311
2017,44069,GUERANDE,244400610,CA DE LA PRESQU'ILE DE GUERANDE ATLANTIQUE (CAP ATLANTIQUE),44,LOIRE ATLANTIQUE,70,0,70,28,242,2,244,342
2017,44129,PONTCHATEAU,200000438,CC DU PAYS DE PONTCHATEAU ST-GILDAS-DES-BOIS,44,LOIRE ATLANTIQUE,23,1,24,25,278,1,279,327
2017,44143,REZE,244400404,NANTES METROPOLE,44,LOIRE ATLANTIQUE,180,30,210,36,795,44,839,1084
2017,44172,SAINTE LUCE SUR LOIRE,244400404,NANTES METROPOLE,44,LOIRE ATLANTIQUE,122,3,125,0,338,6,344,469
2017,01320,REPLONGES,200071371,CC BRESSE ET SAONE,01,AIN,18,0,18,0,107,1,108,126
2017,01321,REVONNAS,200071751,CA DU BASSIN DE BOURG-EN-BRESSE,01,AIN,0,1,1,0,14,0,14,15
2017,01354,SAINT GENIS POUILLY,240100750,CA DU PAYS DE GEX,01,AIN,82,3,85,0,145,1,146,231
2017,02722,SOISSONS,240200477,CA GRANDSOISSONS AGGLOMERATION,02,AISNE,141,20,161,69,281,4,285,515
2017,05061,GAP,200067825,CA GAP-TALLARD-DURANCE,05,HAUTES ALPES,328,4,332,51,361,7,368,751
2017,06029,CANNES,200039915,CA CANNES PAYS DE LERINS,06,ALPES MARITIMES,726,54,780,35,234,36,270,1086
2017,06030,LE CANNET,200039915,CA CANNES PAYS DE LERINS,06,ALPES MARITIMES,302,30,332,11,284,12,296,639
2017,06069,GRASSE,200039857,CA DU PAYS DE GRASSE,06,ALPES MARITIMES,402,18,420,8,446,16,462,890
2017,06079,MANDELIEU LA NAPOULE,200039915,CA CANNES PAYS DE LERINS,06,ALPES MARITIMES,222,13,235,8,117,7,124,367
2017,06088,NICE,200030195,METROPOLE NICE COTE D'AZUR,06,ALPES MARITIMES,3045,98,3143,354,1814,179,1993,5491
2017,06104,ROQUEBRUNE CAP MARTIN,240600551,CA DE LA RIVIERA FRANCAISE,06,ALPES MARITIMES,134,0,134,12,38,2,40,186
2017,06123,SAINT LAURENT DU VAR,200030195,METROPOLE NICE COTE D'AZUR,06,ALPES MARITIMES,253,25,278,0,317,6,323,602
2017,06149,LA TRINITE,200030195,METROPOLE NICE COTE D'AZUR,06,ALPES MARITIMES,83,0,83,1,68,2,70,154
2017,07019,AUBENAS,200073245,CC DU BASSIN D'AUBENAS,07,ARDECHE,80,0,80,34,71,5,76,190
2017,08105,CHARLEVILLE MEZIERES,200041630,CA ARDENNE METROPOLE,08,ARDENNES,384,29,413,137,273,11,284,834
2017,10081,LA CHAPELLE SAINT LUC,200069250,CA TROYES CHAMPAGNE METROPOLE,10,AUBE,78,0,78,95,94,5,99,272
2017,10333,SAINT ANDRE LES VERGERS,200069250,CA TROYES CHAMPAGNE METROPOLE,10,AUBE,116,0,116,0,129,5,134,250
2017,13063,MIRAMAS,200054807,METROPOLE D'AIX-MARSEILLE-PROVENCE,13,BOUCHES DU RHONE,162,1,163,49,154,2,156,368
2017,13206,MARSEILLE 6E ARRONDISSEMENT,200054807,METROPOLE D'AIX-MARSEILLE-PROVENCE,13,BOUCHES DU RHONE,621,96,717,8,258,91,349,1074
2017,13208,MARSEILLE 8E ARRONDISSEMENT,200054807,METROPOLE D'AIX-MARSEILLE-PROVENCE,13,BOUCHES DU RHONE,698,134,832,6,613,140,753,1591
2017,14118,CAEN,200065597,CU CAEN LA MER,14,CALVADOS,1107,36,1143,233,817,43,860,2236
2017,14366,LISIEUX,200069532,CA LISIEUX NORMANDIE,14,CALVADOS,102,0,102,81,319,2,321,504
2017,21171,CHEVIGNY SAINT SAUVEUR,242100410,DIJON METROPOLE,21,COTE D OR,36,6,42,7,182,1,183,232
2017,21617,TALANT,242100410,DIJON METROPOLE,21,COTE D OR,126,8,134,20,98,12,110,264
2017,22093,LAMBALLE ARMOR,200069391,CA LAMBALLE TERRE ET MER,22,COTES D ARMOR,46,3,49,48,368,6,374,471
2017,22113,LANNION,200065928,CA LANNION-TREGOR COMMUNAUTE,22,COTES D ARMOR,150,0,150,63,238,6,244,457
2017,24053,BOULAZAC ISLE MANOIRE,200040392,CA LE GRAND PERIGUEUX,24,DORDOGNE,83,1,84,17,125,6,131,232
2017,25388,MONTBELIARD,200065647,CA PAYS DE MONTBELIARD AGGLOMERATION,25,DOUBS,216,0,216,73,168,5,173,462
2017,26058,BOURG LES VALENCE,200068781,CA VALENCE ROMANS AGGLO,26,DROME,78,12,90,8,218,8,226,325
2017,26252,PORTES LES VALENCE,200068781,CA VALENCE ROMANS AGGLO,26,DROME,40,3,43,6,163,4,167,216
2017,28088,CHATEAUDUN,200069961,CC DU GRAND CHATEAUDUN,28,EURE ET LOIR,79,0,79,47,112,0,112,238
2017,28229,MAINVILLIERS,200033181,CA CHARTRES METROPOLE,28,EURE ET LOIR,76,0,76,48,122,2,124,248
2017,29235,LE RELECQ KERHUON,242900314,BREST METROPOLE,29,FINISTERE,40,0,40,35,233,7,240,315
2017,30032,BEAUCAIRE,243000585,CC BEAUCAIRE TERRE D'ARGENCE,30,GARD,60,1,61,14,68,6,74,149
2017,30258,SAINT GILLES,243000643,CA DE NIMES METROPOLE,30,GARD,41,1,42,26,75,4,79,148
2017,31069,BLAGNAC,243100518,TOULOUSE METROPOLE,31,HAUTE GARONNE,490,0,490,0,253,26,279,769
2017,31157,CUGNAUX,243100518,TOULOUSE METROPOLE,31,HAUTE GARONNE,213,2,215,0,241,12,253,467
2017,31506,SAINT ORENS DE GAMEVILLE,243100518,TOULOUSE METROPOLE,31,HAUTE GARONNE,106,9,115,0,141,4,145,259
2017,32013,AUCH,200066926,CA GRAND AUCH COEUR DE GASCOGNE,32,GERS,186,0,186,56,256,4,260,502
2017,33063,BORDEAUX,243300316,BORDEAUX METROPOLE,33,GIRONDE,2944,161,3105,147,2172,429,2601,5854
2017,33119,CENON,243300316,BORDEAUX METROPOLE,33,GIRONDE,58,6,64,62,279,12,291,416
2017,33243,LIBOURNE,200070092,CA DU LIBOURNAIS,33,GIRONDE,222,1,223,1,237,8,245,469
2017,33519,LE TAILLAN MEDOC,243300316,BORDEAUX METROPOLE,33,GIRONDE,25,4,29,2,199,2,201,232
2017,34129,LATTES,243400017,MONTPELLIER MEDITERRANEE METROPOLE,34,HERAULT,185,5,190,0,144,7,151,342
2017,34154,MAUGUIO,243400470,CA DU PAYS DE L'OR,34,HERAULT,126,7,133,3,196,7,203,339
2017,34157,MEZE,200066355,CA SETE AGGLOPOLE MEDITERRANEE,34,HERAULT,90,0,90,0,66,4,70,161
2017,34337,VILLENEUVE LES MAGUELONE,243400017,MONTPELLIER MEDITERRANEE METROPOLE,34,HERAULT,90,2,92,0,92,6,98,191
2017,35051,CESSON SEVIGNE,243500139,RENNES METROPOLE,35,ILLE ET VILAINE,176,15,191,29,252,5,257,477
2017,35288,SAINT MALO,243500782,CA DU PAYS DE SAINT MALO AGGLOMERATION,35,ILLE ET VILAINE,290,7,297,151,341,40,381,829
2017,37003,AMBOISE,200043065,CC DU VAL D AMBOISE,37,INDRE ET LOIRE,60,0,60,19,207,2,209,288
2017,37195,LA RICHE,243700754,TOURS METROPOLE VAL DE LOIRE,37,INDRE ET LOIRE,70,4,74,14,160,5,165,253
2017,38053,BOURGOIN JALLIEU,243800604,CA PORTE DE L'ISERE (CAPI),38,ISERE,103,42,145,32,373,7,380,557
2017,38193,L'ISLE D ABEAU,243800604,CA PORTE DE L'ISERE (CAPI),38,ISERE,123,17,140,14,288,4,292,445
2017,38485,SEYSSINET PARISET,200040715,GRENOBLE-ALPES-METROPOLE,38,ISERE,139,5,144,0,204,5,209,353
2017,38553,VILLEFONTAINE,243800604,CA PORTE DE L'ISERE (CAPI),38,ISERE,168,20,188,38,259,5,264,489
2017,40279,SAINT PAUL LES DAX,244000675,CA DU GRAND DAX,40,LANDES,60,9,69,0,148,2,150,219
2017,42044,LE CHAMBON FEUGEROLLES,244200770,SAINT-ETIENNE METROPOLE,42,LOIRE,86,1,87,50,91,2,93,231
2017,42187,ROANNE,200035731,CA ROANNAIS AGGLOMERATION,42,LOIRE,197,17,214,107,302,13,315,636
2017,44035,LA CHAPELLE SUR ERDRE,244400404,NANTES METROPOLE,44,LOIRE ATLANTIQUE,150,7,157,4,407,12,419,580
2017,44114,ORVAULT,244400404,NANTES METROPOLE,44,LOIRE ATLANTIQUE,181,14,195,19,472,25,497,711
2017,44132,PORNICHET,244400644,CA DE LA REGION NAZAIRIENNE ET DE L'ESTUAIRE (CARENE),44,LOIRE ATLANTIQUE,45,3,48,2,123,6,129,179
2017,44154,SAINT BREVIN LES PINS,244400586,CC DU SUD ESTUAIRE,44,LOIRE ATLANTIQUE,42,0,42,10,200,3,203,255
2017,45004,AMILLY,244500203,CA MONTARGOISE ET RIVES DU LOING (AME),45,LOIRET,110,0,110,1,191,0,191,302
2017,45068,CHALETTE SUR LOING,244500203,CA MONTARGOISE ET RIVES DU LOING (AME),45,LOIRET,100,5,105,56,107,1,108,269
2017,47001,AGEN,200035459,CA D'AGEN,47,LOT ET GARONNE,229,0,229,99,264,9,273,601
2017,47157,MARMANDE,200030674,CA VAL DE GARONNE AGGLOMERATION,47,LOT ET GARONNE,135,0,135,13,156,2,158,306
2017,49007,ANGERS,244900015,CU ANGERS LOIRE METROPOLE,49,MAINE ET LOIRE,1193,120,1313,327,1472,104,1576,3216
2017,49018,BAUGE EN ANJOU,244900882,CC BAUGEOIS VALLEE,49,MAINE ET LOIRE,63,8,71,17,154,2,156,245
2017,49023,BEAUPREAU EN MAUGES,200060010,CA MAUGES COMMUNAUTE,49,MAINE ET LOIRE,72,23,95,59,605,4,609,763
2017,49050,BRISSAC LOIRE AUBANCE,200071553,CC LOIRE LAYON AUBANCE,49,MAINE ET LOIRE,48,2,50,7,261,2,263,320
2017,49092,CHEMILLE EN ANJOU,200060010,CA MAUGES COMMUNAUTE,49,MAINE ET LOIRE,34,25,59,59,531,4,535,653
2017,49307,LOIRE AUTHION,244900015,CU ANGERS LOIRE METROPOLE,49,MAINE ET LOIRE,30,4,34,36,409,5,414,483
2017,49353,TRELAZE,244900015,CU ANGERS LOIRE METROPOLE,49,MAINE ET LOIRE,84,19,103,88,307,8,315,506
2017,51108,CHALONS EN CHAMPAGNE,200066876,CA DE CHALONS-EN-CHAMPAGNE,51,MARNE,476,40,516,43,374,15,389,948
2017,51454,REIMS,200067213,CU DU GRAND REIMS,51,MARNE,1252,326,1578,349,1414,117,1531,3458
2017,51573,TINQUEUX,200067213,CU DU GRAND REIMS,51,MARNE,58,15,73,5,166,4,170,248
2017,54323,LONGWY,245400262,CA DE LONGWY,54,MEURTHE ET MOSELLE,85,0,85,40,66,0,66,191
2017,54395,NANCY,245400676,METROPOLE DU GRAND NANCY,54,MEURTHE ET MOSELLE,1013,44,1057,162,570,112,682,1901
2017,54528,TOUL,200070563,CC TERRES TOULOISES,54,MEURTHE ET MOSELLE,110,0,110,21,176,3,179,311
2017,54578,VILLERS LES NANCY,245400676,METROPOLE DU GRAND NANCY,54,MEURTHE ET MOSELLE,100,1,101,16,124,6,130,247
2017,56007,AURAY,200043123,CC AURAY QUIBERON TERRE ATLANTIQUE,56,MORBIHAN,45,0,45,72,170,7,177,294
2017,56083,HENNEBONT,200042174,CA LORIENT AGGLOMERATION,56,MORBIHAN,50,0,50,74,253,2,255,379
2017,57019,AMNEVILLE,245701271,CC DU PAYS ORNE MOSELLE,57,MOSELLE,60,3,63,17,175,2,177,258
2017,57160,CREUTZWALD,245701164,CC DU WARNDT,57,MOSELLE,58,1,59,31,84,1,85,175
2017,57206,FAMECK,245701222,CA DU VAL DE FENSCH,57,MOSELLE,50,4,54,66,93,3,96,216
2017,57221,FLORANGE,245701222,CA DU VAL DE FENSCH,57,MOSELLE,35,5,40,31,110,3,113,184
2017,57463,METZ,200039865,METZ METROPOLE,57,MOSELLE,1229,21,1250,80,814,57,871,2200
2017,57480,MONTIGNY LES METZ,200039865,METZ METROPOLE,57,MOSELLE,90,8,98,0,298,9,307,405
2017,57606,SAINT AVOLD,200067502,CA SAINT-AVOLD SYNERGIE,57,MOSELLE,44,0,44,22,148,3,151,217
2017,57631,SARREGUEMINES,200070746,CA SARREGUEMINES CONFLUENCES,57,MOSELLE,210,0,210,34,71,3,74,318
2017,57672,THIONVILLE,245701362,CA PORTES DE FRANCE-THIONVILLE,57,MOSELLE,238,39,277,20,342,8,350,647
2017,57751,WOIPPY,200039865,METZ METROPOLE,57,MOSELLE,30,2,32,25,141,3,144,201
2017,59008,ANICHE,245901152,CC COEUR D'OSTREVENT (CCCO),59,NORD,19,5,24,45,74,2,76,145
2017,59017,ARMENTIERES,245900410,METROPOLE EUROPEENNE DE LILLE,59,NORD,85,15,100,114,263,9,272,486
2017,59043,BAILLEUL,200040947,CC DE FLANDRE INTERIEURE,59,NORD,75,12,87,61,226,4,230,379
2017,59090,BONDUES,245900410,METROPOLE EUROPEENNE DE LILLE,59,NORD,60,13,73,77,106,23,129,279
2017,59122,CAMBRAI,200068500,CA DE CAMBRAI,59,NORD,113,1,114,153,298,6,304,571
2017,59152,COMINES,245900410,METROPOLE EUROPEENNE DE LILLE,59,NORD,42,3,45,37,165,2,167,248
2017,59155,COUDEKERQUE BRANCHE,245900428,CU DE DUNKERQUE,59,NORD,62,6,68,97,297,3,300,465
2017,59163,CROIX,245900410,METROPOLE EUROPEENNE DE LILLE,59,NORD,119,22,141,61,311,12,323,526
2017,59279,HALLUIN,245900410,METROPOLE EUROPEENNE DE LILLE,59,NORD,102,14,116,58,244,4,248,422
2017,59286,HAUBOURDIN,245900410,METROPOLE EUROPEENNE DE LILLE,59,NORD,49,24,73,59,258,11,269,400
2017,59291,HAUTMONT,200043396,CA MAUBEUGE VAL DE SAMBRE,59,NORD,26,0,26,87,91,3,94,207
2017,59367,LYS LEZ LANNOY,245900410,METROPOLE EUROPEENNE DE LILLE,59,NORD,56,12,68,68,172,2,174,309
2017,59378,MARCQ EN BAROEUL,245900410,METROPOLE EUROPEENNE DE LILLE,59,NORD,243,106,349,99,545,86,631,1079
2017,59410,MONS EN BAROEUL,245900410,METROPOLE EUROPEENNE DE LILLE,59,NORD,95,16,111,104,276,7,283,498
2017,59491,RAISMES,200042190,CA DE LA PORTE DU HAINAUT,59,NORD,58,0,58,74,132,4,136,268
2017,59512,ROUBAIX,245900410,METROPOLE EUROPEENNE DE LILLE,59,NORD,920,29,949,433,426,29,455,1838
2017,59544,SAINT SAULVE,245901160,CA VALENCIENNES METROPOLE,59,NORD,150,2,152,38,133,6,139,328
2017,59560,SECLIN,245900410,METROPOLE EUROPEENNE DE LILLE,59,NORD,101,13,114,20,180,5,185,319
2017,59569,SIN LE NOBLE,200044618,CA DU DOUAISIS (CAD),59,NORD,60,3,63,75,151,3,154,292
2017,59616,VIEUX CONDE,245901160,CA VALENCIENNES METROPOLE,59,NORD,25,0,25,25,56,1,57,107
2017,59636,WAMBRECHIES,245900410,METROPOLE EUROPEENNE DE LILLE,59,NORD,30,32,62,30,206,10,216,308
2017,60057,BEAUVAIS,200067999,CA DU BEAUVAISIS,60,OISE,515,0,515,181,491,6,497,1193
2017,60159,COMPIEGNE,200067965,CA DE LA REGION DE COMPIEGNE ET DE LA BASSE AUTOMNE,60,OISE,433,0,433,67,270,42,312,812
2017,60463,NOGENT SUR OISE,200068047,CA CREIL SUD OISE,60,OISE,110,0,110,50,172,5,177,338
2017,60471,NOYON,246000756,CC DU PAYS NOYONNAIS,60,OISE,111,0,111,47,117,3,120,278
2017,61001,ALENCON,246100663,CU D'ALENCON,61,ORNE,193,1,194,96,263,4,267,556
2017,61006,ARGENTAN,200068450,CC ARGENTAN INTERCOM,61,ORNE,83,0,83,38,197,1,198,319
2017,62041,ARRAS,200033579,CU D'ARRAS,62,PAS DE CALAIS,292,50,342,154,299,25,324,820
2017,62065,AVION,246200364,CA DE LENS - LIEVIN,62,PAS DE CALAIS,24,10,34,76,140,4,144,254
2017,62215,CARVIN,246200299,CA D'HENIN-CARVIN,62,PAS DE CALAIS,60,5,65,54,250,4,254,374
2017,62250,COURRIERES,246200299,CA D'HENIN-CARVIN,62,PAS DE CALAIS,70,6,76,42,106,0,106,224
2019,57463,METZ,200039865,METZ METROPOLE,57,MOSELLE,1173,51,1224,63,824,53,877,2164
2019,57480,MONTIGNY LES METZ,200039865,METZ METROPOLE,57,MOSELLE,90,18,108,0,254,7,261,369
2019,57606,SAINT AVOLD,200067502,CA SAINT-AVOLD SYNERGIE,57,MOSELLE,44,7,51,11,155,5,160,222
2019,57757,YUTZ,245701362,CA PORTES DE FRANCE-THIONVILLE,57,MOSELLE,101,22,123,13,180,5,185,321
2019,58194,NEVERS,245804406,CA DE NEVERS,58,NIEVRE,258,7,265,65,194,12,206,536
2019,59008,ANICHE,245901152,CC COEUR D'OSTREVENT (CCCO),59,NORD,19,5,24,44,69,2,71,139
2019,59011,ANNOEULLIN,245901061,CC DE LA HAUTE DEULE,59,NORD,54,10,64,43,153,0,153,260
2019,59017,ARMENTIERES,245900410,METROPOLE EUROPEENNE DE LILLE,59,NORD,101,31,132,87,267,8,275,494
2019,59112,BRUAY SUR L ESCAUT,245901160,CA VALENCIENNES METROPOLE,59,NORD,15,0,15,49,79,0,79,143
2019,59139,CAUDRY,200030633,CA DU CAUDRESIS ET DU CATESIS,59,NORD,45,3,48,75,134,0,134,258
2019,59178,DOUAI,200044618,CA DOUAISIS AGGLO,59,NORD,206,22,228,198,225,9,234,660
2019,59220,FACHES THUMESNIL,245900410,METROPOLE EUROPEENNE DE LILLE,59,NORD,130,30,160,7,342,3,345,512
2019,59271,GRANDE SYNTHE,245900428,CU DE DUNKERQUE,59,NORD,150,3,153,148,166,1,167,468
2019,59279,HALLUIN,245900410,METROPOLE EUROPEENNE DE LILLE,59,NORD,92,30,122,44,284,5,289,455
2019,59291,HAUTMONT,200043396,CA MAUBEUGE VAL DE SAMBRE,59,NORD,26,2,28,66,102,0,102,196
2019,59295,HAZEBROUCK,200040947,CC DE FLANDRE INTERIEURE,59,NORD,87,1,88,80,276,3,279,447
2019,59324,JEUMONT,200043396,CA MAUBEUGE VAL DE SAMBRE,59,NORD,20,0,20,47,82,0,82,149
2019,59328,LAMBERSART,245900410,METROPOLE EUROPEENNE DE LILLE,59,NORD,210,92,302,78,308,45,353,733
2019,59350,LILLE,245900410,METROPOLE EUROPEENNE DE LILLE,59,NORD,1971,401,2372,596,1824,201,2025,4993
2019,59360,LOOS,245900410,METROPOLE EUROPEENNE DE LILLE,59,NORD,135,28,163,35,317,5,322,521
2019,59368,LA MADELEINE,245900410,METROPOLE EUROPEENNE DE LILLE,59,NORD,181,63,244,32,218,57,275,551
2019,59410,MONS EN BAROEUL,245900410,METROPOLE EUROPEENNE DE LILLE,59,NORD,95,14,109,111,259,9,268,488
2019,59426,NEUVILLE EN FERRAIN,245900410,METROPOLE EUROPEENNE DE LILLE,59,NORD,77,13,90,54,110,3,113,256
2019,59507,RONCHIN,245900410,METROPOLE EUROPEENNE DE LILLE,59,NORD,102,61,163,7,239,11,250,421
2019,59544,SAINT SAULVE,245901160,CA VALENCIENNES METROPOLE,59,NORD,150,1,151,29,96,2,98,278
2019,59560,SECLIN,245900410,METROPOLE EUROPEENNE DE LILLE,59,NORD,118,17,135,41,176,5,181,357
2019,59599,TOURCOING,245900410,METROPOLE EUROPEENNE DE LILLE,59,NORD,540,122,662,312,876,17,893,1867
2019,59616,VIEUX CONDE,245901160,CA VALENCIENNES METROPOLE,59,NORD,25,1,26,32,67,0,67,126
2019,59646,WASQUEHAL,245900410,METROPOLE EUROPEENNE DE LILLE,59,NORD,232,51,283,39,312,35,347,669
2019,59648,WATTIGNIES,245900410,METROPOLE EUROPEENNE DE LILLE,59,NORD,74,35,109,7,151,3,154,271
2019,60159,COMPIEGNE,200067965,CA DE LA REGION DE COMPIEGNE ET DE LA BASSE AUTOMNE,60,OISE,433,9,442,75,240,46,286,803
2019,60176,CREPY EN VALOIS,246000871,CC DU PAYS DE VALOIS,60,OISE,137,6,143,14,226,7,233,390
2019,60395,MERU,246000582,CC DES SABLONS,60,OISE,80,1,81,32,161,1,162,274
2019,60471,NOYON,246000756,CC DU PAYS NOYONNAIS,60,OISE,122,0,122,51,103,2,105,278
2019,60509,PONT SAINTE MAXENCE,246000921,CC DES PAYS D'OISE ET D'HALATTE,60,OISE,167,6,173,22,99,2,101,297
2019,61006,ARGENTAN,200068450,CC ARGENTAN INTERCOM,61,ORNE,76,0,76,30,184,1,185,291
2019,62048,AUCHEL,200072460,CA DE BETHUNE-BRUAY,62,PAS DE CALAIS,25,1,26,57,62,2,64,147
2019,62119,BETHUNE,200072460,CA DE BETHUNE-BRUAY,62,PAS DE CALAIS,102,1,103,50,153,13,166,319
2019,62193,CALAIS,200090751,CA GRAND CALAIS TERRES ET MERS,62,PAS DE CALAIS,343,9,352,351,418,9,427,1130
2019,62413,HARNES,246200364,CA DE LENS - LIEVIN,62,PAS DE CALAIS,0,20,20,43,135,1,136,199
2019,62548,MARCK,200090751,CA GRAND CALAIS TERRES ET MERS,62,PAS DE CALAIS,47,1,48,28,115,1,116,192
2019,62765,SAINT OMER,200069037,CA DU PAYS DE SAINT-OMER,62,PAS DE CALAIS,25,4,29,81,105,3,108,218
2019,63178,ISSOIRE,200070407,CA AGGLO PAYS D'ISSOIRE,63,PUY DE DOME,89,5,94,9,267,2,269,372
2019,64102,BAYONNE,200067106,CA DU PAYS BASQUE,64,PYRENEES ATLANTIQUES,255,94,349,68,418,47,465,881
2019,64129,BILLERE,200067254,CA PAU BEARN PYRENEES,64,PYRENEES ATLANTIQUES,94,15,109,8,151,7,158,276
2019,64348,LONS,200067254,CA PAU BEARN PYRENEES,64,PYRENEES ATLANTIQUES,74,18,92,0,202,14,216,309
2019,64430,ORTHEZ,200039204,CC DE LACQ-ORTHEZ,64,PYRENEES ATLANTIQUES,50,0,50,15,95,3,98,163
2019,65440,TARBES,200069300,CA TARBES-LOURDES-PYRENEES,65,HAUTES PYRENEES,315,8,323,109,209,15,224,656
2019,66028,CABESTANY,200027183,CU PERPIGNAN MEDITERRANEE METROPOLE,66,PYRENEES ORIENTALES,75,14,89,10,69,1,70,169
2019,66037,CANET EN ROUSSILLON,200027183,CU PERPIGNAN MEDITERRANEE METROPOLE,66,PYRENEES ORIENTALES,79,14,93,0,62,4,66,159
2019,66172,SAINT ESTEVE,200027183,CU PERPIGNAN MEDITERRANEE METROPOLE,66,PYRENEES ORIENTALES,40,12,52,13,118,3,121,187
2019,67067,BRUMATH,200067874,CA DE HAGUENAU,67,BAS RHIN,44,36,80,0,119,1,120,201
2019,67267,LINGOLSHEIM,246700488,EUROMETROPOLE DE STRASBOURG,67,BAS RHIN,149,27,176,0,203,6,209,385
2019,67482,STRASBOURG,246700488,EUROMETROPOLE DE STRASBOURG,67,BAS RHIN,3511,593,4104,454,1573,238,1811,6369
2019,68154,ILLZACH,200066009,CA MULHOUSE ALSACE AGGLOMERATION,68,HAUT RHIN,85,2,87,18,72,7,79,184
2019,68166,KINGERSHEIM,200066009,CA MULHOUSE ALSACE AGGLOMERATION,68,HAUT RHIN,75,6,81,0,125,2,127,208
2019,68224,MULHOUSE,200066009,CA MULHOUSE ALSACE AGGLOMERATION,68,HAUT RHIN,1113,18,1131,257,382,19,401,1789
2019,68376,WITTENHEIM,200066009,CA MULHOUSE ALSACE AGGLOMERATION,68,HAUT RHIN,85,7,92,0,106,4,110,202
2019,69027,BRIGNAIS,246900757,CC DE LA VALLEE DU GARON (CCVG),69,RHONE,85,21,106,13,177,2,179,298
2019,69034,CALUIRE ET CUIRE,200046977,METROPOLE DE LYON,69,RHONE,339,98,437,56,482,54,536,1029
2019,69069,CRAPONNE,200046977,METROPOLE DE LYON,69,RHONE,112,32,144,0,159,10,169,313
2019,69081,ECULLY,200046977,METROPOLE DE LYON,69,RHONE,164,22,186,14,216,25,241,441
2019,69091,GIVORS,200046977,METROPOLE DE LYON,69,RHONE,126,12,138,130,150,1,151,419
2019,69152,PIERRE BENITE,200046977,METROPOLE DE LYON,69,RHONE,167,8,175,56,137,1,138,369
2019,69202,SAINTE FOY LES LYON,200046977,METROPOLE DE LYON,69,RHONE,174,53,227,2,225,23,248,476
2019,69256,VAULX EN VELIN,200046977,METROPOLE DE LYON,69,RHONE,384,18,402,204,353,20,373,980
2019,69259,VENISSIEUX,200046977,METROPOLE DE LYON,69,RHONE,414,17,431,636,455,13,468,1535
2019,69266,VILLEURBANNE,200046977,METROPOLE DE LYON,69,RHONE,869,261,1130,447,1865,86,1951,3528
2019,69282,MEYZIEU,200046977,METROPOLE DE LYON,69,RHONE,225,79,304,61,453,16,469,834
2019,69381,LYON 1ER ARRONDISSEMENT,200046977,METROPOLE DE LYON,69,RHONE,275,68,343,9,202,60,262,613
2019,69384,LYON 4E ARRONDISSEMENT,200046977,METROPOLE DE LYON,69,RHONE,400,102,502,21,409,79,488,1011
2019,69387,LYON 7E ARRONDISSEMENT,200046977,METROPOLE DE LYON,69,RHONE,793,181,974,14,880,178,1058,2046
2019,70285,HERICOURT,247000722,CC DU PAYS D'HERICOURT,70,HAUTE SAONE,30,1,31,34,167,1,168,232
2019,70550,VESOUL,247000011,CA DE VESOUL,70,HAUTE SAONE,86,3,89,34,143,2,145,269
2019,71270,MACON,200070308,CA MACONNAIS BEAUJOLAIS AGGLOMERATION,71,SAONE ET LOIRE,286,12,298,47,294,11,305,650
2019,72264,SABLE SUR SARTHE,247200090,CC DE SABLE-SUR-SARTHE,72,SARTHE,45,0,45,37,161,2,163,245
2019,73065,CHAMBERY,200069110,CA DU GRAND CHAMBERY,73,SAVOIE,355,21,376,126,552,34,586,1087
2019,74208,PASSY,200034882,CC PAYS DU MONT-BLANC,74,HAUTE SAVOIE,68,9,77,0,147,6,153,230
2019,75104,PARIS 4E ARRONDISSEMENT,200054781,METROPOLE DU GRAND PARIS,75,PARIS,595,1,596,8,33,97,130,734
2019,75105,PARIS 5E ARRONDISSEMENT,200054781,METROPOLE DU GRAND PARIS,75,PARIS,1025,4,1029,14,16,197,213,1256
2019,75106,PARIS 6E ARRONDISSEMENT,200054781,METROPOLE DU GRAND PARIS,75,PARIS,689,8,697,19,18,205,223,938
2019,75108,PARIS 8E ARRONDISSEMENT,200054781,METROPOLE DU GRAND PARIS,75,PARIS,671,32,703,64,31,326,357,1125
2019,75110,PARIS 10E ARRONDISSEMENT,200054781,METROPOLE DU GRAND PARIS,75,PARIS,1832,123,1955,16,203,678,881,2852
2019,75113,PARIS 13E ARRONDISSEMENT,200054781,METROPOLE DU GRAND PARIS,75,PARIS,3647,74,3721,54,364,394,758,4533
2019,75114,PARIS 14E ARRONDISSEMENT,200054781,METROPOLE DU GRAND PARIS,75,PARIS,2318,160,2478,32,352,466,818,3327
2019,75116,PARIS 16E ARRONDISSEMENT,200054781,METROPOLE DU GRAND PARIS,75,PARIS,1594,224,1818,71,72,1293,1365,3254
2019,76108,BOIS GUILLAUME,200023414,METROPOLE ROUEN NORMANDIE,76,SEINE MARITIME,186,13,199,0,104,19,123,322
2019,76216,DEVILLE LES ROUEN,200023414,METROPOLE ROUEN NORMANDIE,76,SEINE MARITIME,40,7,47,14,183,1,184,244
2019,76217,DIEPPE,247600786,CA DE LA REGION DIEPPOISE,76,SEINE MARITIME,204,2,206,78,185,11,196,480
2019,76259,FECAMP,200069821,CA FECAMP CAUX LITTORAL AGGLOMERATION,76,SEINE MARITIME,126,0,126,36,152,4,156,318
2019,76322,LE GRAND QUEVILLY,200023414,METROPOLE ROUEN NORMANDIE,76,SEINE MARITIME,127,12,139,21,417,3,420,579
2019,76410,MAROMME,200023414,METROPOLE ROUEN NORMANDIE,76,SEINE MARITIME,37,11,48,3,193,1,194,246
2019,76447,MONTIVILLIERS,200084952,CU LE HAVRE SEINE METROPOLE,76,SEINE MARITIME,40,23,63,2,286,8,294,360
2019,76575,SAINT ETIENNE DU ROUVRAY,200023414,METROPOLE ROUEN NORMANDIE,76,SEINE MARITIME,120,11,131,65,457,1,458,653
2019,76758,YVETOT,247600620,CC YVETOT NORMANDIE,76,SEINE MARITIME,62,0,62,3,236,6,242,307
2019,77083,CHAMPS SUR MARNE,200057958,CA PARIS - VALLEE DE LA MARNE,77,SEINE ET MARNE,262,4,266,0,238,9,247,513
2019,77108,CHELLES,200057958,CA PARIS - VALLEE DE LA MARNE,77,SEINE ET MARNE,359,53,412,54,631,22,653,1120
2019,77284,MEAUX,200072130,CA DU PAYS DE MEAUX,77,SEINE ET MARNE,538,10,548,18,592,21,613,1179
2019,77294,MITRY MORY,200055655,CA ROISSY PAYS DE FRANCE,77,SEINE ET MARNE,87,1,88,0,286,4,290,378
2019,77333,NEMOURS,200023240,CC PAYS DE NEMOURS,77,SEINE ET MARNE,0,7,7,8,188,6,194,209
2019,77337,NOISIEL,200057958,CA PARIS - VALLEE DE LA MARNE,77,SEINE ET MARNE,197,2,199,19,108,8,116,334
2019,77390,ROISSY EN BRIE,200057958,CA PARIS - VALLEE DE LA MARNE,77,SEINE ET MARNE,150,10,160,21,287,12,299,481
2019,77468,TORCY,200057958,CA PARIS - VALLEE DE LA MARNE,77,SEINE ET MARNE,294,24,318,19,228,10,238,574
2019,78146,CHATOU,200058519,CA SAINT GERMAIN BOUCLES DE SEINE,78,YVELINES,453,18,471,10,234,94,328,809
2019,78190,CROISSY SUR SEINE,200058519,CA SAINT GERMAIN BOUCLES DE SEINE,78,YVELINES,124,2,126,0,48,26,74,200
2019,78297,GUYANCOURT,200058782,CA DE SAINT QUENTIN EN YVELINES,78,YVELINES,593,7,600,204,288,19,307,1111
2019,78372,MARLY LE ROI,200058519,CA SAINT GERMAIN BOUCLES DE SEINE,78,YVELINES,232,11,243,9,163,14,177,429
2019,78440,LES MUREAUX,200059889,CU GRAND PARIS SEINE ET OISE,78,YVELINES,258,42,300,73,187,2,189,562
2019,78481,LE PECQ,200058519,CA SAINT GERMAIN BOUCLES DE SEINE,78,YVELINES,169,17,186,6,147,24,171,364
2019,78621,TRAPPES,200058782,CA DE SAINT QUENTIN EN YVELINES,78,YVELINES,293,17,310,131,285,8,293,734
2019,78624,TRIEL SUR SEINE,200059889,CU GRAND PARIS SEINE ET OISE,78,YVELINES,45,33,78,0,148,8,156,234
2019,78642,VERNEUIL SUR SEINE,200059889,CU GRAND PARIS SEINE ET OISE,78,YVELINES,76,33,109,1,209,9,218,328
2019,78646,VERSAILLES,247800584,CA VERSAILLES GRAND PARC (CAVGP),78,YVELINES,1199,147,1346,44,548,344,892,2282
2019,79329,THOUARS,247900798,CC DU THOUARSAIS,79,DEUX SEVRES,91,0,91,17,167,3,170,278
2019,80001,ABBEVILLE,200070993,CA DE LA BAIE DE SOMME,80,SOMME,54,17,71,63,322,3,325,460
2019,80021,AMIENS,248000531,CA AMIENS METROPOLE,80,SOMME,1126,78,1204,433,1145,69,1214,2851
2019,81099,GAILLAC,200066124,CA GAILLAC-GRAULHET,81,TARN,62,10,72,9,185,9,194,276
2019,81140,LAVAUR,200034023,CC TARN-AGOUT,81,TARN,125,0,125,16,133,2,135,277
2019,82112,MOISSAC,200066322,CC TERRES DES CONFLUENCES,82,TARN ET GARONNE,55,0,55,43,99,2,101,199
2019,82121,MONTAUBAN,248200099,CA GRAND MONTAUBAN,82,TARN ET GARONNE,464,69,533,129,486,20,506,1168
2019,83023,BRIGNOLES,200068104,CA DE LA PROVENCE VERTE,83,VAR,110,4,114,2,186,7,193,309
2019,83050,DRAGUIGNAN,248300493,CA DRACENIE PROVENCE VERDON AGGLOMERATION,83,VAR,236,15,251,23,272,20,292,566
2019,83062,LA GARDE,248300543,METROPOLE TOULON-PROVENCE-MEDITERRANEE,83,VAR,280,15,295,5,159,19,178,478
2019,83069,HYERES,248300543,METROPOLE TOULON-PROVENCE-MEDITERRANEE,83,VAR,383,25,408,9,286,24,310,727
2019,83112,SAINT CYR SUR MER,248300394,CA SUD SAINTE BAUME,83,VAR,60,3,63,0,109,8,117,180
2019,83118,SAINT RAPHAEL,200035319,CA VAR ESTEREL MEDITERRANEE (CAVEM),83,VAR,207,18,225,20,157,12,169,414
2019,84003,APT,200040624,CC PAYS D'APT-LUBERON,84,VAUCLUSE,80,0,80,31,75,4,79,190
2019,84019,BOLLENE,200000628,CC RHONE LEZ PROVENCE,84,VAUCLUSE,70,5,75,36,132,3,135,247
2019,84035,CAVAILLON,200040442,CA LUBERON MONTS DE VAUCLUSE,84,VAUCLUSE,200,2,202,0,136,7,143,346
2019,84054,L'ISLE SUR LA SORGUE,248400319,CC DU PAYS DES SORGUES ET DES MONTS DE VAUCLUSE,84,VAUCLUSE,105,12,117,0,131,5,136,253
2019,85092,FONTENAY LE COMTE,200071934,CC DU PAYS DE FONTENAY-VENDEE,85,VENDEE,24,0,24,27,150,1,151,202
2019,85146,MONTAIGU VENDEE,200070233,CC TERRES DE MONTAIGU,85,VENDEE,98,19,117,31,457,12,469,617
2019,85191,LA ROCHE SUR YON,248500589,CA LA ROCHE SUR YON - AGGLOMERATION,85,VENDEE,390,20,410,98,539,33,572,1080
2019,86041,BUXEROLLES,200069854,CU DU GRAND POITIERS,86,VIENNE,30,0,30,0,160,2,162,193
2019,87085,LIMOGES,248719312,CU LIMOGES METROPOLE,87,HAUTE VIENNE,924,54,978,171,852,72,924,2073
2019,87154,SAINT JUNIEN,200059400,CC PORTE OCEANE DU LIMOUSIN,87,HAUTE VIENNE,40,1,41,0,136,3,139,179
2019,88160,EPINAL,200068757,CA D'EPINAL,88,VOSGES,225,1,226,63,278,3,281,570
2019,91103,BRETIGNY SUR ORGE,200057859,CA COEUR D'ESSONNE AGGLOMERATION,91,ESSONNE,253,25,278,0,436,9,445,724
2019,91161,CHILLY MAZARIN,200056232,CA COMMUNAUTE PARIS-SACLAY,91,ESSONNE,198,7,205,0,224,5,229,434
2019,91201,DRAVEIL,200058477,CA VAL D'YERRES VAL DE SEINE,91,ESSONNE,356,11,367,20,291,16,307,694
2019,91215,EPINAY SOUS SENART,200058477,CA VAL D'YERRES VAL DE SEINE,91,ESSONNE,101,1,102,33,133,6,139,273
2019,91223,ETAMPES,200017846,CA ETAMPOIS SUD ESSONNE,91,ESSONNE,238,19,257,32,197,11,208,497
2019,91286,GRIGNY,200059228,CA GRAND PARIS SUD SEINE ESSONNE SENART,91,ESSONNE,177,2,179,179,139,3,142,500
2019,91432,MORANGIS,200054781,METROPOLE DU GRAND PARIS,91,ESSONNE,125,1,126,0,180,6,186,312
2019,91589,SAVIGNY SUR ORGE,200054781,METROPOLE DU GRAND PARIS,91,ESSONNE,222,11,233,15,475,10,485,733
2019,91661,VILLEBON SUR YVETTE,200056232,CA COMMUNAUTE PARIS-SACLAY,91,ESSONNE,240,7,247,1,64,4,68,315
2019,91687,VIRY CHATILLON,200054781,METROPOLE DU GRAND PARIS,91,ESSONNE,356,19,375,16,333,9,342,733
2019,91692,LES ULIS,200056232,CA COMMUNAUTE PARIS-SACLAY,91,ESSONNE,294,2,296,19,271,2,273,589
2019,92007,BAGNEUX,200054781,METROPOLE DU GRAND PARIS,92,HAUTS DE SEINE,420,32,452,103,398,50,448,1003
2019,92019,CHATENAY MALABRY,200054781,METROPOLE DU GRAND PARIS,92,HAUTS DE SEINE,446,7,453,38,208,43,251,742
2019,92020,CHATILLON,200054781,METROPOLE DU GRAND PARIS,92,HAUTS DE SEINE,513,73,586,0,296,106,402,988
2019,92022,CHAVILLE,200054781,METROPOLE DU GRAND PARIS,92,HAUTS DE SEINE,248,28,276,2,149,90,239,517
2019,92026,COURBEVOIE,200054781,METROPOLE DU GRAND PARIS,92,HAUTS DE SEINE,1944,95,2039,33,629,332,961,3034
2019,92032,FONTENAY AUX ROSES,200054781,METROPOLE DU GRAND PARIS,92,HAUTS DE SEINE,289,21,310,0,177,22,199,510
2019,92033,GARCHES,200054781,METROPOLE DU GRAND PARIS,92,HAUTS DE SEINE,359,4,363,0,70,68,138,501
2019,92036,GENNEVILLIERS,200054781,METROPOLE DU GRAND PARIS,92,HAUTS DE SEINE,711,5,716,203,223,37,260,1179
2019,92044,LEVALLOIS PERRET,200054781,METROPOLE DU GRAND PARIS,92,HAUTS DE SEINE,1188,179,1367,51,251,750,1001,2419
2019,92048,MEUDON,200054781,METROPOLE DU GRAND PARIS,92,HAUTS DE SEINE,637,34,671,11,301,145,446,1128
2019,92050,NANTERRE,200054781,METROPOLE DU GRAND PARIS,92,HAUTS DE SEINE,1403,35,1438,174,776,161,937,2549
2019,92051,NEUILLY SUR SEINE,200054781,METROPOLE DU GRAND PARIS,92,HAUTS DE SEINE,764,38,802,20,29,632,661,1483
2019,92064,SAINT CLOUD,200054781,METROPOLE DU GRAND PARIS,92,HAUTS DE SEINE,482,37,519,7,138,163,301,827
2019,92072,SEVRES,200054781,METROPOLE DU GRAND PARIS,92,HAUTS DE SEINE,295,16,311,5,213,74,287,603
2019,92073,SURESNES,200054781,METROPOLE DU GRAND PARIS,92,HAUTS DE SEINE,782,78,860,34,503,265,768,1662
2019,92078,VILLENEUVE LA GARENNE,200054781,METROPOLE DU GRAND PARIS,92,HAUTS DE SEINE,354,2,356,26,89,11,100,482
2019,93005,AULNAY SOUS BOIS,200054781,METROPOLE DU GRAND PARIS,93,SEINE SAINT DENIS,791,15,806,110,354,30,384,1299
2019,93006,BAGNOLET,200054781,METROPOLE DU GRAND PARIS,93,SEINE SAINT DENIS,341,17,358,34,170,48,218,610
2019,93008,BOBIGNY,200054781,METROPOLE DU GRAND PARIS,93,SEINE SAINT DENIS,598,0,598,73,144,14,158,830
2019,93013,LE BOURGET,200054781,METROPOLE DU GRAND PARIS,93,SEINE SAINT DENIS,141,0,141,0,66,6,72,213
2019,93031,EPINAY SUR SEINE,200054781,METROPOLE DU GRAND PARIS,93,SEINE SAINT DENIS,419,10,429,98,305,20,325,852
2019,93047,MONTFERMEIL,200054781,METROPOLE DU GRAND PARIS,93,SEINE SAINT DENIS,227,4,231,20,129,9,138,389
2019,93051,NOISY LE GRAND,200054781,METROPOLE DU GRAND PARIS,93,SEINE SAINT DENIS,644,11,655,60,604,27,631,1346
2019,93053,NOISY LE SEC,200054781,METROPOLE DU GRAND PARIS,93,SEINE SAINT DENIS,330,3,333,9,228,29,257,598
2019,93059,PIERREFITTE SUR SEINE,200054781,METROPOLE DU GRAND PARIS,93,SEINE SAINT DENIS,220,9,229,19,125,10,135,383
2019,93062,LE RAINCY,200054781,METROPOLE DU GRAND PARIS,93,SEINE SAINT DENIS,159,13,172,0,143,16,159,331
2019,93078,VILLEPINTE,200054781,METROPOLE DU GRAND PARIS,93,SEINE SAINT DENIS,264,2,266,7,176,8,184,456
2019,94015,BRY SUR MARNE,200054781,METROPOLE DU GRAND PARIS,94,VAL DE MARNE,299,4,303,12,113,25,138,454
2019,94021,CHEVILLY LARUE,200054781,METROPOLE DU GRAND PARIS,94,VAL DE MARNE,236,6,242,1,149,5,154,397
2019,94022,CHOISY LE ROI,200054781,METROPOLE DU GRAND PARIS,94,VAL DE MARNE,502,40,542,44,414,18,432,1018
2019,94028,CRETEIL,200054781,METROPOLE DU GRAND PARIS,94,VAL DE MARNE,1488,17,1505,87,385,55,440,2032
2019,94033,FONTENAY SOUS BOIS,200054781,METROPOLE DU GRAND PARIS,94,VAL DE MARNE,514,36,550,49,403,127,530,1130
2019,94041,IVRY SUR SEINE,200054781,METROPOLE DU GRAND PARIS,94,VAL DE MARNE,750,96,846,93,318,54,372,1312
2019,94052,NOGENT SUR MARNE,200054781,METROPOLE DU GRAND PARIS,94,VAL DE MARNE,520,44,564,19,152,152,304,887
2019,94060,LA QUEUE EN BRIE,200054781,METROPOLE DU GRAND PARIS,94,VAL DE MARNE,75,1,76,0,109,2,111,187
2019,94067,SAINT MANDE,200054781,METROPOLE DU GRAND PARIS,94,VAL DE MARNE,455,34,489,0,44,205,249,738
2019,94069,SAINT MAURICE,200054781,METROPOLE DU GRAND PARIS,94,VAL DE MARNE,232,13,245,0,84,55,139,384
2019,94076,VILLEJUIF,200054781,METROPOLE DU GRAND PARIS,94,VAL DE MARNE,648,32,680,74,355,49,404,1158
2019,94077,VILLENEUVE LE ROI,200054781,METROPOLE DU GRAND PARIS,94,VAL DE MARNE,238,4,242,0,125,7,132,375
2019,95019,ARNOUVILLE,200055655,CA ROISSY PAYS DE FRANCE,95,VAL D OISE,110,1,111,2,74,1,75,188
2019,95127,CERGY,249500109,CA DE CERGY-PONTOISE,95,VAL D OISE,629,37,666,88,757,35,792,1546
2019,95197,DEUIL LA BARRE,200056380,CA PLAINE VALLEE,95,VAL D OISE,80,33,113,16,320,10,330,459
2019,95203,EAUBONNE,200058485,CA VAL PARISIS,95,VAL D OISE,362,13,375,1,356,22,378,754
2019,95277,GONESSE,200055655,CA ROISSY PAYS DE FRANCE,95,VAL D OISE,274,1,275,30,139,8,147,452
2019,95280,GOUSSAINVILLE,200055655,CA ROISSY PAYS DE FRANCE,95,VAL D OISE,116,1,117,20,175,4,179,316
2019,95323,JOUY LE MOUTIER,249500109,CA DE CERGY-PONTOISE,95,VAL D OISE,132,10,142,0,237,5,242,384
2019,95607,TAVERNY,200058485,CA VAL PARISIS,95,VAL D OISE,177,4,181,3,398,6,404,588
2019,95637,VAUREAL,249500109,CA DE CERGY-PONTOISE,95,VAL D OISE,113,11,124,0,258,2,260,385
2019,97103,BAIE MAHAULT,200018653,CA CAP EXCELLENCE,971,GUADELOUPE,151,50,201,69,238,13,251,522
2019,97117,LE MOULE,200044691,CA DU NORD GRANDE TERRE,971,GUADELOUPE,0,57,57,50,78,9,87,194
2019,97124,SAINT CLAUDE,249710070,CA GRAND SUD CARAIBE,971,GUADELOUPE,40,11,51,21,42,3,45,118
2019,97210,LE FRANCOIS,249720053,CA DE L'ESPACE SUD DE LA MARTINIQUE,972,MARTINIQUE,123,21,144,66,62,5,67,277
2019,97221,RIVIERE SALEE,249720053,CA DE L'ESPACE SUD DE LA MARTINIQUE,972,MARTINIQUE,0,8,8,51,66,4,70,128
2019,97229,SCHOELCHER,249720061,CA DU CENTRE DE LA MARTINIQUE,972,MARTINIQUE,172,8,180,51,59,10,69,300
2019,97302,CAYENNE,249730045,CA DU CENTRE LITTORAL,973,GUYANE,627,14,641,0,147,21,168,808
2019,97304,KOUROU,200027548,CC DES SAVANES,973,GUYANE,340,0,340,27,75,31,106,473
2019,97309,REMIRE MONTJOLY,249730045,CA DU CENTRE LITTORAL,973,GUYANE,267,11,278,5,107,16,123,406
2019,97411,SAINT DENIS,249740119,CA INTERCOMMUNALE DU NORD DE LA REUNION (CINOR),974,LA REUNION,1329,604,1933,335,355,88,443,2710
2019,97413,SAINT LEU,249740101,CA TERRITOIRE DE LA COTE OUEST (TCO),974,LA REUNION,147,126,273,26,193,55,248,547
2019,97416,SAINT PIERRE,249740077,CA CIVIS (COMMUNAUTE INTERCOMMUNALE DES VILLES SOLIDAIRES),974,LA REUNION,493,387,880,130,370,77,447,1457
2019,97418,SAINTE MARIE,249740119,CA INTERCOMMUNALE DU NORD DE LA REUNION (CINOR),974,LA REUNION,420,197,617,14,160,26,186,817
2019,97801,SAINT-MARTIN,XX,XX,978,COLLECTIVITE D'OUTRE MER SAINT MARTIN,50,0,50,114,59,2,61,225
2020,01004,AMBERIEU EN BUGEY,240100883,CC DE LA PLAINE DE L'AIN,01,AIN,98,5,103,0,283,7,290,393
2020,01053,BOURG EN BRESSE,200071751,CA DU BASSIN DE BOURG-EN-BRESSE,01,AIN,338,16,354,58,320,10,330,742
2020,01160,FERNEY VOLTAIRE,240100750,CA DU PAYS DE GEX,01,AIN,50,4,54,4,94,2,96,153
2020,01249,MIRIBEL,240100800,CC DE MIRIBEL ET DU PLATEAU,01,AIN,102,6,108,6,150,3,153,267
2020,01320,REPLONGES,200071371,CC BRESSE ET SAONE,01,AIN,18,0,18,0,102,1,103,121
2020,01325,RIGNIEUX LE FRANC,240100883,CC DE LA PLAINE DE L'AIN,01,AIN,0,0,0,0,27,0,27,28
2020,01354,SAINT GENIS POUILLY,240100750,CA DU PAYS DE GEX,01,AIN,82,4,86,0,146,3,149,236
2020,02408,LAON,200043495,CA DU PAYS DE LAON,02,AISNE,116,4,120,33,219,4,223,376
2020,02691,SAINT QUENTIN,200071892,CA DU SAINT-QUENTINOIS,02,AISNE,178,69,247,171,376,22,398,816
2020,02738,TERGNIER,200071785,CA CHAUNY TERGNIER LA FERE,02,AISNE,30,10,40,30,156,1,157,227
2020,03185,MONTLUCON,200071082,CA MONTLUCON COMMUNAUTE,03,ALLIER,145,1,146,62,292,5,297,505
2020,03190,MOULINS,200071140,CA MOULINS COMMUNAUTE,03,ALLIER,120,0,120,42,149,8,157,319
2020,03310,VICHY,200071363,CA VICHY COMMUNAUTE,03,ALLIER,162,1,163,53,148,10,158,374
2020,03321,YZEURE,200071140,CA MOULINS COMMUNAUTE,03,ALLIER,102,0,102,8,113,5,118,228
2020,04070,DIGNE LES BAINS,200067437,CA PROVENCE-ALPES-AGGLOMERATION,04,ALPES DE HAUTE PROVENCE,102,11,113,10,116,3,119,241
2020,05023,BRIANCON,240500439,CC DU BRIANCONNAIS,05,HAUTES ALPES,105,4,109,14,63,3,66,189
2020,05061,GAP,200067825,CA GAP-TALLARD-DURANCE,05,HAUTES ALPES,328,4,332,24,267,5,272,628
2020,06027,CAGNES SUR MER,200030195,METROPOLE NICE COTE D'AZUR,06,ALPES MARITIMES,390,32,422,17,414,12,426,865
2020,06029,CANNES,200039915,CA CANNES PAYS DE LERINS,06,ALPES MARITIMES,722,43,765,17,236,24,260,1043
2020,06079,MANDELIEU LA NAPOULE,200039915,CA CANNES PAYS DE LERINS,06,ALPES MARITIMES,213,12,225,0,113,11,124,349
2020,06149,LA TRINITE,200030195,METROPOLE NICE COTE D'AZUR,06,ALPES MARITIMES,83,2,85,13,68,0,68,165
2020,06152,VALBONNE,240600585,CA DE SOPHIA ANTIPOLIS,06,ALPES MARITIMES,206,2,208,0,154,8,162,370
2020,06155,VALLAURIS,240600585,CA DE SOPHIA ANTIPOLIS,06,ALPES MARITIMES,226,16,242,21,140,5,145,408
2020,07019,AUBENAS,200073245,CC DU BASSIN D'AUBENAS,07,ARDECHE,80,0,80,17,70,6,76,173
2020,12176,ONET LE CHATEAU,241200187,CA RODEZ AGGLOMERATION,12,AVEYRON,55,16,71,29,145,0,145,245
2020,13002,ALLAUCH,200054807,METROPOLE D'AIX-MARSEILLE-PROVENCE,13,BOUCHES DU RHONE,181,22,203,0,159,5,164,368
2020,13005,AUBAGNE,200054807,METROPOLE D'AIX-MARSEILLE-PROVENCE,13,BOUCHES DU RHONE,322,30,352,37,384,19,403,792
2020,13014,BERRE L ETANG,200054807,METROPOLE D'AIX-MARSEILLE-PROVENCE,13,BOUCHES DU RHONE,72,7,79,10,43,3,46,135
2020,13027,CHATEAURENARD,200035087,CA TERRE DE PROVENCE,13,BOUCHES DU RHONE,70,23,93,0,163,8,171,264
2020,13039,FOS SUR MER,200054807,METROPOLE D'AIX-MARSEILLE-PROVENCE,13,BOUCHES DU RHONE,150,0,150,0,106,3,109,259
2020,13054,MARIGNANE,200054807,METROPOLE D'AIX-MARSEILLE-PROVENCE,13,BOUCHES DU RHONE,276,27,303,0,279,7,286,589
2020,13063,MIRAMAS,200054807,METROPOLE D'AIX-MARSEILLE-PROVENCE,13,BOUCHES DU RHONE,162,3,165,35,129,6,135,335
2020,13069,PELISSANNE,200054807,METROPOLE D'AIX-MARSEILLE-PROVENCE,13,BOUCHES DU RHONE,72,5,77,3,108,3,111,191
2020,13202,MARSEILLE 2E ARRONDISSEMENT,200054807,METROPOLE D'AIX-MARSEILLE-PROVENCE,13,BOUCHES DU RHONE,334,24,358,31,58,12,70,459
2020,13203,MARSEILLE 3E ARRONDISSEMENT,200054807,METROPOLE D'AIX-MARSEILLE-PROVENCE,13,BOUCHES DU RHONE,401,16,417,97,109,16,125,639
2020,13207,MARSEILLE 7E ARRONDISSEMENT,200054807,METROPOLE D'AIX-MARSEILLE-PROVENCE,13,BOUCHES DU RHONE,350,81,431,20,264,69,333,784
2020,13208,MARSEILLE 8E ARRONDISSEMENT,200054807,METROPOLE D'AIX-MARSEILLE-PROVENCE,13,BOUCHES DU RHONE,776,175,951,5,549,213,762,1719
2020,14047,BAYEUX,241400555,CC DE BAYEUX INTERCOM,14,CALVADOS,40,6,46,14,200,7,207,267
2020,14341,IFS,200065597,CU CAEN LA MER,14,CALVADOS,58,10,68,0,186,2,188,257
2020,15014,AURILLAC,241500230,CA DU BASSIN D'AURILLAC,15,CANTAL,175,3,178,28,215,10,225,430
2020,16015,ANGOULEME,200071827,CA DU GRAND ANGOULEME,16,CHARENTE,315,15,330,68,191,17,208,606
2020,17415,SAINTES,200036473,CA DE SAINTES,17,CHARENTE MARITIME,134,0,134,11,275,17,292,437
2020,18033,BOURGES,241800507,CA BOURGES PLUS,18,CHER,271,11,282,74,733,13,746,1102
2020,19272,TULLE,241927201,CA TULLE AGGLO,19,CORREZE,153,1,154,28,66,4,70,252
2020,21231,DIJON,242100410,DIJON METROPOLE,21,COTE D OR,1621,186,1807,146,937,105,1042,2995
2020,22113,LANNION,200065928,CA LANNION-TREGOR COMMUNAUTE,22,COTES D ARMOR,130,0,130,51,217,5,222,403
2020,23096,GUERET,200034825,CA DU GRAND GUERET,23,CREUSE,82,0,82,21,145,0,145,248
2020,24322,PERIGUEUX,200040392,CA LE GRAND PERIGUEUX,24,DORDOGNE,288,6,294,31,154,15,169,494
2020,25388,MONTBELIARD,200065647,CA PAYS DE MONTBELIARD AGGLOMERATION,25,DOUBS,153,1,154,35,135,3,138,327
2020,25462,PONTARLIER,242500338,CC DU GRAND PONTARLIER,25,DOUBS,123,19,142,0,194,1,195,337
2020,26252,PORTES LES VALENCE,200068781,CA VALENCE ROMANS AGGLO,26,DROME,40,2,42,3,160,0,160,205
2020,27229,EVREUX,200071454,CA EVREUX PORTES DE NORMANDIE,27,EURE,498,24,522,74,370,7,377,972
2020,27375,LOUVIERS,200089456,CA SEINE-EURE,27,EURE,213,0,213,24,193,1,194,431
2020,28229,MAINVILLIERS,200033181,CA CHARTRES METROPOLE,28,EURE ET LOIR,79,2,81,41,112,2,114,235
2020,29189,PLOUGASTEL DAOULAS,242900314,BREST METROPOLE,29,FINISTERE,56,0,56,54,224,8,232,342
2020,2A247,PORTO VECCHIO,200040764,CC DU SUD CORSE,2A,CORSE DU SUD,88,0,88,12,32,7,39,139
2020,30189,NIMES,243000643,CA DE NIMES METROPOLE,30,GARD,1149,9,1158,130,572,107,679,1967
2020,30202,PONT SAINT ESPRIT,200034692,CA DU GARD RHODANIEN,30,GARD,60,3,63,18,75,0,75,156
2020,31044,BALMA,243100518,TOULOUSE METROPOLE,31,HAUTE GARONNE,214,10,224,0,147,30,177,402
2020,31149,COLOMIERS,243100518,TOULOUSE METROPOLE,31,HAUTE GARONNE,377,6,383,0,371,16,387,770
2020,31157,CUGNAUX,243100518,TOULOUSE METROPOLE,31,HAUTE GARONNE,207,21,228,0,231,15,246,475
2020,31395,MURET,200068641,CA LE MURETAIN AGGLO,31,HAUTE GARONNE,173,2,175,2,293,8,301,477
2020,31588,VILLENEUVE TOLOSANE,243100518,TOULOUSE METROPOLE,31,HAUTE GARONNE,69,16,85,0,148,4,152,237
2020,33003,AMBARES ET LAGRAVE,243300316,BORDEAUX METROPOLE,33,GIRONDE,109,27,136,5,276,2,278,420
2020,33039,BEGLES,243300316,BORDEAUX METROPOLE,33,GIRONDE,196,36,232,3,413,18,431,666
2020,33051,BIGANOS,243301504,CA DU BASSIN D'ARCACHON NORD,33,GIRONDE,50,20,70,0,159,6,165,235
2020,33069,LE BOUSCAT,243300316,BORDEAUX METROPOLE,33,GIRONDE,222,50,272,0,231,37,268,539
2020,33199,GUJAN MESTRAS,243300563,CA BASSIN D'ARCACHON SUD (COBAS),33,GIRONDE,108,14,122,3,223,5,228,353
2020,33243,LIBOURNE,200070092,CA DU LIBOURNAIS,33,GIRONDE,222,7,229,1,211,10,221,451
2020,33284,MIOS,243301504,CA DU BASSIN D'ARCACHON NORD,33,GIRONDE,20,13,33,0,254,2,256,289
2020,33366,SAINT ANDRE DE CUBZAC,243301223,CC DU GRAND CUBZAGUAIS,33,GIRONDE,46,10,56,0,299,2,301,357
2020,33522,TALENCE,243300316,BORDEAUX METROPOLE,33,GIRONDE,390,79,469,11,382,46,428,908
2020,33550,VILLENAVE D ORNON,243300316,BORDEAUX METROPOLE,33,GIRONDE,276,37,313,12,560,14,574,899
2020,34057,CASTELNAU LE LEZ,243400017,MONTPELLIER MEDITERRANEE METROPOLE,34,HERAULT,204,16,220,21,149,35,184,425
2020,34108,FRONTIGNAN,200066355,CA SETE AGGLOPOLE MEDITERRANEE,34,HERAULT,127,18,145,15,180,7,187,347
2020,34255,SAINT GELY DU FESC,200022986,CC DU GRAND PIC SAINT-LOUP,34,HERAULT,63,9,72,0,111,6,117,189
2020,35047,BRUZ,243500139,RENNES METROPOLE,35,ILLE ET VILAINE,75,44,119,41,253,5,258,417
2020,35069,CHATEAUGIRON,243500659,CC PAYS DE CHATEAUGIRON COMMUNAUTE,35,ILLE ET VILAINE,35,17,52,32,255,3,258,342
2020,37050,CHAMBRAY LES TOURS,243700754,TOURS METROPOLE VAL DE LOIRE,37,INDRE ET LOIRE,103,8,111,0,181,4,185,296
2020,37109,FONDETTES,243700754,TOURS METROPOLE VAL DE LOIRE,37,INDRE ET LOIRE,70,3,73,0,166,9,175,247
2020,37214,SAINT CYR SUR LOIRE,243700754,TOURS METROPOLE VAL DE LOIRE,37,INDRE ET LOIRE,77,22,99,3,159,6,165,267
2020,37233,SAINT PIERRE DES CORPS,243700754,TOURS METROPOLE VAL DE LOIRE,37,INDRE ET LOIRE,81,13,94,58,237,6,243,395
2020,37261,TOURS,243700754,TOURS METROPOLE VAL DE LOIRE,37,INDRE ET LOIRE,1183,214,1397,107,1146,129,1275,2779
2020,38053,BOURGOIN JALLIEU,243800604,CA PORTE DE L'ISERE (CAPI),38,ISERE,88,53,141,27,329,6,335,503
2020,38151,ECHIROLLES,200040715,GRENOBLE-ALPES-METROPOLE,38,ISERE,303,22,325,86,377,12,389,800
2020,38185,GRENOBLE,200040715,GRENOBLE-ALPES-METROPOLE,38,ISERE,1639,311,1950,156,1403,96,1499,3605
2020,38563,VOIRON,243800984,CA DU PAYS VOIRONNAIS,38,ISERE,166,26,192,1,257,10,267,460
2020,42186,RIVE DE GIER,244200770,SAINT-ETIENNE METROPOLE,42,LOIRE,55,28,83,0,166,2,168,252
2020,42187,ROANNE,200035731,CA ROANNAIS AGGLOMERATION,42,LOIRE,197,16,213,22,266,8,274,509
2020,42207,SAINT CHAMOND,244200770,SAINT-ETIENNE METROPOLE,42,LOIRE,198,24,222,64,334,10,344,630
2020,42218,SAINT ETIENNE,244200770,SAINT-ETIENNE METROPOLE,42,LOIRE,1003,98,1101,145,1116,73,1189,2435
2020,44003,ANCENIS SAINT GEREON,244400552,CC DU PAYS D'ANCENIS,44,LOIRE ATLANTIQUE,40,2,42,11,232,6,238,291
2020,44036,CHATEAUBRIANT,200072726,CC CHATEAUBRIANT-DERVAL,44,LOIRE ATLANTIQUE,56,0,56,23,126,2,128,207
2020,44109,NANTES,244400404,NANTES METROPOLE,44,LOIRE ATLANTIQUE,3397,343,3740,382,3090,789,3879,8001
2020,44129,PONTCHATEAU,200000438,CC DU PAYS DE PONTCHATEAU ST-GILDAS-DES-BOIS,44,LOIRE ATLANTIQUE,23,5,28,17,277,3,280,325
2020,44131,PORNIC,200067346,CA PORNIC AGGLO PAYS DE RETZ,44,LOIRE ATLANTIQUE,35,17,52,14,223,8,231,297
2020,44132,PORNICHET,244400644,CA DE LA REGION NAZAIRIENNE ET DE L'ESTUAIRE (CARENE),44,LOIRE ATLANTIQUE,50,9,59,9,107,7,114,182
2020,44154,SAINT BREVIN LES PINS,244400586,CC DU SUD ESTUAIRE,44,LOIRE ATLANTIQUE,42,15,57,4,169,7,176,237
2020,45004,AMILLY,244500203,CA MONTARGOISE ET RIVES DU LOING (AME),45,LOIRET,110,4,114,0,170,5,175,288
2020,45075,LA CHAPELLE SAINT MESMIN,244500468,ORLEANS METROPOLE,45,LOIRET,59,17,76,0,156,7,163,239
2020,45155,GIEN,244500211,CC GIENNOISES,45,LOIRET,80,6,86,12,125,2,127,226
2020,45234,ORLEANS,244500468,ORLEANS METROPOLE,45,LOIRET,1134,127,1261,96,948,95,1043,2400
2020,46042,CAHORS,200023737,CA DU GRAND CAHORS,46,LOT,149,0,149,13,186,4,190,352
2020,48095,MENDE,244800405,CC COEUR DE LOZERE,48,LOZERE,111,0,111,44,106,1,107,262
2020,49007,ANGERS,244900015,CU ANGERS LOIRE METROPOLE,49,MAINE ET LOIRE,1158,172,1330,224,1297,134,1431,2985
2020,49092,CHEMILLE EN ANJOU,200060010,CA MAUGES COMMUNAUTE,49,MAINE ET LOIRE,36,31,67,28,433,5,438,533
2020,49218,MONTREVAULT SUR EVRE,200060010,CA MAUGES COMMUNAUTE,49,MAINE ET LOIRE,36,2,38,31,233,7,240,309
2020,49244,MAUGES SUR LOIRE,200060010,CA MAUGES COMMUNAUTE,49,MAINE ET LOIRE,36,2,38,33,363,7,370,441
2020,49301,SEVREMOINE,200060010,CA MAUGES COMMUNAUTE,49,MAINE ET LOIRE,36,24,60,60,551,5,556,676
2020,49307,LOIRE AUTHION,244900015,CU ANGERS LOIRE METROPOLE,49,MAINE ET LOIRE,30,15,45,28,283,7,290,364
2020,50041,LA HAGUE,200067205,CA DU COTENTIN,50,MANCHE,22,0,22,18,227,3,230,270
2020,52448,SAINT DIZIER,200068666,CA DE SAINT-DIZIER DER ET BLAISE,52,HAUTE MARNE,137,0,137,63,191,8,199,399
2020,53062,CHATEAU GONTIER SUR MAYENNE,245300447,CC DU PAYS DE CHATEAU-GONTIER,53,MAYENNE,75,0,75,34,313,8,321,430
2020,53130,LAVAL,200083392,CA LAVAL AGGLOMERATION,53,MAYENNE,345,30,375,121,483,33,516,1012
2020,54395,NANCY,245400676,METROPOLE DU GRAND NANCY,54,MEURTHE ET MOSELLE,1024,56,1080,101,425,110,535,1716
2020,54528,TOUL,200070563,CC TERRES TOULOISES,54,MEURTHE ET MOSELLE,110,0,110,17,145,4,149,276
2020,55545,VERDUN,200049187,CA DU GRAND VERDUN,55,MEUSE,82,15,97,43,139,4,143,283
2020,56007,AURAY,200043123,CC AURAY QUIBERON TERRE ATLANTIQUE,56,MORBIHAN,45,0,45,64,134,5,139,248
2020,56121,LORIENT,200042174,CA LORIENT AGGLOMERATION,56,MORBIHAN,286,14,300,237,518,23,541,1079
2020,56260,VANNES,200067932,CA GOLFE DU MORBIHAN - VANNES AGGLOMERATION,56,MORBIHAN,414,20,434,199,313,38,351,985
2020,57160,CREUTZWALD,245701164,CC DU WARNDT,57,MOSELLE,58,1,59,31,84,0,84,174
2020,57206,FAMECK,245701222,CA DU VAL DE FENSCH,57,MOSELLE,50,14,64,40,125,0,125,228
2020,57227,FORBACH,245700372,CA DE FORBACH PORTE DE FRANCE,57,MOSELLE,47,0,47,20,101,0,101,168
2020,57660,STIRING WENDEL,245700372,CA DE FORBACH PORTE DE FRANCE,57,MOSELLE,40,0,40,22,47,0,47,109
2020,57757,YUTZ,245701362,CA PORTES DE FRANCE-THIONVILLE,57,MOSELLE,101,24,125,10,180,4,184,318
2020,59008,ANICHE,245901152,CC COEUR D'OSTREVENT (CCCO),59,NORD,19,6,25,40,67,1,68,133
2020,59014,ANZIN,245901160,CA VALENCIENNES METROPOLE,59,NORD,37,2,39,70,91,0,91,200
2020,59152,COMINES,200093201,METROPOLE EUROPEENNE DE LILLE,59,NORD,42,10,52,43,146,2,148,243
2020,59163,CROIX,200093201,METROPOLE EUROPEENNE DE LILLE,59,NORD,119,67,186,64,281,17,298,547
2020,59271,GRANDE SYNTHE,245900428,CU DE DUNKERQUE,59,NORD,150,4,154,138,139,0,139,430
2020,59291,HAUTMONT,200043396,CA MAUBEUGE VAL DE SAMBRE,59,NORD,26,2,28,49,87,0,87,164
2020,59299,HEM,200093201,METROPOLE EUROPEENNE DE LILLE,59,NORD,125,73,198,81,206,17,223,502
2020,59367,LYS LEZ LANNOY,200093201,METROPOLE EUROPEENNE DE LILLE,59,NORD,44,22,66,54,173,7,180,301
2020,59410,MONS EN BAROEUL,200093201,METROPOLE EUROPEENNE DE LILLE,59,NORD,140,22,162,96,252,7,259,516
2020,59426,NEUVILLE EN FERRAIN,200093201,METROPOLE EUROPEENNE DE LILLE,59,NORD,77,20,97,66,108,4,112,275
2020,59491,RAISMES,200042190,CA DE LA PORTE DU HAINAUT,59,NORD,53,1,54,41,103,3,106,201
2020,59508,RONCQ,200093201,METROPOLE EUROPEENNE DE LILLE,59,NORD,107,25,132,46,147,9,156,335
2020,59512,ROUBAIX,200093201,METROPOLE EUROPEENNE DE LILLE,59,NORD,946,53,999,331,366,29,395,1725
2020,59526,SAINT AMAND LES EAUX,200042190,CA DE LA PORTE DU HAINAUT,59,NORD,85,1,86,18,213,8,221,326
2020,59560,SECLIN,200093201,METROPOLE EUROPEENNE DE LILLE,59,NORD,118,24,142,31,151,5,156,329
2020,60141,CHANTILLY,246000764,CC DE L'AIRE CANTILIENNE,60,OISE,138,2,140,3,141,6,147,290
2020,60157,CLERMONT,246000376,CC DU CLERMONTOIS,60,OISE,65,2,67,8,124,2,126,200
2020,60159,COMPIEGNE,200067965,CA DE LA REGION DE COMPIEGNE ET DE LA BASSE AUTOMNE,60,OISE,408,8,416,61,237,33,270,747
2020,60176,CREPY EN VALOIS,246000871,CC DU PAYS DE VALOIS,60,OISE,97,4,101,10,215,7,222,333
2020,60414,MONTATAIRE,200068047,CA CREIL SUD OISE,60,OISE,101,1,102,26,113,1,114,242
2020,60463,NOGENT SUR OISE,200068047,CA CREIL SUD OISE,60,OISE,110,0,110,39,164,3,167,316
2020,61001,ALENCON,246100663,CU D'ALENCON,61,ORNE,177,0,177,69,252,5,257,503
2020,61006,ARGENTAN,200068450,CC ARGENTAN INTERCOM,61,ORNE,82,0,82,19,174,2,176,277
2020,62108,BERCK,200069029,CA DES DEUX BAIES EN MONTREUILLOIS,62,PAS DE CALAIS,136,6,142,29,67,0,67,238
2020,62186,BULLY LES MINES,246200364,CA DE LENS - LIEVIN,62,PAS DE CALAIS,30,12,42,26,109,1,110,179
2020,62215,CARVIN,246200299,CA D'HENIN-CARVIN,62,PAS DE CALAIS,60,15,75,22,261,4,265,362
2020,62318,ETAPLES,200069029,CA DES DEUX BAIES EN MONTREUILLOIS,62,PAS DE CALAIS,33,1,34,63,125,2,127,223
2020,62427,HENIN BEAUMONT,246200299,CA D'HENIN-CARVIN,62,PAS DE CALAIS,110,65,175,50,203,3,206,430
2020,62510,LIEVIN,246200364,CA DE LENS - LIEVIN,62,PAS DE CALAIS,155,33,188,58,181,1,182,428
2020,62570,MERICOURT,246200364,CA DE LENS - LIEVIN,62,PAS DE CALAIS,10,17,27,21,96,0,96,144
2020,62587,MONTIGNY EN GOHELLE,246200299,CA D'HENIN-CARVIN,62,PAS DE CALAIS,30,7,37,52,74,0,74,163
2020,62765,SAINT OMER,200069037,CA DU PAYS DE SAINT-OMER,62,PAS DE CALAIS,25,8,33,60,105,6,111,204
2020,63032,BEAUMONT,246300701,CLERMONT AUVERGNE METROPOLE,63,PUY DE DOME,52,18,70,0,120,5,125,195
2020,63075,CHAMALIERES,246300701,CLERMONT AUVERGNE METROPOLE,63,PUY DE DOME,196,3,199,0,88,22,110,309
2020,63124,COURNON D AUVERGNE,246300701,CLERMONT AUVERGNE METROPOLE,63,PUY DE DOME,113,15,128,11,238,8,246,385
2020,63164,GERZAT,246300701,CLERMONT AUVERGNE METROPOLE,63,PUY DE DOME,40,0,40,0,198,3,201,241
2020,63178,ISSOIRE,200070407,CA AGGLO PAYS D'ISSOIRE,63,PUY DE DOME,92,4,96,6,272,0,272,374
2020,63300,RIOM,200070753,CA RIOM LIMAGNE ET VOLCANS,63,PUY DE DOME,103,13,116,20,185,8,193,329
2020,64102,BAYONNE,200067106,CA DU PAYS BASQUE,64,PYRENEES ATLANTIQUES,255,96,351,50,356,33,389,790
2020,64430,ORTHEZ,200039204,CC DE LACQ-ORTHEZ,64,PYRENEES ATLANTIQUES,50,0,50,11,80,3,83,144
2020,64483,SAINT JEAN DE LUZ,200067106,CA DU PAYS BASQUE,64,PYRENEES ATLANTIQUES,70,15,85,20,63,3,66,171
2020,67046,BISCHWILLER,200067874,CA DE HAGUENAU,67,BAS RHIN,167,38,205,0,45,0,45,250
2020,67267,LINGOLSHEIM,246700488,EUROMETROPOLE DE STRASBOURG,67,BAS RHIN,149,49,198,0,183,7,190,388
2020,67462,SELESTAT,246700967,CC DE SELESTAT,67,BAS RHIN,127,39,166,0,138,10,148,314
2020,67482,STRASBOURG,246700488,EUROMETROPOLE DE STRASBOURG,67,BAS RHIN,3490,682,4172,406,1414,215,1629,6207
2020,68112,GUEBWILLER,246800569,CC DE LA REGION DE GUEBWILLER,68,HAUT RHIN,70,7,77,0,35,1,36,112
2020,68271,RIEDISHEIM,200066009,CA MULHOUSE ALSACE AGGLOMERATION,68,HAUT RHIN,70,1,71,0,80,6,86,156
2020,69029,BRON,200046977,METROPOLE DE LYON,69,RHONE,375,54,429,50,289,31,320,799
2020,69081,ECULLY,200046977,METROPOLE DE LYON,69,RHONE,180,22,202,6,208,22,230,438
2020,69091,GIVORS,200046977,METROPOLE DE LYON,69,RHONE,126,14,140,102,150,2,152,393
2020,69199,SAINT FONS,200046977,METROPOLE DE LYON,69,RHONE,157,4,161,92,100,6,106,359
2020,69259,VENISSIEUX,200046977,METROPOLE DE LYON,69,RHONE,437,31,468,586,441,23,464,1518
2020,69271,CHASSIEU,200046977,METROPOLE DE LYON,69,RHONE,67,15,82,0,151,13,164,246
2020,69273,CORBAS,200046977,METROPOLE DE LYON,69,RHONE,84,6,90,0,139,6,145,236
2020,69275,DECINES CHARPIEU,200046977,METROPOLE DE LYON,69,RHONE,179,51,230,40,348,10,358,628
2020,69381,LYON 1ER ARRONDISSEMENT,200046977,METROPOLE DE LYON,69,RHONE,275,57,332,11,213,68,281,624
2020,69382,LYON 2E ARRONDISSEMENT,200046977,METROPOLE DE LYON,69,RHONE,406,101,507,18,253,126,379,903
2020,69384,LYON 4E ARRONDISSEMENT,200046977,METROPOLE DE LYON,69,RHONE,408,114,522,14,413,85,498,1034
2020,69387,LYON 7E ARRONDISSEMENT,200046977,METROPOLE DE LYON,69,RHONE,854,183,1037,18,877,185,1062,2116
2020,69388,LYON 8E ARRONDISSEMENT,200046977,METROPOLE DE LYON,69,RHONE,892,89,981,157,698,94,792,1930
2020,70550,VESOUL,247000011,CA DE VESOUL,70,HAUTE SAONE,83,2,85,21,139,3,142,248
2020,71076,CHALON SUR SAONE,247100589,CA LE GRAND CHALON,71,SAONE ET LOIRE,308,38,346,98,310,25,335,779
2020,71153,LE CREUSOT,247100290,CU LE CREUSOT MONTCEAU-LES-MINES,71,SAONE ET LOIRE,68,20,88,53,170,1,171,312
2020,71306,MONTCEAU LES MINES,247100290,CU LE CREUSOT MONTCEAU-LES-MINES,71,SAONE ET LOIRE,55,5,60,73,150,3,153,286
2020,72003,ALLONNES,247200132,CU LE MANS METROPOLE,72,SARTHE,18,0,18,33,173,2,175,226
2020,72264,SABLE SUR SARTHE,247200090,CC DU PAYS SABOLIEN,72,SARTHE,45,0,45,17,157,0,157,219
2020,73065,CHAMBERY,200069110,CA DU GRAND CHAMBERY,73,SAVOIE,370,24,394,113,536,43,579,1086
2020,73179,LA MOTTE SERVOLEX,200069110,CA DU GRAND CHAMBERY,73,SAVOIE,50,13,63,6,193,4,197,266
2020,74012,ANNEMASSE,200011773,CA ANNEMASSE-LES VOIRONS-AGGLOMERATION,74,HAUTE SAVOIE,185,8,193,42,302,5,307,542
2020,75101,PARIS 1ER ARRONDISSEMENT,200054781,METROPOLE DU GRAND PARIS,75,PARIS,234,5,239,13,25,88,113,364
2020,75106,PARIS 6E ARRONDISSEMENT,200054781,METROPOLE DU GRAND PARIS,75,PARIS,617,13,630,37,12,219,231,898
2020,75107,PARIS 7E ARRONDISSEMENT,200054781,METROPOLE DU GRAND PARIS,75,PARIS,636,27,663,49,10,293,303,1015
2020,75110,PARIS 10E ARRONDISSEMENT,200054781,METROPOLE DU GRAND PARIS,75,PARIS,1847,117,1964,13,193,675,868,2845
2020,75112,PARIS 12E ARRONDISSEMENT,200054781,METROPOLE DU GRAND PARIS,75,PARIS,2991,217,3208,23,407,534,941,4172
2020,75114,PARIS 14E ARRONDISSEMENT,200054781,METROPOLE DU GRAND PARIS,75,PARIS,2409,170,2579,39,299,425,724,3342
2020,76351,LE HAVRE,200084952,CU LE HAVRE SEINE METROPOLE,76,SEINE MARITIME,876,183,1059,139,1821,73,1894,3092
2020,76410,MAROMME,200023414,METROPOLE ROUEN NORMANDIE,76,SEINE MARITIME,37,12,49,6,180,0,180,236
2020,76447,MONTIVILLIERS,200084952,CU LE HAVRE SEINE METROPOLE,76,SEINE MARITIME,40,24,64,1,247,11,258,323
2020,76484,OISSEL,200023414,METROPOLE ROUEN NORMANDIE,76,SEINE MARITIME,12,3,15,20,176,0,176,211
2020,76681,SOTTEVILLE LES ROUEN,200023414,METROPOLE ROUEN NORMANDIE,76,SEINE MARITIME,187,18,205,12,409,6,415,632
2020,77053,BRIE COMTE ROBERT,247700644,CC L'OREE DE LA BRIE,77,SEINE ET MARNE,139,5,144,5,306,5,311,460
2020,77083,CHAMPS SUR MARNE,200057958,CA PARIS - VALLEE DE LA MARNE,77,SEINE ET MARNE,278,3,281,0,226,10,236,518
2020,77186,FONTAINEBLEAU,200072346,CA DU PAYS DE FONTAINEBLEAU,77,SEINE ET MARNE,139,17,156,8,104,9,113,276
2020,77258,LOGNES,200057958,CA PARIS - VALLEE DE LA MARNE,77,SEINE ET MARNE,207,2,209,0,120,7,127,336
2020,77284,MEAUX,200072130,CA DU PAYS DE MEAUX,77,SEINE ET MARNE,538,11,549,15,550,20,570,1134
2020,77288,MELUN,247700057,CA MELUN VAL DE SEINE,77,SEINE ET MARNE,451,3,454,23,301,26,327,803
2020,77294,MITRY MORY,200055655,CA ROISSY PAYS DE FRANCE,77,SEINE ET MARNE,87,2,89,0,296,6,302,391
2020,77305,MONTEREAU FAULT YONNE,247700107,CC PAYS DE MONTEREAU,77,SEINE ET MARNE,128,3,131,13,144,7,151,295
2020,77333,NEMOURS,200023240,CC PAYS DE NEMOURS,77,SEINE ET MARNE,0,14,14,3,165,6,171,189
2020,77407,SAINT FARGEAU PONTHIERRY,247700057,CA MELUN VAL DE SEINE,77,SEINE ET MARNE,124,4,128,3,196,5,201,332
2020,77464,THORIGNY SUR MARNE,247700594,CA MARNE ET GONDOIRE,77,SEINE ET MARNE,70,5,75,0,119,1,120,196
2020,77487,VAUX LE PENIL,247700057,CA MELUN VAL DE SEINE,77,SEINE ET MARNE,137,0,137,0,137,3,140,277
2020,78015,ANDRESY,200059889,CU GRAND PARIS SEINE ET OISE,78,YVELINES,35,16,51,16,221,6,227,294
2020,78029,AUBERGENVILLE,200059889,CU GRAND PARIS SEINE ET OISE,78,YVELINES,97,21,118,0,118,2,120,238
2020,78123,CARRIERES SOUS POISSY,200059889,CU GRAND PARIS SEINE ET OISE,78,YVELINES,161,51,212,18,208,17,225,455
2020,78126,LA CELLE SAINT CLOUD,247800584,CA VERSAILLES GRAND PARC (CAVGP),78,YVELINES,273,26,299,0,136,30,166,466
2020,78158,LE CHESNAY ROCQUENCOURT,247800584,CA VERSAILLES GRAND PARC (CAVGP),78,YVELINES,486,10,496,12,132,42,174,682
2020,78190,CROISSY SUR SEINE,200058519,CA SAINT GERMAIN BOUCLES DE SEINE,78,YVELINES,124,5,129,0,39,34,73,202
2020,78242,FONTENAY LE FLEURY,247800584,CA VERSAILLES GRAND PARC (CAVGP),78,YVELINES,156,9,165,0,146,15,161,326
2020,78297,GUYANCOURT,200058782,CA DE SAINT QUENTIN EN YVELINES,78,YVELINES,619,6,625,172,309,7,316,1113
2020,78372,MARLY LE ROI,200058519,CA SAINT GERMAIN BOUCLES DE SEINE,78,YVELINES,232,19,251,9,153,8,161,421
2020,78440,LES MUREAUX,200059889,CU GRAND PARIS SEINE ET OISE,78,YVELINES,258,46,304,64,161,11,172,540
2020,78498,POISSY,200059889,CU GRAND PARIS SEINE ET OISE,78,YVELINES,578,64,642,5,350,27,377,1024
2020,78545,SAINT CYR L ECOLE,247800584,CA VERSAILLES GRAND PARC (CAVGP),78,YVELINES,279,77,356,0,175,25,200,557
2020,78621,TRAPPES,200058782,CA DE SAINT QUENTIN EN YVELINES,78,YVELINES,253,19,272,124,287,12,299,695
2020,78640,VELIZY VILLACOUBLAY,247800584,CA VERSAILLES GRAND PARC (CAVGP),78,YVELINES,557,10,567,0,209,13,222,790
2020,78674,VILLEPREUX,200058782,CA DE SAINT QUENTIN EN YVELINES,78,YVELINES,95,33,128,0,165,4,169,296
2020,79049,BRESSUIRE,200040244,CA DU BOCAGE BRESSUIRAIS,79,DEUX SEVRES,70,1,71,17,296,3,299,387
2020,79191,NIORT,200041317,CA DU NIORTAIS,79,DEUX SEVRES,415,0,415,62,619,36,655,1132
2020,80021,AMIENS,248000531,CA AMIENS METROPOLE,80,SOMME,1180,97,1277,385,1092,59,1151,2813
2020,82112,MOISSAC,200066322,CC TERRES DES CONFLUENCES,82,TARN ET GARONNE,55,0,55,16,95,4,99,170
2020,82121,MONTAUBAN,248200099,CA GRAND MONTAUBAN,82,TARN ET GARONNE,439,60,499,86,448,15,463,1049
2020,83047,LA CRAU,248300543,METROPOLE TOULON-PROVENCE-MEDITERRANEE,83,VAR,97,16,113,4,217,7,224,341
2020,83061,FREJUS,200035319,CA ESTEREL COTE D'AZUR AGGLOMERATION,83,VAR,383,22,405,28,309,18,327,760
2020,83062,LA GARDE,248300543,METROPOLE TOULON-PROVENCE-MEDITERRANEE,83,VAR,280,19,299,4,155,10,165,469
2020,83069,HYERES,248300543,METROPOLE TOULON-PROVENCE-MEDITERRANEE,83,VAR,383,29,412,30,287,33,320,762
2020,83071,LA LONDE LES MAURES,200027100,CC MEDITERRANEE PORTE DES MAURES,83,VAR,76,2,78,0,49,4,53,131
2020,83090,OLLIOULES,248300543,METROPOLE TOULON-PROVENCE-MEDITERRANEE,83,VAR,94,32,126,1,114,7,121,247
2020,83098,LE PRADET,248300543,METROPOLE TOULON-PROVENCE-MEDITERRANEE,83,VAR,76,9,85,0,83,6,89,175
2020,83107,ROQUEBRUNE SUR ARGENS,200035319,CA ESTEREL COTE D'AZUR AGGLOMERATION,83,VAR,94,2,96,0,120,8,128,224
2020,83112,SAINT CYR SUR MER,248300394,CA SUD SAINTE BAUME,83,VAR,60,3,63,0,99,7,106,169
2020,83126,LA SEYNE SUR MER,248300543,METROPOLE TOULON-PROVENCE-MEDITERRANEE,83,VAR,388,129,517,87,392,36,428,1032
2020,83137,TOULON,248300543,METROPOLE TOULON-PROVENCE-MEDITERRANEE,83,VAR,1247,94,1341,281,903,145,1048,2671
2020,83144,LA VALETTE DU VAR,248300543,METROPOLE TOULON-PROVENCE-MEDITERRANEE,83,VAR,163,17,180,0,214,7,221,401
2020,84003,APT,200040624,CC PAYS D'APT-LUBERON,84,VAUCLUSE,80,0,80,32,68,2,70,182
2020,84007,AVIGNON,248400251,CA DU GRAND AVIGNON (COGA),84,VAUCLUSE,797,105,902,65,311,38,349,1316
2020,84019,BOLLENE,200000628,CC RHONE LEZ PROVENCE,84,VAUCLUSE,70,5,75,38,122,1,123,236
2020,84031,CARPENTRAS,248400053,CA VENTOUX-COMTAT-VENAISSIN (COVE),84,VAUCLUSE,238,7,245,0,188,6,194,439
2020,84054,L'ISLE SUR LA SORGUE,248400319,CC DU PAYS DES SORGUES ET DES MONTS DE VAUCLUSE,84,VAUCLUSE,105,14,119,0,144,4,148,267
2020,84089,PERTUIS,200054807,METROPOLE D'AIX-MARSEILLE-PROVENCE,84,VAUCLUSE,150,0,150,3,250,13,263,417
2020,84092,LE PONTET,248400251,CA DU GRAND AVIGNON (COGA),84,VAUCLUSE,67,7,74,0,146,2,148,223
2020,84129,SORGUES,248400293,CA DES SORGUES DU COMTAT,84,VAUCLUSE,100,32,132,8,128,0,128,269
2020,85092,FONTENAY LE COMTE,200071934,CC DU PAYS DE FONTENAY-VENDEE,85,VENDEE,24,1,25,17,153,2,155,197
2020,85194,LES SABLES D OLONNE,200071165,CA LES SABLES D'OLONNE AGGLOMERATION,85,VENDEE,100,28,128,55,366,18,384,568
2020,86066,CHATELLERAULT,248600413,CA GRAND CHATELLERAULT,86,VIENNE,125,0,125,58,238,5,243,426
2020,87085,LIMOGES,248719312,CU LIMOGES METROPOLE,87,HAUTE VIENNE,886,53,939,116,794,78,872,1926
2020,87154,SAINT JUNIEN,200059400,CC PORTE OCEANE DU LIMOUSIN,87,HAUTE VIENNE,40,0,40,3,140,5,145,189
2020,91021,ARPAJON,200057859,CA COEUR D'ESSONNE AGGLOMERATION,91,ESSONNE,91,7,98,0,111,6,117,215
2020,91086,BONDOUFLE,200059228,CA GRAND PARIS SUD SEINE ESSONNE SENART,91,ESSONNE,110,7,117,0,124,5,129,246
2020,91161,CHILLY MAZARIN,200056232,CA COMMUNAUTE PARIS-SACLAY,91,ESSONNE,198,12,210,0,199,6,205,415
2020,91200,DOURDAN,249100595,CC LE DOURDANNAIS EN HUREPOIX (CCDH),91,ESSONNE,70,7,77,0,130,1,131,207
2020,91228,EVRY COURCOURONNES,200059228,CA GRAND PARIS SUD SEINE ESSONNE SENART,91,ESSONNE,605,9,614,111,689,18,707,1433
2020,91477,PALAISEAU,200056232,CA COMMUNAUTE PARIS-SACLAY,91,ESSONNE,451,66,517,12,427,20,447,976
2020,91549,SAINTE GENEVIEVE DES BOIS,200057859,CA COEUR D'ESSONNE AGGLOMERATION,91,ESSONNE,260,29,289,32,391,11,402,722
2020,91552,SAINT GERMAIN LES ARPAJON,200057859,CA COEUR D'ESSONNE AGGLOMERATION,91,ESSONNE,14,9,23,0,173,4,177,199
2020,91570,SAINT MICHEL SUR ORGE,200057859,CA COEUR D'ESSONNE AGGLOMERATION,91,ESSONNE,156,22,178,6,266,2,268,452
2020,91589,SAVIGNY SUR ORGE,200054781,METROPOLE DU GRAND PARIS,91,ESSONNE,222,15,237,13,455,16,471,721
2020,91687,VIRY CHATILLON,200054781,METROPOLE DU GRAND PARIS,91,ESSONNE,356,26,382,14,330,7,337,733
2020,92002,ANTONY,200054781,METROPOLE DU GRAND PARIS,92,HAUTS DE SEINE,899,46,945,16,453,155,608,1569
2020,92020,CHATILLON,200054781,METROPOLE DU GRAND PARIS,92,HAUTS DE SEINE,513,84,597,0,254,110,364,961
2020,92023,CLAMART,200054781,METROPOLE DU GRAND PARIS,92,HAUTS DE SEINE,640,95,735,43,283,133,416,1194
2020,92024,CLICHY,200054781,METROPOLE DU GRAND PARIS,92,HAUTS DE SEINE,891,96,987,23,459,220,679,1689
2020,92032,FONTENAY AUX ROSES,200054781,METROPOLE DU GRAND PARIS,92,HAUTS DE SEINE,278,26,304,0,167,17,184,489
2020,92040,ISSY LES MOULINEAUX,200054781,METROPOLE DU GRAND PARIS,92,HAUTS DE SEINE,1440,49,1489,11,556,324,880,2380
2020,92044,LEVALLOIS PERRET,200054781,METROPOLE DU GRAND PARIS,92,HAUTS DE SEINE,1197,171,1368,67,241,755,996,2431
2020,92063,RUEIL MALMAISON,200054781,METROPOLE DU GRAND PARIS,92,HAUTS DE SEINE,1177,88,1265,36,344,276,620,1921
2020,92073,SURESNES,200054781,METROPOLE DU GRAND PARIS,92,HAUTS DE SEINE,755,100,855,29,483,249,732,1616
2020,93001,AUBERVILLIERS,200054781,METROPOLE DU GRAND PARIS,93,SEINE SAINT DENIS,689,14,703,55,243,50,293,1051
2020,93007,LE BLANC MESNIL,200054781,METROPOLE DU GRAND PARIS,93,SEINE SAINT DENIS,363,10,373,12,149,11,160,545
2020,93031,EPINAY SUR SEINE,200054781,METROPOLE DU GRAND PARIS,93,SEINE SAINT DENIS,459,13,472,78,294,27,321,871
2020,93048,MONTREUIL,200054781,METROPOLE DU GRAND PARIS,93,SEINE SAINT DENIS,1241,148,1389,70,673,425,1098,2557
2020,93050,NEUILLY SUR MARNE,200054781,METROPOLE DU GRAND PARIS,93,SEINE SAINT DENIS,399,20,419,28,308,17,325,771
2020,93051,NOISY LE GRAND,200054781,METROPOLE DU GRAND PARIS,93,SEINE SAINT DENIS,662,25,687,52,545,50,595,1334
2020,93055,PANTIN,200054781,METROPOLE DU GRAND PARIS,93,SEINE SAINT DENIS,669,33,702,78,298,158,456,1236
2020,93059,PIERREFITTE SUR SEINE,200054781,METROPOLE DU GRAND PARIS,93,SEINE SAINT DENIS,220,11,231,19,117,10,127,377
2020,93063,ROMAINVILLE,200054781,METROPOLE DU GRAND PARIS,93,SEINE SAINT DENIS,377,31,408,0,271,41,312,720
2020,93066,SAINT DENIS,200054781,METROPOLE DU GRAND PARIS,93,SEINE SAINT DENIS,1084,35,1119,163,612,59,671,1953
2020,93071,SEVRAN,200054781,METROPOLE DU GRAND PARIS,93,SEINE SAINT DENIS,297,5,302,116,203,11,214,631
2020,93077,VILLEMOMBLE,200054781,METROPOLE DU GRAND PARIS,93,SEINE SAINT DENIS,266,23,289,0,219,30,249,538
2020,94004,BOISSY SAINT LEGER,200054781,METROPOLE DU GRAND PARIS,94,VAL DE MARNE,140,21,161,0,145,2,147,308
2020,94017,CHAMPIGNY SUR MARNE,200054781,METROPOLE DU GRAND PARIS,94,VAL DE MARNE,539,54,593,113,571,41,612,1318
2020,94041,IVRY SUR SEINE,200054781,METROPOLE DU GRAND PARIS,94,VAL DE MARNE,746,92,838,94,336,50,386,1318
2020,94043,LE KREMLIN BICETRE,200054781,METROPOLE DU GRAND PARIS,94,VAL DE MARNE,483,5,488,7,188,17,205,700
2020,94067,SAINT MANDE,200054781,METROPOLE DU GRAND PARIS,94,VAL DE MARNE,428,39,467,17,43,193,236,721
2020,94069,SAINT MAURICE,200054781,METROPOLE DU GRAND PARIS,94,VAL DE MARNE,232,20,252,0,80,59,139,391
2020,94076,VILLEJUIF,200054781,METROPOLE DU GRAND PARIS,94,VAL DE MARNE,698,41,739,72,335,51,386,1197
2020,94079,VILLIERS SUR MARNE,200054781,METROPOLE DU GRAND PARIS,94,VAL DE MARNE,254,24,278,0,247,30,277,555
2020,94081,VITRY SUR SEINE,200054781,METROPOLE DU GRAND PARIS,94,VAL DE MARNE,774,94,868,46,349,42,391,1304
2020,95063,BEZONS,200058519,CA SAINT GERMAIN BOUCLES DE SEINE,95,VAL D OISE,225,73,298,33,265,30,295,626
2020,95127,CERGY,249500109,CA DE CERGY-PONTOISE,95,VAL D OISE,669,33,702,57,716,38,754,1513
2020,95176,CORMEILLES EN PARISIS,200058485,CA VAL PARISIS,95,VAL D OISE,180,40,220,0,272,43,315,534
2020,95197,DEUIL LA BARRE,200056380,CA PLAINE VALLEE,95,VAL D OISE,80,37,117,14,313,18,331,462
2020,95203,EAUBONNE,200058485,CA VAL PARISIS,95,VAL D OISE,362,10,372,0,354,16,370,742
2020,95210,ENGHIEN LES BAINS,200056380,CA PLAINE VALLEE,95,VAL D OISE,263,12,275,2,46,24,70,347
2020,95306,HERBLAY SUR SEINE,200058485,CA VAL PARISIS,95,VAL D OISE,213,24,237,0,426,21,447,684
2020,95427,MONTMAGNY,200056380,CA PLAINE VALLEE,95,VAL D OISE,87,4,91,0,157,9,166,256
2020,95428,MONTMORENCY,200056380,CA PLAINE VALLEE,95,VAL D OISE,100,34,134,11,198,24,222,367
2020,95476,OSNY,249500109,CA DE CERGY-PONTOISE,95,VAL D OISE,152,24,176,9,198,2,200,385
2020,95539,SAINT BRICE SOUS FORET,200056380,CA PLAINE VALLEE,95,VAL D OISE,102,16,118,0,170,25,195,313
2020,95555,SAINT GRATIEN,200056380,CA PLAINE VALLEE,95,VAL D OISE,178,5,183,0,204,17,221,404
2020,95582,SANNOIS,200058485,CA VAL PARISIS,95,VAL D OISE,244,8,252,0,352,14,366,618
2020,97103,BAIE MAHAULT,200018653,CA CAP EXCELLENCE,971,GUADELOUPE,167,63,230,45,246,11,257,531
2020,97116,MORNE A L EAU,200044691,CA DU NORD GRANDE TERRE,971,GUADELOUPE,40,3,43,53,68,2,70,166
2020,97124,SAINT CLAUDE,249710070,CA GRAND SUD CARAIBE,971,GUADELOUPE,40,11,51,28,41,2,43,122
2020,97210,LE FRANCOIS,249720053,CA DE L'ESPACE SUD DE LA MARTINIQUE,972,MARTINIQUE,123,17,140,48,71,6,77,265
2020,97222,LE ROBERT,200041788,CA DU PAYS NORD MARTINIQUE,972,MARTINIQUE,195,55,250,65,79,7,86,400
2020,97228,SAINTE MARIE,200041788,CA DU PAYS NORD MARTINIQUE,972,MARTINIQUE,40,26,66,44,26,2,28,138
2020,97230,LA TRINITE,200041788,CA DU PAYS NORD MARTINIQUE,972,MARTINIQUE,100,8,108,31,40,6,46,185
2020,97302,CAYENNE,249730045,CA DU CENTRE LITTORAL,973,GUYANE,639,18,657,11,136,21,157,825
2020,97304,KOUROU,200027548,CC DES SAVANES,973,GUYANE,340,0,340,39,72,28,100,479
2020,97305,MACOURIA,249730045,CA DU CENTRE LITTORAL,973,GUYANE,80,1,81,3,25,3,28,112
2020,97311,SAINT LAURENT DU MARONI,249730037,CC DE L'OUEST GUYANAIS,973,GUYANE,170,0,170,2,79,11,90,262
2020,97353,MARIPASOULA,249730037,CC DE L'OUEST GUYANAIS,973,GUYANE,0,0,0,10,0,3,3,13
2020,97405,PETITE ILE,249740077,CA CIVIS (COMMUNAUTE INTERCOMMUNALE DES VILLES SOLIDAIRES),974,LA REUNION,55,25,80,18,44,9,53,151
2020,97407,LE PORT,249740101,CA TERRITOIRE DE LA COTE OUEST (TCO),974,LA REUNION,300,36,336,60,76,11,87,483
2020,97408,LA POSSESSION,249740101,CA TERRITOIRE DE LA COTE OUEST (TCO),974,LA REUNION,190,232,422,43,164,37,201,666
2020,97410,SAINT BENOIT,249740093,CA INTERCOMMUNALE DE LA REUNION EST (CIREST),974,LA REUNION,190,113,303,23,89,19,108,434
2020,97412,SAINT JOSEPH,249740085,CA DU SUD,974,LA REUNION,145,119,264,29,85,20,105,398
2020,97413,SAINT LEU,249740101,CA TERRITOIRE DE LA COTE OUEST (TCO),974,LA REUNION,147,137,284,24,178,56,234,542
2020,97418,SAINTE MARIE,249740119,CA INTERCOMMUNALE DU NORD DE LA REUNION (CINOR),974,LA REUNION,420,199,619,13,163,25,188,820
2020,97801,SAINT-MARTIN,XX,XX,978,COLLECTIVITE D'OUTRE MER SAINT MARTIN,50,0,50,186,84,5,89,325
2021,02691,SAINT QUENTIN,200071892,CA DU SAINT-QUENTINOIS,02,AISNE,181,80,261,193,333,9,342,796
2021,02810,VILLERS COTTERETS,200071991,CC RETZ EN VALOIS,02,AISNE,24,11,35,0,153,2,155,191
2021,02722,SOISSONS,240200477,CA GRANDSOISSONS AGGLOMERATION,02,AISNE,141,40,181,61,201,3,204,446
2021,03095,CUSSET,200071363,CA VICHY COMMUNAUTE,03,ALLIER,26,0,26,36,117,5,122,184
2021,03321,YZEURE,200071140,CA MOULINS COMMUNAUTE,03,ALLIER,95,0,95,15,104,5,109,219
2021,04112,MANOSQUE,200034700,CA DURANCE-LUBERON-VERDON AGGLOMERATION,04,ALPES DE HAUTE PROVENCE,194,15,209,28,118,1,119,356
2021,05023,BRIANCON,240500439,CC DU BRIANCONNAIS,05,HAUTES ALPES,105,1,106,0,57,7,64,170
2021,06104,ROQUEBRUNE CAP MARTIN,240600551,CA DE LA RIVIERA FRANCAISE,06,ALPES MARITIMES,134,3,137,8,61,3,64,209
2021,06012,BEAUSOLEIL,240600551,CA DE LA RIVIERA FRANCAISE,06,ALPES MARITIMES,44,0,44,11,46,1,47,102
2021,06088,NICE,200030195,METROPOLE NICE COTE D'AZUR,06,ALPES MARITIMES,3039,154,3193,327,1661,197,1858,5378
2021,06027,CAGNES SUR MER,200030195,METROPOLE NICE COTE D'AZUR,06,ALPES MARITIMES,390,44,434,14,386,17,403,851
2021,06152,VALBONNE,240600585,CA DE SOPHIA ANTIPOLIS,06,ALPES MARITIMES,206,4,210,0,130,8,138,348
2021,06157,VENCE,200030195,METROPOLE NICE COTE D'AZUR,06,ALPES MARITIMES,159,2,161,9,84,6,90,260
2021,07019,AUBENAS,200073245,CC DU BASSIN D'AUBENAS,07,ARDECHE,80,0,80,19,58,5,63,163
2021,07102,GUILHERAND GRANGES,200041366,CC RHONE CRUSSOL,07,ARDECHE,73,15,88,4,136,4,140,232
2021,08409,SEDAN,200041630,CA ARDENNE METROPOLE,08,ARDENNES,62,31,93,36,57,1,58,186
2021,10362,SAINTE SAVINE,200069250,CA TROYES CHAMPAGNE METROPOLE,10,AUBE,44,0,44,2,129,3,132,178
2021,10333,SAINT ANDRE LES VERGERS,200069250,CA TROYES CHAMPAGNE METROPOLE,10,AUBE,112,1,113,0,132,6,138,251
2021,10387,TROYES,200069250,CA TROYES CHAMPAGNE METROPOLE,10,AUBE,473,1,474,115,286,32,318,908
2021,11069,CARCASSONNE,200035715,CA CARCASSONNE AGGLO,11,AUDE,246,1,247,95,277,22,299,641
2021,11206,LIMOUX,200071926,CC DU LIMOUXIN,11,AUDE,55,0,55,37,42,7,49,141
2021,11076,CASTELNAUDARY,200035855,CC CASTELNAUDARY LAURAGAIS AUDOIS,11,AUDE,70,12,82,31,74,4,78,190
2021,12176,ONET LE CHATEAU,241200187,CA RODEZ AGGLOMERATION,12,AVEYRON,55,17,72,29,147,2,149,251
2021,13004,ARLES,241300417,CA D'ARLES-CRAU-CAMARGUE-MONTAGNETTE,13,BOUCHES DU RHONE,191,23,214,59,293,13,306,578
2021,13014,BERRE L ETANG,200054807,METROPOLE D'AIX-MARSEILLE-PROVENCE,13,BOUCHES DU RHONE,72,9,81,16,45,1,46,143
2021,13015,BOUC BEL AIR,200054807,METROPOLE D'AIX-MARSEILLE-PROVENCE,13,BOUCHES DU RHONE,129,24,153,0,147,15,162,315
2021,13026,CHATEAUNEUF LES MARTIGUES,200054807,METROPOLE D'AIX-MARSEILLE-PROVENCE,13,BOUCHES DU RHONE,127,43,170,7,170,6,176,353
2021,13041,GARDANNE,200054807,METROPOLE D'AIX-MARSEILLE-PROVENCE,13,BOUCHES DU RHONE,147,11,158,15,208,5,213,386
2021,13047,ISTRES,200054807,METROPOLE D'AIX-MARSEILLE-PROVENCE,13,BOUCHES DU RHONE,506,21,527,4,279,10,289,820
2021,13069,PELISSANNE,200054807,METROPOLE D'AIX-MARSEILLE-PROVENCE,13,BOUCHES DU RHONE,72,3,75,2,127,4,131,208
2021,13071,LES PENNES MIRABEAU,200054807,METROPOLE D'AIX-MARSEILLE-PROVENCE,13,BOUCHES DU RHONE,147,44,191,21,119,8,127,339
2021,13077,PORT DE BOUC,200054807,METROPOLE D'AIX-MARSEILLE-PROVENCE,13,BOUCHES DU RHONE,148,0,148,67,64,2,66,281
2021,13097,SAINT MARTIN DE CRAU,241300417,CA D'ARLES-CRAU-CAMARGUE-MONTAGNETTE,13,BOUCHES DU RHONE,112,16,128,0,137,1,138,266
2021,13205,MARSEILLE 5E ARRONDISSEMENT,200054807,METROPOLE D'AIX-MARSEILLE-PROVENCE,13,BOUCHES DU RHONE,583,107,690,1,306,36,342,1033
2021,13211,MARSEILLE 11E ARRONDISSEMENT,200054807,METROPOLE D'AIX-MARSEILLE-PROVENCE,13,BOUCHES DU RHONE,498,101,599,47,335,34,369,1014
2021,13212,MARSEILLE 12E ARRONDISSEMENT,200054807,METROPOLE D'AIX-MARSEILLE-PROVENCE,13,BOUCHES DU RHONE,450,164,614,6,405,57,462,1081
2021,13213,MARSEILLE 13E ARRONDISSEMENT,200054807,METROPOLE D'AIX-MARSEILLE-PROVENCE,13,BOUCHES DU RHONE,789,102,891,236,360,64,424,1550
2021,14047,BAYEUX,241400555,CC DE BAYEUX INTERCOM,14,CALVADOS,40,9,49,15,171,6,177,241
2021,14327,HEROUVILLE SAINT CLAIR,200065597,CU CAEN LA MER,14,CALVADOS,255,9,264,50,253,7,260,574
2021,19031,BRIVE LA GAILLARDE,200043172,CA DU BASSIN DE BRIVE,19,CORREZE,353,7,360,80,284,46,330,770
2021,2A247,PORTO VECCHIO,200040764,CC DU SUD CORSE,20R,CORSE,88,0,88,8,35,8,43,139
2021,21231,DIJON,242100410,DIJON METROPOLE,21,COTE D OR,1695,214,1909,155,870,115,985,3049
2021,22187,PLERIN,200069409,CA SAINT-BRIEUC ARMOR AGGLOMERATION,22,COTES D ARMOR,111,4,115,36,174,6,180,330
2021,25462,PONTARLIER,242500338,CC DU GRAND PONTARLIER,25,DOUBS,123,17,140,0,181,3,184,325
2021,26058,BOURG LES VALENCE,200068781,CA VALENCE ROMANS AGGLO,26,DROME,74,16,90,0,208,5,213,303
2021,26362,VALENCE,200068781,CA VALENCE ROMANS AGGLO,26,DROME,729,54,783,141,452,32,484,1408
2021,26198,MONTELIMAR,200040459,CA MONTELIMAR AGGLOMERATION,26,DROME,159,60,219,27,374,10,384,630
2021,29019,BREST,242900314,BREST METROPOLE,29,FINISTERE,1041,39,1080,364,1335,114,1449,2893
2021,31157,CUGNAUX,243100518,TOULOUSE METROPOLE,31,HAUTE GARONNE,207,30,237,0,226,2,228,465
2021,31588,VILLENEUVE TOLOSANE,243100518,TOULOUSE METROPOLE,31,HAUTE GARONNE,69,22,91,0,161,3,164,254
2021,31555,TOULOUSE,243100518,TOULOUSE METROPOLE,31,HAUTE GARONNE,6203,78,6281,379,2430,630,3060,9719
2021,31424,PLAISANCE DU TOUCH,243100781,CC LE GRAND OUEST TOULOUSAIN,31,HAUTE GARONNE,102,11,113,9,261,12,273,395
2021,31561,L'UNION,243100518,TOULOUSE METROPOLE,31,HAUTE GARONNE,117,9,126,0,120,12,132,258
2021,31069,BLAGNAC,243100518,TOULOUSE METROPOLE,31,HAUTE GARONNE,456,1,457,0,210,16,226,683
2021,31149,COLOMIERS,243100518,TOULOUSE METROPOLE,31,HAUTE GARONNE,377,7,384,5,347,21,368,757
2021,33167,FLOIRAC,243300316,BORDEAUX METROPOLE,33,GIRONDE,156,17,173,46,262,9,271,490
2021,33238,LEOGNAN,243301264,CC DE MONTESQUIEU,33,GIRONDE,39,17,56,0,178,1,179,234
2021,33529,LA TESTE DE BUCH,243300563,CA BASSIN D'ARCACHON SUD (COBAS),33,GIRONDE,97,43,140,9,235,4,239,388
2021,33522,TALENCE,243300316,BORDEAUX METROPOLE,33,GIRONDE,390,78,468,8,364,49,413,889
2021,33075,BRUGES,243300316,BORDEAUX METROPOLE,33,GIRONDE,253,17,270,0,343,6,349,619
2021,33005,ANDERNOS LES BAINS,243301504,CA DU BASSIN D'ARCACHON NORD,33,GIRONDE,42,1,43,2,122,0,122,167
2021,33056,BLANQUEFORT,243300316,BORDEAUX METROPOLE,33,GIRONDE,114,16,130,0,245,10,255,384
2021,33063,BORDEAUX,243300316,BORDEAUX METROPOLE,33,GIRONDE,3251,378,3629,116,1971,514,2485,6230
2021,33249,LORMONT,243300316,BORDEAUX METROPOLE,33,GIRONDE,166,32,198,49,252,8,260,506
2021,34057,CASTELNAU LE LEZ,243400017,MONTPELLIER MEDITERRANEE METROPOLE,34,HERAULT,183,36,219,9,150,37,187,415
2021,34129,LATTES,243400017,MONTPELLIER MEDITERRANEE METROPOLE,34,HERAULT,225,15,240,0,124,11,135,374
2021,34172,MONTPELLIER,243400017,MONTPELLIER MEDITERRANEE METROPOLE,34,HERAULT,2623,187,2810,234,1571,252,1823,4867
2021,34157,MEZE,200066355,CA SETE AGGLOPOLE MEDITERRANEE,34,HERAULT,93,2,95,0,82,1,83,178
2021,35051,CESSON SEVIGNE,243500139,RENNES METROPOLE,35,ILLE ET VILAINE,248,37,285,23,177,25,202,510
2021,35360,VITRE,200039022,CA VITRE COMMUNAUTE,35,ILLE ET VILAINE,105,30,135,37,276,5,281,453
2021,35069,CHATEAUGIRON,243500659,CC PAYS DE CHATEAUGIRON COMMUNAUTE,35,ILLE ET VILAINE,35,20,55,43,263,0,263,361
2021,35115,FOUGERES,200072452,CA FOUGERES AGGLOMERATION,35,ILLE ET VILAINE,72,22,94,51,183,7,190,335
2021,35281,SAINT JACQUES DE LA LANDE,243500139,RENNES METROPOLE,35,ILLE ET VILAINE,126,10,136,13,207,6,213,362
2021,35093,DINARD,243500725,CC COTE D'EMERAUDE,35,ILLE ET VILAINE,38,8,46,8,48,0,48,101
2021,36044,CHATEAUROUX,243600327,CA CHATEAUROUX METROPOLE,36,INDRE,273,14,287,52,443,6,449,788
2021,37208,SAINT AVERTIN,243700754,TOURS METROPOLE VAL DE LOIRE,37,INDRE ET LOIRE,122,4,126,1,171,7,178,305
2021,37122,JOUE LES TOURS,243700754,TOURS METROPOLE VAL DE LOIRE,37,INDRE ET LOIRE,229,33,262,22,537,11,548,833
2021,37003,AMBOISE,200043065,CC DU VAL D AMBOISE,37,INDRE ET LOIRE,60,0,60,0,165,0,165,225
2021,37214,SAINT CYR SUR LOIRE,243700754,TOURS METROPOLE VAL DE LOIRE,37,INDRE ET LOIRE,77,26,103,0,162,12,174,276
2021,37195,LA RICHE,243700754,TOURS METROPOLE VAL DE LOIRE,37,INDRE ET LOIRE,70,23,93,5,140,6,146,245
2021,38185,GRENOBLE,200040715,GRENOBLE-ALPES-METROPOLE,38,ISERE,1646,329,1975,143,1270,108,1378,3496
2021,38169,FONTAINE,200040715,GRENOBLE-ALPES-METROPOLE,38,ISERE,129,19,148,22,281,8,289,459
2021,38317,LE PONT DE CLAIX,200040715,GRENOBLE-ALPES-METROPOLE,38,ISERE,100,3,103,38,101,4,105,245
2021,38382,SAINT EGREVE,200040715,GRENOBLE-ALPES-METROPOLE,38,ISERE,209,8,217,3,242,7,249,470
2021,38553,VILLEFONTAINE,243800604,CA PORTE DE L'ISERE (CAPI),38,ISERE,168,35,203,25,247,4,251,480
2021,39300,LONS LE SAUNIER,200071116,CA ECLA  (ESPACE COMMUNAUTAIRE LONS AGGLOMERATION),39,JURA,160,11,171,30,92,2,94,295
2021,40046,BISCARROSSE,244000873,CC DES GRANDS LACS,40,LANDES,84,0,84,0,151,2,153,237
2021,41194,ROMORANTIN LANTHENAY,200018406,CC DU ROMORANTINAIS ET DU MONESTOIS,41,LOIR ET CHER,91,0,91,20,211,2,213,324
2021,41018,BLOIS,200030385,CA DE BLOIS ''AGGLOPOLYS'',41,LOIR ET CHER,340,32,372,85,406,10,416,873
2021,41269,VENDOME,200072072,CA TERRITOIRES VENDOMOIS,41,LOIR ET CHER,100,1,101,2,178,5,183,286
2021,42044,LE CHAMBON FEUGEROLLES,244200770,SAINT-ETIENNE METROPOLE,42,LOIRE,86,3,89,39,76,2,78,206
2021,42207,SAINT CHAMOND,244200770,SAINT-ETIENNE METROPOLE,42,LOIRE,198,25,223,33,324,9,333,589
2021,44162,SAINT HERBLAIN,244400404,NANTES METROPOLE,44,LOIRE ATLANTIQUE,604,71,675,51,799,35,834,1561
2021,44069,GUERANDE,244400610,CA DE LA PRESQU'ILE DE GUERANDE ATLANTIQUE (CAP ATLANTIQUE),44,LOIRE ATLANTIQUE,70,3,73,24,227,4,231,329
2021,44114,ORVAULT,244400404,NANTES METROPOLE,44,LOIRE ATLANTIQUE,291,32,323,20,355,27,382,724
2021,44047,COUERON,244400404,NANTES METROPOLE,44,LOIRE ATLANTIQUE,104,50,154,0,544,10,554,708
2021,44143,REZE,244400404,NANTES METROPOLE,44,LOIRE ATLANTIQUE,217,71,288,10,730,45,775,1073
2021,44172,SAINTE LUCE SUR LOIRE,244400404,NANTES METROPOLE,44,LOIRE ATLANTIQUE,122,9,131,0,284,7,291,422
2021,45004,AMILLY,244500203,CA MONTARGOISE ET RIVES DU LOING (AME),45,LOIRET,70,4,74,0,168,3,171,245
2021,45302,SARAN,244500468,ORLEANS METROPOLE,45,LOIRET,182,10,192,0,238,7,245,437
2021,47323,VILLENEUVE SUR LOT,200023307,CA DU GRAND VILLENEUVOIS,47,LOT ET GARONNE,147,0,147,46,163,4,167,360
2021,49307,LOIRE AUTHION,244900015,CU ANGERS LOIRE METROPOLE,49,MAINE ET LOIRE,30,25,55,23,260,8,268,346
2021,49018,BAUGE EN ANJOU,244900882,CC BAUGEOIS VALLEE,49,MAINE ET LOIRE,60,13,73,20,102,4,106,199
2021,49015,AVRILLE,244900015,CU ANGERS LOIRE METROPOLE,49,MAINE ET LOIRE,57,38,95,10,208,9,217,322
2021,49023,BEAUPREAU EN MAUGES,200060010,CA MAUGES COMMUNAUTE,49,MAINE ET LOIRE,72,27,99,43,412,8,420,562
2021,49331,SEGRE EN ANJOU BLEU,244900809,CC ANJOU BLEU COMMUNAUTE,49,MAINE ET LOIRE,69,3,72,29,251,6,257,358
2021,49050,BRISSAC LOIRE AUBANCE,200071553,CC LOIRE LAYON AUBANCE,49,MAINE ET LOIRE,48,9,57,10,162,3,165,232
2021,49007,ANGERS,244900015,CU ANGERS LOIRE METROPOLE,49,MAINE ET LOIRE,1149,203,1352,231,1306,125,1431,3015
2021,50041,LA HAGUE,200067205,CA DU COTENTIN,50,MANCHE,22,0,22,9,194,6,200,231
2021,50129,CHERBOURG EN COTENTIN,200067205,CA DU COTENTIN,50,MANCHE,571,0,571,176,852,38,890,1637
2021,51454,REIMS,200067213,CU DU GRAND REIMS,51,MARNE,1380,452,1832,297,1077,166,1243,3372
2021,51573,TINQUEUX,200067213,CU DU GRAND REIMS,51,MARNE,81,31,112,0,139,2,141,252
2021,52121,CHAUMONT,200068658,CA DE CHAUMONT,52,HAUTE MARNE,112,9,121,30,257,1,258,409
2021,52448,SAINT DIZIER,200068666,CA DE SAINT-DIZIER DER ET BLAISE,52,HAUTE MARNE,137,0,137,68,180,7,187,392
2021,53062,CHATEAU GONTIER SUR MAYENNE,245300447,CC DU PAYS DE CHATEAU-GONTIER,53,MAYENNE,75,1,76,39,312,4,316,430
2021,54329,LUNEVILLE,200070324,CC DU TERRITOIRE DE LUNEVILLE A BACCARAT,54,MEURTHE ET MOSELLE,96,1,97,24,152,7,159,280
2021,54304,LAXOU,245400676,METROPOLE DU GRAND NANCY,54,MEURTHE ET MOSELLE,199,11,210,18,56,8,64,293
2021,54528,TOUL,200070563,CC TERRES TOULOISES,54,MEURTHE ET MOSELLE,110,1,111,10,176,5,181,302
2021,55029,BAR LE DUC,200033025,CA DE BAR-LE-DUC - SUD MEUSE,55,MEUSE,131,0,131,30,114,5,119,280
2021,56121,LORIENT,200042174,CA LORIENT AGGLOMERATION,56,MORBIHAN,299,16,315,244,501,36,537,1096
2021,56162,PLOEMEUR,200042174,CA LORIENT AGGLOMERATION,56,MORBIHAN,100,15,115,41,142,15,157,313
2021,56178,PONTIVY,245614433,CC PONTIVY COMMUNAUTE,56,MORBIHAN,45,2,47,53,165,2,167,267
2021,57433,MAIZIERES LES METZ,200039949,CC RIVES DE MOSELLE,57,MOSELLE,30,7,37,0,189,0,189,225
2021,57206,FAMECK,245701222,CA DU VAL DE FENSCH,57,MOSELLE,50,24,74,26,104,0,104,204
2021,57757,YUTZ,245701362,CA PORTES DE FRANCE-THIONVILLE,57,MOSELLE,101,28,129,10,160,4,164,303
2021,57660,STIRING WENDEL,245700372,CA DE FORBACH PORTE DE FRANCE,57,MOSELLE,40,0,40,19,44,1,45,104
2021,57306,HAYANGE,245701222,CA DU VAL DE FENSCH,57,MOSELLE,55,3,58,0,101,4,105,164
2021,57672,THIONVILLE,245701362,CA PORTES DE FRANCE-THIONVILLE,57,MOSELLE,238,65,303,10,256,14,270,583
2021,57019,AMNEVILLE,245701271,CC DU PAYS ORNE MOSELLE,57,MOSELLE,60,8,68,13,159,1,160,241
2021,58194,NEVERS,245804406,CA DE NEVERS,58,NIEVRE,271,9,280,54,229,13,242,576
2021,59122,CAMBRAI,200068500,CA DE CAMBRAI,59,NORD,102,5,107,120,238,9,247,473
2021,59526,SAINT AMAND LES EAUX,200042190,CA DE LA PORTE DU HAINAUT,59,NORD,80,14,94,49,200,6,206,349
2021,59350,LILLE,200093201,METROPOLE EUROPEENNE DE LILLE,59,NORD,2162,497,2659,600,1718,179,1897,5157
2021,59378,MARCQ EN BAROEUL,200093201,METROPOLE EUROPEENNE DE LILLE,59,NORD,286,208,494,65,476,82,558,1117
2021,59273,GRAVELINES,245900428,CU DE DUNKERQUE,59,NORD,65,16,81,56,132,3,135,272
2021,59599,TOURCOING,200093201,METROPOLE EUROPEENNE DE LILLE,59,NORD,540,151,691,336,789,21,810,1838
2021,59512,ROUBAIX,200093201,METROPOLE EUROPEENNE DE LILLE,59,NORD,950,72,1022,288,371,30,401,1711
2021,59560,SECLIN,200093201,METROPOLE EUROPEENNE DE LILLE,59,NORD,127,29,156,48,132,2,134,338
2021,59324,JEUMONT,200043396,CA MAUBEUGE VAL DE SAMBRE,59,NORD,20,1,21,55,67,2,69,145
2021,59606,VALENCIENNES,245901160,CA VALENCIENNES METROPOLE,59,NORD,282,16,298,143,266,13,279,721
2021,59178,DOUAI,200044618,CA DOUAISIS AGGLO,59,NORD,216,26,242,168,212,17,229,639
2021,59271,GRANDE SYNTHE,245900428,CU DE DUNKERQUE,59,NORD,150,5,155,127,129,0,129,411
2021,59299,HEM,200093201,METROPOLE EUROPEENNE DE LILLE,59,NORD,116,68,184,47,178,19,197,428
2021,59386,MARQUETTE LEZ LILLE,200093201,METROPOLE EUROPEENNE DE LILLE,59,NORD,115,21,136,27,193,3,196,360
2021,59249,FOURMIES,200043404,CC DU SUD AVESNOIS,59,NORD,24,3,27,46,61,4,65,138
2021,59112,BRUAY SUR L ESCAUT,245901160,CA VALENCIENNES METROPOLE,59,NORD,15,3,18,29,73,0,73,119
2021,59279,HALLUIN,200093201,METROPOLE EUROPEENNE DE LILLE,59,NORD,82,53,135,49,248,4,252,436
2021,59152,COMINES,200093201,METROPOLE EUROPEENNE DE LILLE,59,NORD,42,14,56,44,138,4,142,242
2021,59508,RONCQ,200093201,METROPOLE EUROPEENNE DE LILLE,59,NORD,107,29,136,50,140,3,143,328
2021,59011,ANNOEULLIN,200093201,METROPOLE EUROPEENNE DE LILLE,59,NORD,54,18,72,41,161,9,170,283
2021,60414,MONTATAIRE,200068047,CA CREIL SUD OISE,60,OISE,101,0,101,24,113,0,113,238
2021,60157,CLERMONT,246000376,CC DU CLERMONTOIS,60,OISE,65,2,67,24,106,1,107,198
2021,60057,BEAUVAIS,200067999,CA DU BEAUVAISIS,60,OISE,530,14,544,110,359,11,370,1024
2021,60176,CREPY EN VALOIS,246000871,CC DU PAYS DE VALOIS,60,OISE,97,7,104,13,186,4,190,307
2021,60612,SENLIS,200066975,CC SENLIS SUD OISE,60,OISE,160,4,164,1,151,16,167,332
2021,60141,CHANTILLY,246000764,CC DE L'AIRE CANTILIENNE,60,OISE,138,1,139,6,147,7,154,299
2021,60509,PONT SAINTE MAXENCE,246000921,CC DES PAYS D'OISE ET D'HALATTE,60,OISE,152,6,158,30,108,3,111,299
2021,61169,FLERS,200035814,CA FLERS AGGLO,61,ORNE,66,0,66,26,92,3,95,187
2021,62498,LENS,246200364,CA DE LENS - LIEVIN,62,PAS DE CALAIS,115,39,154,108,159,3,162,424
2021,62548,MARCK,200090751,CA GRAND CALAIS TERRES ET MERS,62,PAS DE CALAIS,47,0,47,33,117,0,117,197
2021,62570,MERICOURT,246200364,CA DE LENS - LIEVIN,62,PAS DE CALAIS,10,20,30,15,93,0,93,138
2021,62160,BOULOGNE SUR MER,246200729,CA DU BOULONNAIS,62,PAS DE CALAIS,259,10,269,128,149,16,165,562
2021,62525,LONGUENESSE,200069037,CA DU PAYS DE SAINT-OMER,62,PAS DE CALAIS,45,7,52,43,121,2,123,218
2021,63164,GERZAT,246300701,CLERMONT AUVERGNE METROPOLE,63,PUY DE DOME,40,3,43,0,205,1,206,249
2021,64260,HENDAYE,200067106,CA DU PAYS BASQUE,64,PYRENEES ATLANTIQUES,86,8,94,15,78,3,81,191
2021,64445,PAU,200067254,CA PAU BEARN PYRENEES,64,PYRENEES ATLANTIQUES,432,68,500,68,484,48,532,1100
2021,64024,ANGLET,200067106,CA DU PAYS BASQUE,64,PYRENEES ATLANTIQUES,145,93,238,26,357,21,378,642
2021,64122,BIARRITZ,200067106,CA DU PAYS BASQUE,64,PYRENEES ATLANTIQUES,184,40,224,15,88,28,116,355
2021,65440,TARBES,200069300,CA TARBES-LOURDES-PYRENEES,65,HAUTES PYRENEES,315,21,336,106,176,9,185,627
2021,66136,PERPIGNAN,200027183,CU PERPIGNAN MEDITERRANEE METROPOLE,66,PYRENEES ORIENTALES,742,165,907,326,386,41,427,1659
2021,66171,SAINT CYPRIEN,246600282,CC SUD-ROUSSILLON,66,PYRENEES ORIENTALES,31,4,35,7,49,1,50,92
2021,67218,ILLKIRCH GRAFFENSTADEN,246700488,EUROMETROPOLE DE STRASBOURG,67,BAS RHIN,412,42,454,0,207,8,215,669
2021,67447,SCHILTIGHEIM,246700488,EUROMETROPOLE DE STRASBOURG,67,BAS RHIN,397,109,506,53,256,17,273,832
2021,67180,HAGUENAU,200067874,CA DE HAGUENAU,67,BAS RHIN,338,135,473,0,212,5,217,690
2021,67067,BRUMATH,200067874,CA DE HAGUENAU,67,BAS RHIN,89,48,137,0,130,2,132,268
2021,68297,SAINT LOUIS,200066058,CA SAINT-LOUIS AGGLOMERATION,68,HAUT RHIN,153,18,171,40,96,1,97,308
2021,68063,CERNAY,200036465,CC DE THANN-CERNAY,68,HAUT RHIN,63,8,71,2,127,0,127,200
2021,68278,RIXHEIM,200066009,CA MULHOUSE ALSACE AGGLOMERATION,68,HAUT RHIN,130,6,136,9,99,0,99,243
2021,69069,CRAPONNE,200046977,METROPOLE DE LYON,69,RHONE,112,35,147,1,133,4,137,285
2021,69149,OULLINS,200046977,METROPOLE DE LYON,69,RHONE,204,49,253,22,328,40,368,643
2021,69244,TASSIN LA DEMI LUNE,200046977,METROPOLE DE LYON,69,RHONE,131,77,208,1,227,11,238,447
2021,69271,CHASSIEU,200046977,METROPOLE DE LYON,69,RHONE,67,16,83,0,126,7,133,216
2021,69283,MIONS,200046977,METROPOLE DE LYON,69,RHONE,59,30,89,0,230,3,233,322
2021,69286,RILLIEUX LA PAPE,200046977,METROPOLE DE LYON,69,RHONE,224,63,287,69,228,22,250,607
2021,69381,LYON 1ER ARRONDISSEMENT,200046977,METROPOLE DE LYON,69,RHONE,282,61,343,7,191,80,271,621
2021,69383,LYON 3E ARRONDISSEMENT,200046977,METROPOLE DE LYON,69,RHONE,1461,280,1741,21,896,238,1134,2896
2021,69385,LYON 5E ARRONDISSEMENT,200046977,METROPOLE DE LYON,69,RHONE,451,89,540,36,332,65,397,973
2021,69386,LYON 6E ARRONDISSEMENT,200046977,METROPOLE DE LYON,69,RHONE,586,205,791,17,372,195,567,1375
2021,70285,HERICOURT,247000722,CC DU PAYS D'HERICOURT,70,HAUTE SAONE,30,4,34,22,152,1,153,209
2021,70550,VESOUL,247000011,CA DE VESOUL,70,HAUTE SAONE,83,1,84,16,138,1,139,239
2021,72264,SABLE SUR SARTHE,247200090,CC DU PAYS SABOLIEN,72,SARTHE,45,0,45,27,153,6,159,231
2021,72181,LE MANS,247200132,CU LE MANS METROPOLE,72,SARTHE,616,43,659,214,1927,104,2031,2904
2021,73065,CHAMBERY,200069110,CA DU GRAND CHAMBERY,73,SAVOIE,350,32,382,81,540,41,581,1044
2021,73008,AIX LES BAINS,200068674,CA GRAND LAC,73,SAVOIE,155,56,211,23,283,20,303,538
2021,74133,GAILLARD,200011773,CA ANNEMASSE-LES VOIRONS-AGGLOMERATION,74,HAUTE SAVOIE,101,0,101,14,93,1,94,209
2021,74010,ANNECY,200066793,CA DU GRAND ANNECY,74,HAUTE SAVOIE,1277,125,1402,31,1139,93,1232,2665
2021,75101,PARIS 1ER ARRONDISSEMENT,200054781,METROPOLE DU GRAND PARIS,75,PARIS,259,2,261,13,28,66,94,368
2021,75104,PARIS 4E ARRONDISSEMENT,200054781,METROPOLE DU GRAND PARIS,75,PARIS,669,7,676,31,30,94,124,831
2021,75112,PARIS 12E ARRONDISSEMENT,200054781,METROPOLE DU GRAND PARIS,75,PARIS,2949,288,3237,20,400,440,840,4098
2021,75113,PARIS 13E ARRONDISSEMENT,200054781,METROPOLE DU GRAND PARIS,75,PARIS,3766,151,3917,20,320,286,606,4543
2021,75116,PARIS 16E ARRONDISSEMENT,200054781,METROPOLE DU GRAND PARIS,75,PARIS,1407,292,1699,113,68,1258,1326,3137
2021,75117,PARIS 17E ARRONDISSEMENT,200054781,METROPOLE DU GRAND PARIS,75,PARIS,2502,474,2976,42,381,1526,1907,4925
2021,75118,PARIS 18E ARRONDISSEMENT,200054781,METROPOLE DU GRAND PARIS,75,PARIS,3775,287,4062,98,379,932,1311,5471
2021,76322,LE GRAND QUEVILLY,200023414,METROPOLE ROUEN NORMANDIE,76,SEINE MARITIME,127,19,146,16,404,1,405,567
2021,76484,OISSEL,200023414,METROPOLE ROUEN NORMANDIE,76,SEINE MARITIME,12,2,14,23,183,0,183,220
2021,76217,DIEPPE,247600786,CA DE LA REGION DIEPPOISE,76,SEINE MARITIME,184,3,187,87,184,4,188,462
2021,76259,FECAMP,200069821,CA FECAMP CAUX LITTORAL AGGLOMERATION,76,SEINE MARITIME,126,6,132,23,159,2,161,316
2021,76498,LE PETIT QUEVILLY,200023414,METROPOLE ROUEN NORMANDIE,76,SEINE MARITIME,114,17,131,39,295,4,299,468
2021,76231,ELBEUF,200023414,METROPOLE ROUEN NORMANDIE,76,SEINE MARITIME,80,6,86,26,124,5,129,241
2021,76451,MONT SAINT AIGNAN,200023414,METROPOLE ROUEN NORMANDIE,76,SEINE MARITIME,259,48,307,10,138,14,152,469
2021,77407,SAINT FARGEAU PONTHIERRY,247700057,CA MELUN VAL DE SEINE,77,SEINE ET MARNE,124,4,128,3,209,5,214,345
2021,77288,MELUN,247700057,CA MELUN VAL DE SEINE,77,SEINE ET MARNE,451,5,456,29,298,13,311,796
2021,77251,LIEUSAINT,200059228,CA GRAND PARIS SUD SEINE ESSONNE SENART,77,SEINE ET MARNE,135,9,144,0,256,2,258,402
2021,77285,LE MEE SUR SEINE,247700057,CA MELUN VAL DE SEINE,77,SEINE ET MARNE,216,0,216,71,188,8,196,483
2021,77479,VAIRES SUR MARNE,200057958,CA PARIS - VALLEE DE LA MARNE,77,SEINE ET MARNE,131,1,132,0,110,6,116,248
2021,77131,COULOMMIERS,200090504,CA COULOMMIERS PAYS DE BRIE,77,SEINE ET MARNE,147,21,168,19,161,2,163,350
2021,77014,AVON,200072346,CA DU PAYS DE FONTAINEBLEAU,77,SEINE ET MARNE,69,7,76,1,124,8,132,208
2021,77305,MONTEREAU FAULT YONNE,247700107,CC PAYS DE MONTEREAU,77,SEINE ET MARNE,128,4,132,23,133,3,136,292
2021,77108,CHELLES,200057958,CA PARIS - VALLEE DE LA MARNE,77,SEINE ET MARNE,329,63,392,56,590,26,616,1064
2021,77337,NOISIEL,200057958,CA PARIS - VALLEE DE LA MARNE,77,SEINE ET MARNE,197,3,200,17,98,5,103,320
2021,77390,ROISSY EN BRIE,200057958,CA PARIS - VALLEE DE LA MARNE,77,SEINE ET MARNE,156,10,166,28,263,5,268,462
2021,77058,BUSSY SAINT GEORGES,247700594,CA MARNE ET GONDOIRE,77,SEINE ET MARNE,350,12,362,13,222,9,231,606
2021,77186,FONTAINEBLEAU,200072346,CA DU PAYS DE FONTAINEBLEAU,77,SEINE ET MARNE,139,15,154,7,103,15,118,279
2021,78126,LA CELLE SAINT CLOUD,247800584,CA VERSAILLES GRAND PARC (CAVGP),78,YVELINES,273,23,296,0,118,29,147,442
2021,78297,GUYANCOURT,200058782,CA DE SAINT QUENTIN EN YVELINES,78,YVELINES,619,11,630,160,320,8,328,1117
2021,78124,CARRIERES SUR SEINE,200058519,CA SAINT GERMAIN BOUCLES DE SEINE,78,YVELINES,220,16,236,10,112,16,128,374
2021,78372,MARLY LE ROI,200058519,CA SAINT GERMAIN BOUCLES DE SEINE,78,YVELINES,232,21,253,10,140,14,154,417
2021,78158,LE CHESNAY ROCQUENCOURT,247800584,CA VERSAILLES GRAND PARC (CAVGP),78,YVELINES,486,14,500,15,118,44,162,676
2021,78029,AUBERGENVILLE,200059889,CU GRAND PARIS SEINE ET OISE,78,YVELINES,88,32,120,0,104,2,106,226
2021,78418,MONTESSON,200058519,CA SAINT GERMAIN BOUCLES DE SEINE,78,YVELINES,195,4,199,5,118,18,136,339
2021,78650,LE VESINET,200058519,CA SAINT GERMAIN BOUCLES DE SEINE,78,YVELINES,233,11,244,15,55,71,126,385
2021,78358,MAISONS LAFFITTE,200058519,CA SAINT GERMAIN BOUCLES DE SEINE,78,YVELINES,329,77,406,2,104,78,182,590
2021,78688,VOISINS LE BRETONNEUX,200058782,CA DE SAINT QUENTIN EN YVELINES,78,YVELINES,95,6,101,0,93,8,101,202
2021,78242,FONTENAY LE FLEURY,247800584,CA VERSAILLES GRAND PARC (CAVGP),78,YVELINES,156,17,173,0,132,10,142,314
2021,78138,CHANTELOUP LES VIGNES,200059889,CU GRAND PARIS SEINE ET OISE,78,YVELINES,113,5,118,12,104,1,105,235
2021,78361,MANTES LA JOLIE,200059889,CU GRAND PARIS SEINE ET OISE,78,YVELINES,375,70,445,59,138,32,170,675
2021,78383,MAUREPAS,200058782,CA DE SAINT QUENTIN EN YVELINES,78,YVELINES,192,9,201,10,200,11,211,422
2021,78481,LE PECQ,200058519,CA SAINT GERMAIN BOUCLES DE SEINE,78,YVELINES,159,15,174,2,119,20,139,315
2021,78146,CHATOU,200058519,CA SAINT GERMAIN BOUCLES DE SEINE,78,YVELINES,453,25,478,11,222,94,316,805
2021,78646,VERSAILLES,247800584,CA VERSAILLES GRAND PARC (CAVGP),78,YVELINES,1146,171,1317,47,511,329,840,2204
2021,78545,SAINT CYR L ECOLE,247800584,CA VERSAILLES GRAND PARC (CAVGP),78,YVELINES,279,74,353,2,181,19,200,555
2021,78621,TRAPPES,200058782,CA DE SAINT QUENTIN EN YVELINES,78,YVELINES,250,26,276,94,281,8,289,659
2021,78640,VELIZY VILLACOUBLAY,247800584,CA VERSAILLES GRAND PARC (CAVGP),78,YVELINES,475,12,487,0,217,18,235,722
2021,79202,PARTHENAY,200041333,CC DE PARTHENAY-GATINE,79,DEUX SEVRES,72,0,72,5,75,2,77,154
2021,80021,AMIENS,248000531,CA AMIENS METROPOLE,80,SOMME,1103,112,1215,377,1004,72,1076,2668
2021,81140,LAVAUR,200034023,CC TARN-AGOUT,81,TARN,115,0,115,12,115,4,119,246
2021,81105,GRAULHET,200066124,CA GAILLAC-GRAULHET,81,TARN,76,0,76,34,65,3,68,178
2021,81099,GAILLAC,200066124,CA GAILLAC-GRAULHET,81,TARN,62,10,72,13,154,7,161,246
2021,82033,CASTELSARRASIN,200066322,CC TERRES DES CONFLUENCES,82,TARN ET GARONNE,95,9,104,7,120,2,122,232
2021,83061,FREJUS,200035319,CA ESTEREL COTE D'AZUR AGGLOMERATION,83,VAR,406,16,422,34,295,20,315,771
2021,83047,LA CRAU,248300543,METROPOLE TOULON-PROVENCE-MEDITERRANEE,83,VAR,97,15,112,0,204,8,212,324
2021,83062,LA GARDE,248300543,METROPOLE TOULON-PROVENCE-MEDITERRANEE,83,VAR,280,25,305,8,153,15,168,482
2021,83123,SANARY SUR MER,248300394,CA SUD SAINTE BAUME,83,VAR,112,27,139,0,90,7,97,236
2021,83042,COGOLIN,200036077,CC DU GOLFE DE SAINT-TROPEZ,83,VAR,108,2,110,0,82,0,82,191
2021,83073,LE LUC,248300550,CC COEUR DU VAR,83,VAR,90,4,94,0,75,7,82,176
2021,83069,HYERES,248300543,METROPOLE TOULON-PROVENCE-MEDITERRANEE,83,VAR,383,32,415,16,298,29,327,759
2021,83130,SOLLIES PONT,248300410,CC DE LA VALLEE DU GAPEAU,83,VAR,95,14,109,3,139,8,147,259
2021,84031,CARPENTRAS,248400053,CA VENTOUX-COMTAT-VENAISSIN (COVE),84,VAUCLUSE,208,19,227,0,189,9,198,425
2021,84019,BOLLENE,200000628,CC RHONE LEZ PROVENCE,84,VAUCLUSE,70,10,80,29,96,1,97,207
2021,84089,PERTUIS,200054807,METROPOLE D'AIX-MARSEILLE-PROVENCE,84,VAUCLUSE,150,1,151,8,249,9,258,417
2021,84007,AVIGNON,248400251,CA DU GRAND AVIGNON (COGA),84,VAUCLUSE,757,123,880,67,329,33,362,1308
2021,84088,PERNES LES FONTAINES,248400293,CA DES SORGUES DU COMTAT,84,VAUCLUSE,68,9,77,6,125,2,127,210
2021,84035,CAVAILLON,200040442,CA LUBERON MONTS DE VAUCLUSE,84,VAUCLUSE,200,6,206,1,127,7,134,341
2021,85092,FONTENAY LE COMTE,200071934,CC DU PAYS DE FONTENAY-VENDEE,85,VENDEE,24,4,28,12,150,3,153,193
2021,86066,CHATELLERAULT,248600413,CA GRAND CHATELLERAULT,86,VIENNE,125,8,133,82,229,5,234,450
2021,89024,AUXERRE,200067114,CA DE L'AUXERROIS,89,YONNE,264,8,272,26,367,13,380,678
2021,90010,BELFORT,200069052,CA GRAND BELFORT,90,TERRITOIRE DE BELFORT,395,12,407,171,251,16,267,845
2021,91421,MONTGERON,200058477,CA VAL D'YERRES VAL DE SEINE,91,ESSONNE,196,10,206,18,245,16,261,485
2021,91434,MORSANG SUR ORGE,200057859,CA COEUR D'ESSONNE AGGLOMERATION,91,ESSONNE,200,14,214,0,248,7,255,469
2021,91432,MORANGIS,200054781,METROPOLE DU GRAND PARIS,91,ESSONNE,125,4,129,0,158,9,167,296
2021,91552,SAINT GERMAIN LES ARPAJON,200057859,CA COEUR D'ESSONNE AGGLOMERATION,91,ESSONNE,14,12,26,0,162,2,164,189
2021,91645,VERRIERES LE BUISSON,200056232,CA COMMUNAUTE PARIS-SACLAY,91,ESSONNE,147,7,154,9,83,8,91,253
2021,91521,RIS ORANGIS,200059228,CA GRAND PARIS SUD SEINE ESSONNE SENART,91,ESSONNE,201,21,222,16,289,7,296,534
2021,91549,SAINTE GENEVIEVE DES BOIS,200057859,CA COEUR D'ESSONNE AGGLOMERATION,91,ESSONNE,260,45,305,35,369,13,382,722
2021,91657,VIGNEUX SUR SEINE,200058477,CA VAL D'YERRES VAL DE SEINE,91,ESSONNE,218,34,252,7,262,11,273,532
2021,91174,CORBEIL ESSONNES,200059228,CA GRAND PARIS SUD SEINE ESSONNE SENART,91,ESSONNE,346,34,380,107,326,20,346,833
2021,91215,EPINAY SOUS SENART,200058477,CA VAL D'YERRES VAL DE SEINE,91,ESSONNE,80,2,82,36,140,1,141,259
2021,91228,EVRY COURCOURONNES,200059228,CA GRAND PARIS SUD SEINE ESSONNE SENART,91,ESSONNE,590,11,601,143,642,16,658,1402
2021,91386,MENNECY,249100546,CC DU VAL D'ESSONNE (CCVE),91,ESSONNE,100,9,109,0,176,5,181,290
2021,91477,PALAISEAU,200056232,CA COMMUNAUTE PARIS-SACLAY,91,ESSONNE,451,68,519,12,424,24,448,979
2021,91216,EPINAY SUR ORGE,200056232,CA COMMUNAUTE PARIS-SACLAY,91,ESSONNE,95,4,99,0,95,4,99,197
2021,91200,DOURDAN,249100595,CC LE DOURDANNAIS EN HUREPOIX (CCDH),91,ESSONNE,70,10,80,5,120,2,122,207
2021,91687,VIRY CHATILLON,200054781,METROPOLE DU GRAND PARIS,91,ESSONNE,356,37,393,12,330,10,340,745
2021,91691,YERRES,200058477,CA VAL D'YERRES VAL DE SEINE,91,ESSONNE,481,12,493,58,314,18,332,883
2021,91103,BRETIGNY SUR ORGE,200057859,CA COEUR D'ESSONNE AGGLOMERATION,91,ESSONNE,253,54,307,0,399,9,408,715
2021,92035,LA GARENNE COLOMBES,200054781,METROPOLE DU GRAND PARIS,92,HAUTS DE SEINE,679,49,728,4,110,117,227,960
2021,92009,BOIS COLOMBES,200054781,METROPOLE DU GRAND PARIS,92,HAUTS DE SEINE,382,133,515,0,170,153,323,838
2021,92004,ASNIERES SUR SEINE,200054781,METROPOLE DU GRAND PARIS,92,HAUTS DE SEINE,1300,210,1510,39,434,696,1130,2679
2021,92036,GENNEVILLIERS,200054781,METROPOLE DU GRAND PARIS,92,HAUTS DE SEINE,709,9,718,208,218,36,254,1180
2021,92078,VILLENEUVE LA GARENNE,200054781,METROPOLE DU GRAND PARIS,92,HAUTS DE SEINE,314,3,317,23,77,9,86,426
2021,92024,CLICHY,200054781,METROPOLE DU GRAND PARIS,92,HAUTS DE SEINE,937,110,1047,41,445,215,660,1748
2021,92025,COLOMBES,200054781,METROPOLE DU GRAND PARIS,92,HAUTS DE SEINE,1200,145,1345,49,566,250,816,2210
2021,92012,BOULOGNE BILLANCOURT,200054781,METROPOLE DU GRAND PARIS,92,HAUTS DE SEINE,2325,256,2581,37,490,816,1306,3924
2021,92022,CHAVILLE,200054781,METROPOLE DU GRAND PARIS,92,HAUTS DE SEINE,248,34,282,6,130,88,218,506
2021,92020,CHATILLON,200054781,METROPOLE DU GRAND PARIS,92,HAUTS DE SEINE,513,88,601,0,238,101,339,940
2021,92073,SURESNES,200054781,METROPOLE DU GRAND PARIS,92,HAUTS DE SEINE,802,136,938,30,454,206,660,1628
2021,93013,LE BOURGET,200054781,METROPOLE DU GRAND PARIS,93,SEINE SAINT DENIS,141,4,145,0,45,6,51,197
2021,93001,AUBERVILLIERS,200054781,METROPOLE DU GRAND PARIS,93,SEINE SAINT DENIS,649,17,666,70,240,45,285,1021
2021,93032,GAGNY,200054781,METROPOLE DU GRAND PARIS,93,SEINE SAINT DENIS,330,18,348,5,278,42,320,674
2021,93062,LE RAINCY,200054781,METROPOLE DU GRAND PARIS,93,SEINE SAINT DENIS,179,8,187,0,135,18,153,340
2021,93029,DRANCY,200054781,METROPOLE DU GRAND PARIS,93,SEINE SAINT DENIS,520,8,528,0,297,25,322,850
2021,93059,PIERREFITTE SUR SEINE,200054781,METROPOLE DU GRAND PARIS,93,SEINE SAINT DENIS,220,13,233,19,98,11,109,361
2021,93055,PANTIN,200054781,METROPOLE DU GRAND PARIS,93,SEINE SAINT DENIS,684,60,744,67,277,171,448,1260
2021,93064,ROSNY SOUS BOIS,200054781,METROPOLE DU GRAND PARIS,93,SEINE SAINT DENIS,525,22,547,7,335,44,379,934
2021,93005,AULNAY SOUS BOIS,200054781,METROPOLE DU GRAND PARIS,93,SEINE SAINT DENIS,791,23,814,111,325,17,342,1267
2021,93046,LIVRY GARGAN,200054781,METROPOLE DU GRAND PARIS,93,SEINE SAINT DENIS,400,49,449,0,291,22,313,762
2021,93049,NEUILLY PLAISANCE,200054781,METROPOLE DU GRAND PARIS,93,SEINE SAINT DENIS,162,31,193,0,146,15,161,354
2021,94068,SAINT MAUR DES FOSSES,200054781,METROPOLE DU GRAND PARIS,94,VAL DE MARNE,728,133,861,61,440,155,595,1517
2021,94016,CACHAN,200054781,METROPOLE DU GRAND PARIS,94,VAL DE MARNE,319,22,341,19,231,41,272,632
2021,94078,VILLENEUVE SAINT GEORGES,200054781,METROPOLE DU GRAND PARIS,94,VAL DE MARNE,210,7,217,37,142,5,147,401
2021,94060,LA QUEUE EN BRIE,200054781,METROPOLE DU GRAND PARIS,94,VAL DE MARNE,113,1,114,0,95,2,97,210
2021,94076,VILLEJUIF,200054781,METROPOLE DU GRAND PARIS,94,VAL DE MARNE,698,45,743,80,316,57,373,1196
2021,94055,ORMESSON SUR MARNE,200054781,METROPOLE DU GRAND PARIS,94,VAL DE MARNE,112,2,114,0,80,5,85,199
2021,94018,CHARENTON LE PONT,200054781,METROPOLE DU GRAND PARIS,94,VAL DE MARNE,557,35,592,0,148,124,272,864
2021,94041,IVRY SUR SEINE,200054781,METROPOLE DU GRAND PARIS,94,VAL DE MARNE,723,97,820,79,302,50,352,1251
2021,94077,VILLENEUVE LE ROI,200054781,METROPOLE DU GRAND PARIS,94,VAL DE MARNE,214,11,225,1,113,5,118,344
2021,94038,L'HAY LES ROSES,200054781,METROPOLE DU GRAND PARIS,94,VAL DE MARNE,292,58,350,16,218,21,239,605
2021,94074,VALENTON,200054781,METROPOLE DU GRAND PARIS,94,VAL DE MARNE,122,9,131,51,51,7,58,241
2021,94081,VITRY SUR SEINE,200054781,METROPOLE DU GRAND PARIS,94,VAL DE MARNE,774,97,871,53,289,49,338,1262
2021,94058,LE PERREUX SUR MARNE,200054781,METROPOLE DU GRAND PARIS,94,VAL DE MARNE,409,65,474,3,215,73,288,766
2021,94073,THIAIS,200054781,METROPOLE DU GRAND PARIS,94,VAL DE MARNE,340,67,407,11,184,15,199,617
2021,94054,ORLY,200054781,METROPOLE DU GRAND PARIS,94,VAL DE MARNE,271,8,279,80,138,4,142,501
2021,95500,PONTOISE,249500109,CA DE CERGY-PONTOISE,95,VAL D OISE,335,31,366,24,254,10,264,654
2021,95280,GOUSSAINVILLE,200055655,CA ROISSY PAYS DE FRANCE,95,VAL D OISE,121,3,124,29,159,5,164,317
2021,95563,SAINT LEU LA FORET,200058485,CA VAL PARISIS,95,VAL D OISE,94,13,107,0,158,6,164,271
2021,95268,GARGES LES GONESSE,200055655,CA ROISSY PAYS DE FRANCE,95,VAL D OISE,273,3,276,149,147,11,158,583
2021,95585,SARCELLES,200055655,CA ROISSY PAYS DE FRANCE,95,VAL D OISE,371,39,410,268,243,49,292,970
2021,95323,JOUY LE MOUTIER,249500109,CA DE CERGY-PONTOISE,95,VAL D OISE,132,12,144,0,231,4,235,379
2021,95428,MONTMORENCY,200056380,CA PLAINE VALLEE,95,VAL D OISE,100,33,133,0,198,27,225,357
2021,95424,MONTIGNY LES CORMEILLES,200058485,CA VAL PARISIS,95,VAL D OISE,171,6,177,29,230,6,236,442
2021,95607,TAVERNY,200058485,CA VAL PARISIS,95,VAL D OISE,177,15,192,1,359,5,364,558
2021,95176,CORMEILLES EN PARISIS,200058485,CA VAL PARISIS,95,VAL D OISE,180,47,227,0,282,32,314,541
2021,95018,ARGENTEUIL,200054781,METROPOLE DU GRAND PARIS,95,VAL D OISE,1057,63,1120,74,777,53,830,2024
2021,95063,BEZONS,200058519,CA SAINT GERMAIN BOUCLES DE SEINE,95,VAL D OISE,225,85,310,40,268,27,295,646
2021,97118,PETIT BOURG,249710062,CA DU NORD BASSE-TERRE,971,GUADELOUPE,50,49,99,45,140,22,162,307
2021,97117,LE MOULE,200044691,CA DU NORD GRANDE TERRE,971,GUADELOUPE,0,74,74,40,91,5,96,210
2021,97101,LES ABYMES,200018653,CA CAP EXCELLENCE,971,GUADELOUPE,483,36,519,144,291,11,302,965
2021,97209,FORT DE FRANCE,249720061,CA DU CENTRE DE LA MARTINIQUE,972,MARTINIQUE,815,39,854,244,231,24,255,1353
2021,97221,RIVIERE SALEE,249720053,CA DE L'ESPACE SUD DE LA MARTINIQUE,972,MARTINIQUE,0,8,8,73,62,1,63,144
2021,97311,SAINT LAURENT DU MARONI,249730037,CC DE L'OUEST GUYANAIS,973,GUYANE,170,0,170,0,65,6,71,241
2021,97309,REMIRE MONTJOLY,249730045,CA DU CENTRE LITTORAL,973,GUYANE,287,15,302,12,100,18,118,432
2021,97304,KOUROU,200027548,CC DES SAVANES,973,GUYANE,280,0,280,22,59,31,90,392
2021,97409,SAINT ANDRE,249740093,CA INTERCOMMUNALE DE LA REUNION EST (CIREST),974,LA REUNION,478,177,655,81,177,30,207,943
2021,97413,SAINT LEU,249740101,CA TERRITOIRE DE LA COTE OUEST (TCO),974,LA REUNION,147,145,292,27,187,54,241,560
2021,97411,SAINT DENIS,249740119,CA INTERCOMMUNALE DU NORD DE LA REUNION (CINOR),974,LA REUNION,1389,652,2041,296,361,92,453,2790
2021,97416,SAINT PIERRE,249740077,CA CIVIS (COMMUNAUTE INTERCOMMUNALE DES VILLES SOLIDAIRES),974,LA REUNION,525,431,956,119,427,60,487,1562
2021,97407,LE PORT,249740101,CA TERRITOIRE DE LA COTE OUEST (TCO),974,LA REUNION,300,43,343,73,91,16,107,523
2021,97701,SAINT-BARTHELEMY,XX,XX,977,COLLECTIVITE D'OUTRE MER SAINT BARTHELEMY,0,0,0,19,0,12,12,31
2022,01053,BOURG EN BRESSE,200071751,CA DU BASSIN DE BOURG-EN-BRESSE,01,AIN,375,23,398,45,293,12,305,749
2022,01160,FERNEY VOLTAIRE,240100750,CA DU PAYS DE GEX,01,AIN,50,10,60,0,91,1,92,152
2022,01173,GEX,240100750,CA DU PAYS DE GEX,01,AIN,119,10,129,0,174,2,176,304
2022,02408,LAON,200043495,CA DU PAYS DE LAON,02,AISNE,116,8,124,27,224,4,228,380
2022,02691,SAINT QUENTIN,200071892,CA DU SAINT-QUENTINOIS,02,AISNE,161,81,242,171,337,10,347,761
2022,04112,MANOSQUE,200034700,CA DURANCE-LUBERON-VERDON AGGLOMERATION,04,ALPES DE HAUTE PROVENCE,191,22,213,29,132,5,137,379
2022,06079,MANDELIEU LA NAPOULE,200039915,CA CANNES PAYS DE LERINS,06,ALPES MARITIMES,233,12,245,0,122,17,139,384
2022,06085,MOUGINS,200039915,CA CANNES PAYS DE LERINS,06,ALPES MARITIMES,241,30,271,1,137,14,151,424
2022,06123,SAINT LAURENT DU VAR,200030195,METROPOLE NICE COTE D'AZUR,06,ALPES MARITIMES,249,63,312,0,343,11,354,667
2022,06149,LA TRINITE,200030195,METROPOLE NICE COTE D'AZUR,06,ALPES MARITIMES,66,2,68,10,78,2,80,158
2022,06157,VENCE,200030195,METROPOLE NICE COTE D'AZUR,06,ALPES MARITIMES,159,2,161,10,82,13,95,266
2022,07324,TOURNON SUR RHONE,200073096,CA ARCHE AGGLO,07,ARDECHE,50,1,51,40,106,6,112,204
2022,09225,PAMIERS,200066231,CC DES PORTES D'ARIEGE PYRENEES,09,ARIEGE,184,0,184,9,90,4,94,287
2022,10323,ROMILLY SUR SEINE,200000545,CC DES PORTES DE ROMILLY SUR SEINE,10,AUBE,55,1,56,49,155,5,160,265
2022,10333,SAINT ANDRE LES VERGERS,200069250,CA TROYES CHAMPAGNE METROPOLE,10,AUBE,112,2,114,0,137,3,140,254
2022,11206,LIMOUX,200071926,CC DU LIMOUXIN,11,AUDE,55,0,55,23,44,7,51,129
2022,13001,AIX EN PROVENCE,200054807,METROPOLE D'AIX-MARSEILLE-PROVENCE,13,BOUCHES DU RHONE,1431,316,1747,65,881,154,1035,2847
2022,13004,ARLES,241300417,CA D'ARLES-CRAU-CAMARGUE-MONTAGNETTE,13,BOUCHES DU RHONE,191,36,227,64,293,21,314,605
2022,13028,LA CIOTAT,200054807,METROPOLE D'AIX-MARSEILLE-PROVENCE,13,BOUCHES DU RHONE,246,14,260,17,292,17,309,585
2022,13056,MARTIGUES,200054807,METROPOLE D'AIX-MARSEILLE-PROVENCE,13,BOUCHES DU RHONE,515,11,526,33,161,16,177,736
2022,13069,PELISSANNE,200054807,METROPOLE D'AIX-MARSEILLE-PROVENCE,13,BOUCHES DU RHONE,72,8,80,3,122,8,130,213
2022,13081,ROGNAC,200054807,METROPOLE D'AIX-MARSEILLE-PROVENCE,13,BOUCHES DU RHONE,81,26,107,0,165,1,166,273
2022,13103,SALON DE PROVENCE,200054807,METROPOLE D'AIX-MARSEILLE-PROVENCE,13,BOUCHES DU RHONE,382,55,437,3,350,35,385,826
2022,13106,SEPTEMES LES VALLONS,200054807,METROPOLE D'AIX-MARSEILLE-PROVENCE,13,BOUCHES DU RHONE,99,11,110,17,53,7,60,188
2022,13201,MARSEILLE 1ER ARRONDISSEMENT,200054807,METROPOLE D'AIX-MARSEILLE-PROVENCE,13,BOUCHES DU RHONE,302,49,351,16,117,34,151,518
2022,13202,MARSEILLE 2E ARRONDISSEMENT,200054807,METROPOLE D'AIX-MARSEILLE-PROVENCE,13,BOUCHES DU RHONE,340,49,389,32,50,20,70,492
2022,13205,MARSEILLE 5E ARRONDISSEMENT,200054807,METROPOLE D'AIX-MARSEILLE-PROVENCE,13,BOUCHES DU RHONE,583,124,707,0,310,47,357,1064
2022,13206,MARSEILLE 6E ARRONDISSEMENT,200054807,METROPOLE D'AIX-MARSEILLE-PROVENCE,13,BOUCHES DU RHONE,617,215,832,12,230,84,314,1158
2022,13207,MARSEILLE 7E ARRONDISSEMENT,200054807,METROPOLE D'AIX-MARSEILLE-PROVENCE,13,BOUCHES DU RHONE,362,96,458,18,242,84,326,802
2022,13212,MARSEILLE 12E ARRONDISSEMENT,200054807,METROPOLE D'AIX-MARSEILLE-PROVENCE,13,BOUCHES DU RHONE,459,234,693,13,397,60,457,1162
2022,14327,HEROUVILLE SAINT CLAIR,200065597,CU CAEN LA MER,14,CALVADOS,239,12,251,64,261,4,265,580
2022,15014,AURILLAC,241500230,CA DU BASSIN D'AURILLAC,15,CANTAL,188,3,191,46,207,8,215,452
2022,17299,ROCHEFORT,200041762,CA ROCHEFORT OCEAN,17,CHARENTE MARITIME,187,3,190,36,214,5,219,445
2022,17300,LA ROCHELLE,241700434,CA DE LA ROCHELLE,17,CHARENTE MARITIME,543,55,598,63,560,72,632,1294
2022,17306,ROYAN,241700640,CA ROYAN ATLANTIQUE,17,CHARENTE MARITIME,49,0,49,24,88,6,94,168
2022,2A004,AJACCIO,242010056,CA DU PAYS AJACCIEN,20R,CORSE,470,12,482,18,203,11,214,715
2022,2A247,PORTO VECCHIO,200040764,CC DU SUD CORSE,20R,CORSE,88,0,88,5,28,7,35,128
2022,22093,LAMBALLE ARMOR,200069391,CA LAMBALLE TERRE ET MER,22,COTES D ARMOR,46,11,57,19,275,1,276,353
2022,22113,LANNION,200065928,CA LANNION-TREGOR COMMUNAUTE,22,COTES D ARMOR,130,4,134,38,189,6,195,367
2022,22278,SAINT BRIEUC,200069409,CA SAINT-BRIEUC ARMOR AGGLOMERATION,22,COTES D ARMOR,191,8,199,88,434,10,444,731
2022,25580,VALENTIGNEY,200065647,CA PAYS DE MONTBELIARD AGGLOMERATION,25,DOUBS,37,1,38,19,76,1,77,134
2022,26252,PORTES LES VALENCE,200068781,CA VALENCE ROMANS AGGLO,26,DROME,40,6,46,7,153,2,155,209
2022,26362,VALENCE,200068781,CA VALENCE ROMANS AGGLO,26,DROME,729,67,796,132,421,35,456,1384
2022,27284,GISORS,200071843,CC DU VEXIN NORMAND,27,EURE,109,9,118,0,129,4,133,251
2022,27375,LOUVIERS,200089456,CA SEINE-EURE,27,EURE,183,2,185,30,178,2,180,394
2022,27681,VERNON,200072312,CA SEINE NORMANDIE AGGLOMERATION,27,EURE,160,81,241,0,254,10,264,505
2022,28085,CHARTRES,200033181,CA CHARTRES METROPOLE,28,EURE ET LOIR,365,40,405,28,328,30,358,791
2022,28404,VERNOUILLET,200040277,CA AGGLO DU PAYS DE DREUX,28,EURE ET LOIR,98,12,110,9,137,3,140,259
2022,29046,DOUARNENEZ,242900645,CC DOUARNENEZ COMMUNAUTE,29,FINISTERE,48,0,48,47,107,3,110,205
2022,29235,LE RELECQ KERHUON,242900314,BREST METROPOLE,29,FINISTERE,42,8,50,22,177,14,191,263
2022,30258,SAINT GILLES,243000643,CA DE NIMES METROPOLE,30,GARD,32,5,37,24,142,4,146,207
2022,31044,BALMA,243100518,TOULOUSE METROPOLE,31,HAUTE GARONNE,209,10,219,0,138,18,156,375
2022,31069,BLAGNAC,243100518,TOULOUSE METROPOLE,31,HAUTE GARONNE,465,0,465,1,242,32,274,740
2022,31157,CUGNAUX,243100518,TOULOUSE METROPOLE,31,HAUTE GARONNE,212,36,248,0,235,11,246,494
2022,31187,FONSORBES,200068641,CA LE MURETAIN AGGLO,31,HAUTE GARONNE,76,9,85,0,195,4,199,285
2022,31395,MURET,200068641,CA LE MURETAIN AGGLO,31,HAUTE GARONNE,193,2,195,0,323,8,331,526
2022,31555,TOULOUSE,243100518,TOULOUSE METROPOLE,31,HAUTE GARONNE,6242,86,6328,281,2585,700,3285,9894
2022,33009,ARCACHON,243300563,CA BASSIN D'ARCACHON SUD (COBAS),33,GIRONDE,66,4,70,5,20,1,21,97
2022,33056,BLANQUEFORT,243300316,BORDEAUX METROPOLE,33,GIRONDE,114,23,137,0,231,11,242,379
2022,33075,BRUGES,243300316,BORDEAUX METROPOLE,33,GIRONDE,253,16,269,4,346,12,358,631
2022,33162,EYSINES,243300316,BORDEAUX METROPOLE,33,GIRONDE,168,57,225,0,383,5,388,613
2022,33167,FLOIRAC,243300316,BORDEAUX METROPOLE,33,GIRONDE,134,24,158,30,290,8,298,486
2022,33200,LE HAILLAN,243300316,BORDEAUX METROPOLE,33,GIRONDE,140,16,156,0,137,3,140,296
2022,33238,LEOGNAN,243301264,CC DE MONTESQUIEU,33,GIRONDE,39,18,57,0,178,3,181,238
2022,33243,LIBOURNE,200070092,CA DU LIBOURNAIS,33,GIRONDE,222,20,242,4,246,8,254,500
2022,33284,MIOS,243301504,CA DU BASSIN D'ARCACHON NORD,33,GIRONDE,20,39,59,0,289,2,291,350
2022,33366,SAINT ANDRE DE CUBZAC,243301223,CC DU GRAND CUBZAGUAIS,33,GIRONDE,46,7,53,0,298,5,303,356
2022,33522,TALENCE,243300316,BORDEAUX METROPOLE,33,GIRONDE,308,85,393,19,370,52,422,834
2022,33529,LA TESTE DE BUCH,243300563,CA BASSIN D'ARCACHON SUD (COBAS),33,GIRONDE,97,45,142,5,229,7,236,383
2022,33550,VILLENAVE D ORNON,243300316,BORDEAUX METROPOLE,33,GIRONDE,283,58,341,10,619,19,638,989
2022,34057,CASTELNAU LE LEZ,243400017,MONTPELLIER MEDITERRANEE METROPOLE,34,HERAULT,171,59,230,9,158,37,195,434
2022,34270,SAINT JEAN DE VEDAS,243400017,MONTPELLIER MEDITERRANEE METROPOLE,34,HERAULT,54,68,122,0,181,5,186,308
2022,35024,BETTON,243500139,RENNES METROPOLE,35,ILLE ET VILAINE,48,58,106,22,171,11,182,310
2022,35281,SAINT JACQUES DE LA LANDE,243500139,RENNES METROPOLE,35,ILLE ET VILAINE,126,19,145,18,208,8,216,379
2022,35288,SAINT MALO,243500782,CA DU PAYS DE SAINT MALO AGGLOMERATION,35,ILLE ET VILAINE,275,32,307,140,371,36,407,854
2022,37003,AMBOISE,200043065,CC DU VAL D AMBOISE,37,INDRE ET LOIRE,60,4,64,0,193,1,194,259
2022,37050,CHAMBRAY LES TOURS,243700754,TOURS METROPOLE VAL DE LOIRE,37,INDRE ET LOIRE,103,15,118,0,188,6,194,312
2022,37261,TOURS,243700754,TOURS METROPOLE VAL DE LOIRE,37,INDRE ET LOIRE,1203,310,1513,103,1241,81,1322,2938
2022,38229,MEYLAN,200040715,GRENOBLE-ALPES-METROPOLE,38,ISERE,184,46,230,0,165,4,169,399
2022,38474,SASSENAGE,200040715,GRENOBLE-ALPES-METROPOLE,38,ISERE,88,9,97,0,194,2,196,294
2022,38553,VILLEFONTAINE,243800604,CA PORTE DE L'ISERE (CAPI),38,ISERE,153,35,188,27,224,7,231,446
2022,40312,TARNOS,244000659,CC DU SEIGNANX,40,LANDES,60,44,104,5,123,6,129,238
2022,42186,RIVE DE GIER,244200770,SAINT-ETIENNE METROPOLE,42,LOIRE,58,45,103,1,180,5,185,289
2022,42187,ROANNE,200035731,CA ROANNAIS AGGLOMERATION,42,LOIRE,197,18,215,15,213,9,222,452
2022,42207,SAINT CHAMOND,244200770,SAINT-ETIENNE METROPOLE,42,LOIRE,198,29,227,34,324,12,336,597
2022,43157,LE PUY EN VELAY,200073419,CA DU PUY-EN-VELAY,43,HAUTE LOIRE,107,1,108,88,131,5,136,332
2022,44026,CARQUEFOU,244400404,NANTES METROPOLE,44,LOIRE ATLANTIQUE,198,27,225,5,309,15,324,554
2022,47157,MARMANDE,200030674,CA VAL DE GARONNE AGGLOMERATION,47,LOT ET GARONNE,137,0,137,6,172,2,174,317
2022,49018,BAUGE EN ANJOU,244900882,CC BAUGEOIS VALLEE,49,MAINE ET LOIRE,60,11,71,14,91,2,93,178
2022,49092,CHEMILLE EN ANJOU,200060010,CA MAUGES COMMUNAUTE,49,MAINE ET LOIRE,36,47,83,45,366,3,369,497
2022,49099,CHOLET,200071678,CA AGGLOMERATION DU CHOLETAIS,49,MAINE ET LOIRE,292,53,345,156,602,19,621,1122
2022,49218,MONTREVAULT SUR EVRE,200060010,CA MAUGES COMMUNAUTE,49,MAINE ET LOIRE,36,10,46,41,188,3,191,279
2022,49244,MAUGES SUR LOIRE,200060010,CA MAUGES COMMUNAUTE,49,MAINE ET LOIRE,42,4,46,43,242,6,248,337
2022,50025,AVRANCHES,200069425,CA MONT-SAINT-MICHEL-NORMANDIE,50,MANCHE,45,6,51,39,100,3,103,193
2022,50129,CHERBOURG EN COTENTIN,200067205,CA DU COTENTIN,50,MANCHE,594,0,594,145,838,35,873,1612
2022,51108,CHALONS EN CHAMPAGNE,200066876,CA DE CHALONS-EN-CHAMPAGNE,51,MARNE,491,30,521,42,290,28,318,881
2022,54528,TOUL,200070563,CC TERRES TOULOISES,54,MEURTHE ET MOSELLE,110,3,113,17,183,3,186,317
2022,54547,VANDOEUVRE LES NANCY,245400676,METROPOLE DU GRAND NANCY,54,MEURTHE ET MOSELLE,284,19,303,48,160,12,172,523
2022,56007,AURAY,200043123,CC AURAY QUIBERON TERRE ATLANTIQUE,56,MORBIHAN,45,0,45,71,159,8,167,284
2022,57433,MAIZIERES LES METZ,200039949,CC RIVES DE MOSELLE,57,MOSELLE,30,14,44,0,165,1,166,210
2022,57757,YUTZ,245701362,CA PORTES DE FRANCE-THIONVILLE,57,MOSELLE,101,32,133,6,138,0,138,277
2022,59014,ANZIN,245901160,CA VALENCIENNES METROPOLE,59,NORD,25,4,29,70,80,2,82,182
2022,59155,COUDEKERQUE BRANCHE,245900428,CU DE DUNKERQUE,59,NORD,62,15,77,68,261,1,262,408
2022,59286,HAUBOURDIN,200093201,METROPOLE EUROPEENNE DE LILLE,59,NORD,61,38,99,40,211,5,216,355
2022,59378,MARCQ EN BAROEUL,200093201,METROPOLE EUROPEENNE DE LILLE,59,NORD,286,242,528,49,451,76,527,1104
2022,59421,MOUVAUX,200093201,METROPOLE EUROPEENNE DE LILLE,59,NORD,85,74,159,25,164,24,188,371
2022,59508,RONCQ,200093201,METROPOLE EUROPEENNE DE LILLE,59,NORD,107,35,142,37,124,3,127,306
2022,59544,SAINT SAULVE,245901160,CA VALENCIENNES METROPOLE,59,NORD,150,4,154,28,117,4,121,303
2022,59636,WAMBRECHIES,200093201,METROPOLE EUROPEENNE DE LILLE,59,NORD,30,60,90,22,170,13,183,295
2022,59648,WATTIGNIES,200093201,METROPOLE EUROPEENNE DE LILLE,59,NORD,74,60,134,16,146,6,152,301
2022,60141,CHANTILLY,246000764,CC DE L'AIRE CANTILIENNE,60,OISE,126,2,128,8,128,10,138,274
2022,60175,CREIL,200068047,CA CREIL SUD OISE,60,OISE,239,3,242,66,130,5,135,443
2022,60176,CREPY EN VALOIS,246000871,CC DU PAYS DE VALOIS,60,OISE,97,7,104,14,186,5,191,308
2022,60414,MONTATAIRE,200068047,CA CREIL SUD OISE,60,OISE,101,0,101,21,112,2,114,236
2022,60509,PONT SAINTE MAXENCE,246000921,CC DES PAYS D'OISE ET D'HALATTE,60,OISE,152,6,158,15,116,2,118,291
2022,62643,OUTREAU,246200729,CA DU BOULONNAIS,62,PAS DE CALAIS,60,1,61,64,91,6,97,223
2022,63124,COURNON D AUVERGNE,246300701,CLERMONT AUVERGNE METROPOLE,63,PUY DE DOME,99,16,115,14,226,10,236,365
2022,63430,THIERS,200070712,CC THIERS DORE ET MONTAGNE,63,PUY DE DOME,15,3,18,38,109,3,112,168
2022,64545,URRUGNE,200067106,CA DU PAYS BASQUE,64,PYRENEES ATLANTIQUES,81,13,94,4,64,1,65,163
2017,62587,MONTIGNY EN GOHELLE,246200299,CA D'HENIN-CARVIN,62,PAS DE CALAIS,30,7,37,44,76,2,78,159
2017,62643,OUTREAU,246200729,CA DU BOULONNAIS,62,PAS DE CALAIS,60,1,61,63,89,2,91,215
2017,62758,SAINT MARTIN BOULOGNE,246200729,CA DU BOULONNAIS,62,PAS DE CALAIS,50,7,57,52,123,2,125,234
2017,62765,SAINT OMER,200069037,CA DU PAYS DE SAINT-OMER,62,PAS DE CALAIS,25,2,27,91,125,3,128,246
2017,63075,CHAMALIERES,246300701,CLERMONT AUVERGNE METROPOLE,63,PUY DE DOME,206,3,209,10,112,21,133,352
2017,63113,CLERMONT FERRAND,246300701,CLERMONT AUVERGNE METROPOLE,63,PUY DE DOME,963,62,1025,96,1307,70,1377,2498
2017,63164,GERZAT,246300701,CLERMONT AUVERGNE METROPOLE,63,PUY DE DOME,40,2,42,0,209,2,211,253
2017,63178,ISSOIRE,200070407,CA AGGLO PAYS D'ISSOIRE,63,PUY DE DOME,93,0,93,4,262,1,263,360
2017,64024,ANGLET,200067106,CA DU PAYS BASQUE,64,PYRENEES ATLANTIQUES,145,93,238,21,413,28,441,700
2017,64122,BIARRITZ,200067106,CA DU PAYS BASQUE,64,PYRENEES ATLANTIQUES,170,22,192,27,119,17,136,355
2017,64129,BILLERE,200067254,CA PAU BEARN PYRENEES,64,PYRENEES ATLANTIQUES,94,17,111,10,137,6,143,264
2017,64483,SAINT JEAN DE LUZ,200067106,CA DU PAYS BASQUE,64,PYRENEES ATLANTIQUES,48,25,73,30,90,5,95,198
2017,65286,LOURDES,200069300,CA TARBES-LOURDES-PYRENEES,65,HAUTES PYRENEES,126,0,126,52,57,1,58,237
2017,66028,CABESTANY,200027183,CU PERPIGNAN MEDITERRANEE METROPOLE,66,PYRENEES ORIENTALES,75,10,85,16,71,4,75,176
2017,66180,SAINT LAURENT DE LA SALANQUE,200027183,CU PERPIGNAN MEDITERRANEE METROPOLE,66,PYRENEES ORIENTALES,50,1,51,11,88,1,89,152
2017,67130,ERSTEIN,200067924,CC DU CANTON D'ERSTEIN,67,BAS RHIN,65,23,88,0,142,1,143,232
2017,67267,LINGOLSHEIM,246700488,EUROMETROPOLE DE STRASBOURG,67,BAS RHIN,149,24,173,0,182,1,183,356
2017,67348,OBERNAI,246701080,CC DU PAYS DE SAINTE-ODILE,67,BAS RHIN,126,9,135,4,81,3,84,223
2017,67437,SAVERNE,200068112,CC DU PAYS DE SAVERNE,67,BAS RHIN,111,11,122,16,103,3,106,244
2017,67447,SCHILTIGHEIM,246700488,EUROMETROPOLE DE STRASBOURG,67,BAS RHIN,387,59,446,72,373,15,388,906
2017,67462,SELESTAT,246700967,CC DE SELESTAT,67,BAS RHIN,105,31,136,0,183,7,190,327
2017,67482,STRASBOURG,246700488,EUROMETROPOLE DE STRASBOURG,67,BAS RHIN,3525,359,3884,505,1705,196,1901,6291
2017,68066,COLMAR,246800726,CA COLMAR AGGLOMERATION,68,HAUT RHIN,664,27,691,60,476,17,493,1245
2017,68271,RIEDISHEIM,200066009,CA MULHOUSE ALSACE AGGLOMERATION,68,HAUT RHIN,58,1,59,0,75,4,79,138
2017,68297,SAINT LOUIS,200066058,CA SAINT-LOUIS AGGLOMERATION,68,HAUT RHIN,136,2,138,30,148,2,150,318
2017,68375,WITTELSHEIM,200066009,CA MULHOUSE ALSACE AGGLOMERATION,68,HAUT RHIN,40,4,44,0,113,1,114,158
2017,69069,CRAPONNE,200046977,METROPOLE DE LYON,69,RHONE,112,18,130,0,156,13,169,299
2017,69089,FRANCHEVILLE,200046977,METROPOLE DE LYON,69,RHONE,89,45,134,2,168,13,181,318
2017,69256,VAULX EN VELIN,200046977,METROPOLE DE LYON,69,RHONE,340,5,345,258,375,14,389,992
2017,69259,VENISSIEUX,200046977,METROPOLE DE LYON,69,RHONE,414,12,426,631,466,20,486,1544
2017,69264,VILLEFRANCHE SUR SAONE,200040590,CA VILLEFRANCHE BEAUJOLAIS SAONE,69,RHONE,330,24,354,118,410,17,427,899
2017,69266,VILLEURBANNE,200046977,METROPOLE DE LYON,69,RHONE,836,205,1041,426,2020,90,2110,3577
2017,69271,CHASSIEU,200046977,METROPOLE DE LYON,69,RHONE,55,10,65,0,154,3,157,222
2017,69282,MEYZIEU,200046977,METROPOLE DE LYON,69,RHONE,232,58,290,64,442,21,463,817
2017,69283,MIONS,200046977,METROPOLE DE LYON,69,RHONE,59,20,79,0,221,1,222,301
2017,69286,RILLIEUX LA PAPE,200046977,METROPOLE DE LYON,69,RHONE,216,32,248,104,268,8,276,628
2017,69383,LYON 3E ARRONDISSEMENT,200046977,METROPOLE DE LYON,69,RHONE,1370,254,1624,8,1040,249,1289,2921
2017,69384,LYON 4E ARRONDISSEMENT,200046977,METROPOLE DE LYON,69,RHONE,382,77,459,31,416,84,500,990
2017,69388,LYON 8E ARRONDISSEMENT,200046977,METROPOLE DE LYON,69,RHONE,849,64,913,208,774,89,863,1984
2017,71076,CHALON SUR SAONE,247100589,CA LE GRAND CHALON,71,SAONE ET LOIRE,351,42,393,100,390,12,402,895
2017,71153,LE CREUSOT,247100290,CU LE CREUSOT MONTCEAU-LES-MINES,71,SAONE ET LOIRE,73,11,84,58,193,3,196,338
2017,73008,AIX LES BAINS,200068674,CA GRAND LAC,73,SAVOIE,155,20,175,28,286,7,293,496
2017,73065,CHAMBERY,200069110,CA DU GRAND CHAMBERY,73,SAVOIE,485,9,494,119,422,35,457,1071
2017,74042,BONNEVILLE,200000172,CC FAUCIGNY-GLIERES,74,HAUTE SAVOIE,52,10,62,0,218,3,221,284
2017,74081,CLUSES,200033116,CC CLUSES-ARVE ET MONTAGNES,74,HAUTE SAVOIE,68,0,68,45,181,0,181,295
2017,74208,PASSY,200034882,CC PAYS DU MONT-BLANC,74,HAUTE SAVOIE,86,5,91,0,136,2,138,229
2017,74243,SAINT JULIEN EN GENEVOIS,247400690,CC DU GENEVOIS,74,HAUTE SAVOIE,101,4,105,2,168,3,171,278
2017,74256,SALLANCHES,200034882,CC PAYS DU MONT-BLANC,74,HAUTE SAVOIE,106,9,115,0,233,3,236,351
2017,75101,PARIS 1ER ARRONDISSEMENT,200054781,METROPOLE DU GRAND PARIS,75,PARIS,234,0,234,10,21,97,118,362
2017,75108,PARIS 8E ARRONDISSEMENT,200054781,METROPOLE DU GRAND PARIS,75,PARIS,616,51,667,54,34,384,418,1139
2017,75109,PARIS 9E ARRONDISSEMENT,200054781,METROPOLE DU GRAND PARIS,75,PARIS,1089,82,1171,7,104,619,723,1901
2017,75116,PARIS 16E ARRONDISSEMENT,200054781,METROPOLE DU GRAND PARIS,75,PARIS,1516,179,1695,101,82,1193,1275,3071
2017,76108,BOIS GUILLAUME,200023414,METROPOLE ROUEN NORMANDIE,76,SEINE MARITIME,186,15,201,1,127,34,161,363
2017,76114,BOLBEC,200010700,CA CAUX SEINE AGGLO,76,SEINE MARITIME,38,1,39,26,193,5,198,263
2017,76157,CANTELEU,200023414,METROPOLE ROUEN NORMANDIE,76,SEINE MARITIME,167,4,171,32,153,3,156,359
2017,76165,CAUDEBEC LES ELBEUF,200023414,METROPOLE ROUEN NORMANDIE,76,SEINE MARITIME,30,3,33,0,162,1,163,196
2017,76216,DEVILLE LES ROUEN,200023414,METROPOLE ROUEN NORMANDIE,76,SEINE MARITIME,40,4,44,21,216,2,218,283
2017,76259,FECAMP,200069821,CA FECAMP CAUX LITTORAL AGGLOMERATION,76,SEINE MARITIME,126,1,127,38,148,2,150,315
2017,76451,MONT SAINT AIGNAN,200023414,METROPOLE ROUEN NORMANDIE,76,SEINE MARITIME,258,17,275,3,176,29,205,483
2017,76484,OISSEL,200023414,METROPOLE ROUEN NORMANDIE,76,SEINE MARITIME,12,0,12,25,212,1,213,250
2017,76681,SOTTEVILLE LES ROUEN,200023414,METROPOLE ROUEN NORMANDIE,76,SEINE MARITIME,195,19,214,12,506,5,511,737
2017,76758,YVETOT,247600620,CC YVETOT NORMANDIE,76,SEINE MARITIME,70,9,79,3,218,1,219,301
2017,77122,COMBS LA VILLE,200059228,CA GRAND PARIS SUD SEINE ESSONNE SENART,77,SEINE ET MARNE,163,2,165,24,356,9,365,553
2017,77243,LAGNY SUR MARNE,247700594,CA MARNE ET GONDOIRE,77,SEINE ET MARNE,86,11,97,1,339,9,348,445
2017,77258,LOGNES,200057958,CA PARIS - VALLEE DE LA MARNE,77,SEINE ET MARNE,207,2,209,0,161,8,169,378
2017,77307,MONTEVRAIN,247700594,CA MARNE ET GONDOIRE,77,SEINE ET MARNE,96,15,111,0,209,6,215,326
2017,77333,NEMOURS,200023240,CC PAYS DE NEMOURS,77,SEINE ET MARNE,0,0,0,0,201,2,203,203
2017,77337,NOISIEL,200057958,CA PARIS - VALLEE DE LA MARNE,77,SEINE ET MARNE,190,2,192,23,113,15,128,343
2017,77373,PONTAULT COMBAULT,200057958,CA PARIS - VALLEE DE LA MARNE,77,SEINE ET MARNE,245,1,246,41,631,9,640,927
2017,77390,ROISSY EN BRIE,200057958,CA PARIS - VALLEE DE LA MARNE,77,SEINE ET MARNE,150,2,152,24,297,8,305,482
2017,78005,ACHERES,200059889,CU GRAND PARIS SEINE ET OISE,78,YVELINES,187,17,204,15,284,16,300,519
2017,78138,CHANTELOUP LES VIGNES,200059889,CU GRAND PARIS SEINE ET OISE,78,YVELINES,108,3,111,6,95,7,102,219
2017,78165,LES CLAYES SOUS BOIS,200058782,CA DE SAINT QUENTIN EN YVELINES,78,YVELINES,153,9,162,34,211,12,223,420
2017,78172,CONFLANS SAINTE HONORINE,200059889,CU GRAND PARIS SEINE ET OISE,78,YVELINES,371,18,389,4,488,12,500,893
2017,78208,ELANCOURT,200058782,CA DE SAINT QUENTIN EN YVELINES,78,YVELINES,335,5,340,11,406,8,414,765
2017,78297,GUYANCOURT,200058782,CA DE SAINT QUENTIN EN YVELINES,78,YVELINES,618,6,624,216,358,10,368,1208
2017,78311,HOUILLES,200058519,CA SAINT GERMAIN BOUCLES DE SEINE,78,YVELINES,287,91,378,1,505,55,560,939
2017,78335,LIMAY,200059889,CU GRAND PARIS SEINE ET OISE,78,YVELINES,145,10,155,0,197,4,201,357
2017,78358,MAISONS LAFFITTE,200058519,CA SAINT GERMAIN BOUCLES DE SEINE,78,YVELINES,335,51,386,1,116,101,217,604
2017,78362,MANTES LA VILLE,200059889,CU GRAND PARIS SEINE ET OISE,78,YVELINES,100,46,146,0,225,3,228,374
2017,78440,LES MUREAUX,200059889,CU GRAND PARIS SEINE ET OISE,78,YVELINES,292,34,326,89,188,5,193,607
2017,78545,SAINT CYR L ECOLE,247800584,CA VERSAILLES GRAND PARC (CAVGP),78,YVELINES,275,42,317,0,254,13,267,584
2017,78551,SAINT GERMAIN EN LAYE,200058519,CA SAINT GERMAIN BOUCLES DE SEINE,78,YVELINES,497,81,578,12,277,112,389,978
2017,78624,TRIEL SUR SEINE,200059889,CU GRAND PARIS SEINE ET OISE,78,YVELINES,45,24,69,0,159,6,165,234
2017,78642,VERNEUIL SUR SEINE,200059889,CU GRAND PARIS SEINE ET OISE,78,YVELINES,76,26,102,2,224,8,232,337
2017,78643,VERNOUILLET,200059889,CU GRAND PARIS SEINE ET OISE,78,YVELINES,82,9,91,16,93,5,98,205
2017,78646,VERSAILLES,247800584,CA VERSAILLES GRAND PARC (CAVGP),78,YVELINES,1088,94,1182,79,634,346,980,2241
2017,81004,ALBI,248100737,CA DE L'ALBIGEOIS (C2A),81,TARN,399,41,440,51,271,20,291,782
2017,81099,GAILLAC,200066124,CA GAILLAC-GRAULHET,81,TARN,62,6,68,9,211,6,217,294
2017,81163,MAZAMET,248100430,CA DE CASTRES MAZAMET,81,TARN,67,0,67,24,18,2,20,111
2017,83042,COGOLIN,200036077,CC DU GOLFE DE SAINT-TROPEZ,83,VAR,108,0,108,0,91,6,97,205
2017,83047,LA CRAU,248300543,METROPOLE TOULON-PROVENCE-MEDITERRANEE,83,VAR,97,8,105,1,211,6,217,323
2017,83069,HYERES,248300543,METROPOLE TOULON-PROVENCE-MEDITERRANEE,83,VAR,411,26,437,27,313,22,335,799
2017,83073,LE LUC,248300550,CC COEUR DU VAR,83,VAR,101,1,102,0,79,2,81,182
2017,83112,SAINT CYR SUR MER,248300394,CA SUD SAINTE BAUME,83,VAR,60,1,61,0,100,5,105,165
2017,83115,SAINTE MAXIME,200036077,CC DU GOLFE DE SAINT-TROPEZ,83,VAR,160,2,162,4,53,4,57,222
2017,83118,SAINT RAPHAEL,200035319,CA VAR ESTEREL MEDITERRANEE (CAVEM),83,VAR,213,19,232,9,148,10,158,400
2017,83129,SIX FOURS LES PLAGES,248300543,METROPOLE TOULON-PROVENCE-MEDITERRANEE,83,VAR,261,64,325,15,225,5,230,570
2017,83137,TOULON,248300543,METROPOLE TOULON-PROVENCE-MEDITERRANEE,83,VAR,1309,82,1391,341,974,136,1110,2842
2017,84003,APT,200040624,CC PAYS D'APT-LUBERON,84,VAUCLUSE,80,0,80,36,76,2,78,194
2017,84031,CARPENTRAS,248400053,CA VENTOUX-COMTAT-VENAISSIN (COVE),84,VAUCLUSE,198,8,206,12,168,11,179,397
2017,84087,ORANGE,248400236,CC DU PAYS REUNI D'ORANGE,84,VAUCLUSE,172,5,177,0,254,3,257,434
2017,84089,PERTUIS,200054807,METROPOLE D'AIX-MARSEILLE-PROVENCE,84,VAUCLUSE,151,1,152,3,268,6,274,429
2017,84141,VEDENE,248400251,CA DU GRAND AVIGNON (COGA),84,VAUCLUSE,65,16,81,0,155,5,160,242
2017,85191,LA ROCHE SUR YON,248500589,CA LA ROCHE SUR YON - AGGLOMERATION,85,VENDEE,390,7,397,85,539,31,570,1053
2017,85226,SAINT HILAIRE DE RIEZ,200023778,CC DU PAYS DE ST GILLES-CROIX-DE-VIE,85,VENDEE,35,0,35,17,160,0,160,212
2017,86041,BUXEROLLES,200069854,CU DU GRAND POITIERS,86,VIENNE,30,0,30,0,177,2,179,209
2017,86194,POITIERS,200069854,CU DU GRAND POITIERS,86,VIENNE,715,0,715,79,682,53,735,1529
2017,87114,PANAZOL,248719312,CU LIMOGES METROPOLE,87,HAUTE VIENNE,38,3,41,0,141,7,148,188
2017,87154,SAINT JUNIEN,200059400,CC PORTE OCEANE DU LIMOUSIN,87,HAUTE VIENNE,40,0,40,2,155,1,156,198
2017,91103,BRETIGNY SUR ORGE,200057859,CA COEUR D'ESSONNE AGGLOMERATION,91,ESSONNE,253,10,263,0,462,16,478,741
2017,91161,CHILLY MAZARIN,200056232,CA COMMUNAUTE PARIS-SACLAY,91,ESSONNE,258,0,258,0,293,2,295,553
2017,91200,DOURDAN,249100595,CC LE DOURDANNAIS EN HUREPOIX (CCDH),91,ESSONNE,70,0,70,6,146,2,148,224
2017,91228,EVRY COURCOURONNES,200059228,CA GRAND PARIS SUD SEINE ESSONNE SENART,91,ESSONNE,697,17,714,115,811,17,828,1657
2017,91272,GIF SUR YVETTE,200056232,CA COMMUNAUTE PARIS-SACLAY,91,ESSONNE,216,0,216,4,186,19,205,425
2017,91345,LONGJUMEAU,200056232,CA COMMUNAUTE PARIS-SACLAY,91,ESSONNE,225,2,227,7,254,17,271,505
2017,91432,MORANGIS,200054781,METROPOLE DU GRAND PARIS,91,ESSONNE,129,1,130,0,192,4,196,326
2017,91434,MORSANG SUR ORGE,200057859,CA COEUR D'ESSONNE AGGLOMERATION,91,ESSONNE,200,1,201,0,266,3,269,470
2017,91477,PALAISEAU,200056232,CA COMMUNAUTE PARIS-SACLAY,91,ESSONNE,518,26,544,0,465,18,483,1027
2017,91573,SAINT PIERRE DU PERRAY,200059228,CA GRAND PARIS SUD SEINE ESSONNE SENART,91,ESSONNE,97,5,102,0,253,8,261,364
2017,91589,SAVIGNY SUR ORGE,200054781,METROPOLE DU GRAND PARIS,91,ESSONNE,217,12,229,15,504,15,519,763
2017,91687,VIRY CHATILLON,200054781,METROPOLE DU GRAND PARIS,91,ESSONNE,331,3,334,16,387,13,400,750
2017,92004,ASNIERES SUR SEINE,200054781,METROPOLE DU GRAND PARIS,92,HAUTS DE SEINE,1299,98,1397,22,505,756,1261,2679
2017,92014,BOURG LA REINE,200054781,METROPOLE DU GRAND PARIS,92,HAUTS DE SEINE,327,6,333,0,95,53,148,481
2017,92025,COLOMBES,200054781,METROPOLE DU GRAND PARIS,92,HAUTS DE SEINE,1087,49,1136,55,649,268,917,2108
2017,92036,GENNEVILLIERS,200054781,METROPOLE DU GRAND PARIS,92,HAUTS DE SEINE,713,1,714,208,231,28,259,1181
2017,92048,MEUDON,200054781,METROPOLE DU GRAND PARIS,92,HAUTS DE SEINE,661,10,671,5,343,163,506,1181
2017,92049,MONTROUGE,200054781,METROPOLE DU GRAND PARIS,92,HAUTS DE SEINE,1058,35,1093,16,261,240,501,1610
2017,92060,LE PLESSIS ROBINSON,200054781,METROPOLE DU GRAND PARIS,92,HAUTS DE SEINE,473,5,478,12,296,46,342,832
2017,92072,SEVRES,200054781,METROPOLE DU GRAND PARIS,92,HAUTS DE SEINE,312,8,320,16,228,68,296,632
2017,92078,VILLENEUVE LA GARENNE,200054781,METROPOLE DU GRAND PARIS,92,HAUTS DE SEINE,354,0,354,25,77,13,90,469
2017,93013,LE BOURGET,200054781,METROPOLE DU GRAND PARIS,93,SEINE SAINT DENIS,141,1,142,23,57,4,61,226
2017,93029,DRANCY,200054781,METROPOLE DU GRAND PARIS,93,SEINE SAINT DENIS,493,2,495,1,347,24,371,867
2017,93031,EPINAY SUR SEINE,200054781,METROPOLE DU GRAND PARIS,93,SEINE SAINT DENIS,419,3,422,91,323,9,332,845
2017,93050,NEUILLY SUR MARNE,200054781,METROPOLE DU GRAND PARIS,93,SEINE SAINT DENIS,285,1,286,40,365,15,380,706
2017,93053,NOISY LE SEC,200054781,METROPOLE DU GRAND PARIS,93,SEINE SAINT DENIS,317,2,319,0,284,15,299,619
2017,93066,SAINT DENIS,200054781,METROPOLE DU GRAND PARIS,93,SEINE SAINT DENIS,1129,16,1145,165,627,78,705,2015
2017,93078,VILLEPINTE,200054781,METROPOLE DU GRAND PARIS,93,SEINE SAINT DENIS,349,1,350,0,174,5,179,528
2017,94002,ALFORTVILLE,200054781,METROPOLE DU GRAND PARIS,94,VAL DE MARNE,382,22,404,49,409,66,475,928
2017,94003,ARCUEIL,200054781,METROPOLE DU GRAND PARIS,94,VAL DE MARNE,248,21,269,5,133,27,160,434
2017,94015,BRY SUR MARNE,200054781,METROPOLE DU GRAND PARIS,94,VAL DE MARNE,299,0,299,1,129,19,148,448
2017,94016,CACHAN,200054781,METROPOLE DU GRAND PARIS,94,VAL DE MARNE,317,3,320,17,292,42,334,671
2017,94022,CHOISY LE ROI,200054781,METROPOLE DU GRAND PARIS,94,VAL DE MARNE,440,44,484,38,424,11,435,957
2017,94028,CRETEIL,200054781,METROPOLE DU GRAND PARIS,94,VAL DE MARNE,1347,4,1351,96,475,38,513,1961
2017,94042,JOINVILLE LE PONT,200054781,METROPOLE DU GRAND PARIS,94,VAL DE MARNE,289,5,294,0,155,49,204,498
2017,94052,NOGENT SUR MARNE,200054781,METROPOLE DU GRAND PARIS,94,VAL DE MARNE,451,39,490,1,174,175,349,839
2017,94059,LE PLESSIS TREVISE,200054781,METROPOLE DU GRAND PARIS,94,VAL DE MARNE,165,2,167,0,182,13,195,362
2017,94060,LA QUEUE EN BRIE,200054781,METROPOLE DU GRAND PARIS,94,VAL DE MARNE,79,3,82,1,120,5,125,208
2017,94067,SAINT MANDE,200054781,METROPOLE DU GRAND PARIS,94,VAL DE MARNE,415,31,446,17,51,176,227,690
2017,94071,SUCY EN BRIE,200054781,METROPOLE DU GRAND PARIS,94,VAL DE MARNE,160,7,167,1,186,12,198,365
2017,94073,THIAIS,200054781,METROPOLE DU GRAND PARIS,94,VAL DE MARNE,385,24,409,19,214,6,220,649
2017,94075,VILLECRESNES,200054781,METROPOLE DU GRAND PARIS,94,VAL DE MARNE,36,14,50,4,115,2,117,171
2017,94078,VILLENEUVE SAINT GEORGES,200054781,METROPOLE DU GRAND PARIS,94,VAL DE MARNE,210,0,210,27,178,7,185,422
2017,95018,ARGENTEUIL,200054781,METROPOLE DU GRAND PARIS,95,VAL D OISE,1004,35,1039,76,962,78,1040,2155
2017,95019,ARNOUVILLE,200055655,CA ROISSY PAYS DE FRANCE,95,VAL D OISE,90,0,90,4,86,4,90,184
2017,95197,DEUIL LA BARRE,200056380,CA PLAINE VALLEE,95,VAL D OISE,80,30,110,19,323,14,337,466
2017,95203,EAUBONNE,200058485,CA VAL PARISIS,95,VAL D OISE,314,8,322,0,361,21,382,704
2017,95210,ENGHIEN LES BAINS,200056380,CA PLAINE VALLEE,95,VAL D OISE,263,5,268,1,48,24,72,341
2017,95218,ERAGNY,249500109,CA DE CERGY-PONTOISE,95,VAL D OISE,125,19,144,0,272,7,279,423
2017,95268,GARGES LES GONESSE,200055655,CA ROISSY PAYS DE FRANCE,95,VAL D OISE,257,0,257,135,183,2,185,578
2017,95428,MONTMORENCY,200056380,CA PLAINE VALLEE,95,VAL D OISE,100,17,117,17,224,16,240,374
2017,95500,PONTOISE,249500109,CA DE CERGY-PONTOISE,95,VAL D OISE,337,36,373,20,274,11,285,679
2017,95539,SAINT BRICE SOUS FORET,200056380,CA PLAINE VALLEE,95,VAL D OISE,103,6,109,0,203,17,220,329
2017,95585,SARCELLES,200055655,CA ROISSY PAYS DE FRANCE,95,VAL D OISE,416,26,442,247,292,13,305,994
2017,95607,TAVERNY,200058485,CA VAL PARISIS,95,VAL D OISE,187,8,195,0,377,8,385,580
2017,95637,VAUREAL,249500109,CA DE CERGY-PONTOISE,95,VAL D OISE,113,9,122,0,251,4,255,377
2017,97107,CAPESTERRE BELLE EAU,249710070,CA GRAND SUD CARAIBE,971,GUADELOUPE,25,3,28,59,46,3,49,136
2017,97125,SAINT FRANCOIS,200041507,CA LA RIVIERA DU LEVANT,971,GUADELOUPE,53,45,98,44,86,3,89,232
2017,97207,DUCOS,249720053,CA DE L'ESPACE SUD DE LA MARTINIQUE,972,MARTINIQUE,26,32,58,29,107,4,111,199
2017,97302,CAYENNE,249730045,CA DU CENTRE LITTORAL,973,GUYANE,472,7,479,8,137,19,156,643
2017,97304,KOUROU,200027548,CC DES SAVANES,973,GUYANE,205,0,205,32,83,40,123,360
2017,97306,MANA,249730037,CC DE L'OUEST GUYANAIS,973,GUYANE,0,0,0,11,1,2,3,14
2017,97408,LA POSSESSION,249740101,CA TERRITOIRE DE LA COTE OUEST (TCO),974,LA REUNION,190,216,406,40,153,29,182,628
2017,97410,SAINT BENOIT,249740093,CA INTERCOMMUNALE DE LA REUNION EST (CIREST),974,LA REUNION,205,89,294,62,95,24,119,474
2017,97422,LE TAMPON,249740085,CA DU SUD,974,LA REUNION,244,131,375,137,387,62,449,961
2017,97801,SAINT-MARTIN,XX,XX,978,COLLECTIVITE D'OUTRE MER SAINT MARTIN,127,7,134,79,56,5,61,274
2018,01053,BOURG EN BRESSE,200071751,CA DU BASSIN DE BOURG-EN-BRESSE,01,AIN,331,7,338,118,334,18,352,808
2018,01173,GEX,240100750,CA DU PAYS DE GEX,01,AIN,58,12,70,0,193,2,195,265
2018,01249,MIRIBEL,240100800,CC DE MIRIBEL ET DU PLATEAU,01,AIN,102,5,107,21,172,6,178,306
2018,01283,OYONNAX,200042935,CA HAUT - BUGEY AGGLOMERATION,01,AIN,60,7,67,97,168,1,169,333
2018,01320,REPLONGES,200071371,CC BRESSE ET SAONE,01,AIN,18,0,18,0,114,0,114,132
2018,01321,REVONNAS,200071751,CA DU BASSIN DE BOURG-EN-BRESSE,01,AIN,0,1,1,0,15,0,15,17
2018,01322,REYRIEUX,200042497,CC DOMBES SAONE VALLEE,01,AIN,35,1,36,4,88,3,91,131
2018,01323,REYSSOUZE,200071371,CC BRESSE ET SAONE,01,AIN,0,0,0,0,11,0,11,11
2018,01325,RIGNIEUX LE FRANC,240100883,CC DE LA PLAINE DE L'AIN,01,AIN,0,0,0,0,23,0,23,23
2018,01329,ROSSILLON,200040350,CC BUGEY SUD,01,AIN,0,0,0,0,2,0,2,2
2018,02168,CHATEAU THIERRY,200072031,CA DE LA REGION DE CHATEAU-THIERRY,02,AISNE,102,4,106,51,209,3,212,369
2018,02810,VILLERS COTTERETS,200071991,CC RETZ EN VALOIS,02,AISNE,24,12,36,0,168,3,171,207
2018,06088,NICE,200030195,METROPOLE NICE COTE D'AZUR,06,ALPES MARITIMES,3072,124,3196,313,1780,175,1955,5464
2018,06104,ROQUEBRUNE CAP MARTIN,240600551,CA DE LA RIVIERA FRANCAISE,06,ALPES MARITIMES,134,0,134,9,46,1,47,190
2018,06161,VILLENEUVE LOUBET,240600585,CA DE SOPHIA ANTIPOLIS,06,ALPES MARITIMES,177,2,179,0,131,11,142,321
2018,07019,AUBENAS,200073245,CC DU BASSIN D'AUBENAS,07,ARDECHE,80,0,80,27,67,7,74,181
2018,08409,SEDAN,200041630,CA ARDENNE METROPOLE,08,ARDENNES,90,14,104,56,75,1,76,236
2018,10081,LA CHAPELLE SAINT LUC,200069250,CA TROYES CHAMPAGNE METROPOLE,10,AUBE,78,0,78,64,83,4,87,229
2018,11069,CARCASSONNE,200035715,CA CARCASSONNE AGGLO,11,AUDE,269,0,269,98,302,29,331,698
2018,11206,LIMOUX,200071926,CC DU LIMOUXIN,11,AUDE,55,0,55,32,45,0,45,132
2018,12176,ONET LE CHATEAU,241200187,CA RODEZ AGGLOMERATION,12,AVEYRON,55,13,68,31,163,2,165,264
2018,12202,RODEZ,241200187,CA RODEZ AGGLOMERATION,12,AVEYRON,209,10,219,85,157,14,171,475
2018,13004,ARLES,241300417,CA D'ARLES-CRAU-CAMARGUE-MONTAGNETTE,13,BOUCHES DU RHONE,194,10,204,90,359,9,368,663
2018,13015,BOUC BEL AIR,200054807,METROPOLE D'AIX-MARSEILLE-PROVENCE,13,BOUCHES DU RHONE,129,21,150,1,168,8,176,327
2018,13026,CHATEAUNEUF LES MARTIGUES,200054807,METROPOLE D'AIX-MARSEILLE-PROVENCE,13,BOUCHES DU RHONE,125,23,148,4,174,12,186,338
2018,13028,LA CIOTAT,200054807,METROPOLE D'AIX-MARSEILLE-PROVENCE,13,BOUCHES DU RHONE,236,6,242,19,306,8,314,575
2018,13054,MARIGNANE,200054807,METROPOLE D'AIX-MARSEILLE-PROVENCE,13,BOUCHES DU RHONE,279,14,293,2,265,8,273,568
2018,13069,PELISSANNE,200054807,METROPOLE D'AIX-MARSEILLE-PROVENCE,13,BOUCHES DU RHONE,72,2,74,3,138,2,140,218
2018,13071,LES PENNES MIRABEAU,200054807,METROPOLE D'AIX-MARSEILLE-PROVENCE,13,BOUCHES DU RHONE,165,30,195,19,159,11,170,385
2018,13075,PLAN DE CUQUES,200054807,METROPOLE D'AIX-MARSEILLE-PROVENCE,13,BOUCHES DU RHONE,109,9,118,0,88,5,93,212
2018,13077,PORT DE BOUC,200054807,METROPOLE D'AIX-MARSEILLE-PROVENCE,13,BOUCHES DU RHONE,113,0,113,56,93,3,96,265
2018,13205,MARSEILLE 5E ARRONDISSEMENT,200054807,METROPOLE D'AIX-MARSEILLE-PROVENCE,13,BOUCHES DU RHONE,583,87,670,1,339,33,372,1043
2018,13207,MARSEILLE 7E ARRONDISSEMENT,200054807,METROPOLE D'AIX-MARSEILLE-PROVENCE,13,BOUCHES DU RHONE,350,60,410,25,277,93,370,805
2018,13208,MARSEILLE 8E ARRONDISSEMENT,200054807,METROPOLE D'AIX-MARSEILLE-PROVENCE,13,BOUCHES DU RHONE,732,151,883,9,612,173,785,1677
2018,13209,MARSEILLE 9E ARRONDISSEMENT,200054807,METROPOLE D'AIX-MARSEILLE-PROVENCE,13,BOUCHES DU RHONE,952,59,1011,59,518,43,561,1631
2018,13210,MARSEILLE 10E ARRONDISSEMENT,200054807,METROPOLE D'AIX-MARSEILLE-PROVENCE,13,BOUCHES DU RHONE,320,53,373,39,337,21,358,770
2018,13212,MARSEILLE 12E ARRONDISSEMENT,200054807,METROPOLE D'AIX-MARSEILLE-PROVENCE,13,BOUCHES DU RHONE,322,109,431,14,419,45,464,908
2018,13214,MARSEILLE 14E ARRONDISSEMENT,200054807,METROPOLE D'AIX-MARSEILLE-PROVENCE,13,BOUCHES DU RHONE,384,13,397,153,163,13,176,725
2018,14118,CAEN,200065597,CU CAEN LA MER,14,CALVADOS,1117,40,1157,258,755,61,816,2231
2018,14341,IFS,200065597,CU CAEN LA MER,14,CALVADOS,58,12,70,0,199,2,201,270
2018,14762,VIRE NORMANDIE,200068799,CC INTERCOM DE LA VIRE AU NOIREAU,14,CALVADOS,45,0,45,24,295,2,297,366
2018,15014,AURILLAC,241500230,CA DU BASSIN D'AURILLAC,15,CANTAL,200,5,205,35,232,9,241,481
2018,17300,LA ROCHELLE,241700434,CA DE LA ROCHELLE,17,CHARENTE MARITIME,539,15,554,86,585,66,651,1291
2018,19272,TULLE,241927201,CA TULLE AGGLO,19,CORREZE,153,2,155,28,74,7,81,264
2018,21166,CHENOVE,242100410,DIJON METROPOLE,21,COTE D OR,96,6,102,83,138,2,140,325
2018,22050,DINAN,200068989,CA DINAN AGGLOMERATION,22,COTES D ARMOR,65,6,71,32,90,5,95,198
2018,22215,PLOUFRAGAN,200069409,CA SAINT-BRIEUC ARMOR AGGLOMERATION,22,COTES D ARMOR,72,1,73,25,174,4,178,276
2018,22278,SAINT BRIEUC,200069409,CA SAINT-BRIEUC ARMOR AGGLOMERATION,22,COTES D ARMOR,278,6,284,90,469,20,489,862
2018,24037,BERGERAC,200070647,CA BERGERACOISE,24,DORDOGNE,155,0,155,59,189,3,192,406
2018,25031,AUDINCOURT,200065647,CA PAYS DE MONTBELIARD AGGLOMERATION,25,DOUBS,90,0,90,40,122,1,123,253
2018,25388,MONTBELIARD,200065647,CA PAYS DE MONTBELIARD AGGLOMERATION,25,DOUBS,161,0,161,79,159,8,167,408
2018,25462,PONTARLIER,242500338,CC DU GRAND PONTARLIER,25,DOUBS,123,20,143,10,207,2,209,362
2018,25580,VALENTIGNEY,200065647,CA PAYS DE MONTBELIARD AGGLOMERATION,25,DOUBS,37,1,38,39,74,4,78,154
2018,26198,MONTELIMAR,200040459,CA MONTELIMAR AGGLOMERATION,26,DROME,186,56,242,39,424,6,430,710
2018,26235,PIERRELATTE,200042901,CC DROME SUD PROVENCE,26,DROME,50,8,58,16,169,0,169,243
2018,27229,EVREUX,200071454,CA EVREUX PORTES DE NORMANDIE,27,EURE,483,8,491,64,409,7,416,970
2018,27375,LOUVIERS,200089456,CA SEINE-EURE,27,EURE,183,1,184,28,196,2,198,409
2018,28088,CHATEAUDUN,200069961,CC DU GRAND CHATEAUDUN,28,EURE ET LOIR,79,5,84,41,108,3,111,237
2018,28134,DREUX,200040277,CA AGGLO DU PAYS DE DREUX,28,EURE ET LOIR,270,7,277,29,212,14,226,532
2018,28218,LUCE,200033181,CA CHARTRES METROPOLE,28,EURE ET LOIR,140,2,142,0,195,3,198,340
2018,28404,VERNOUILLET,200040277,CA AGGLO DU PAYS DE DREUX,28,EURE ET LOIR,114,3,117,7,151,5,156,280
2018,29019,BREST,242900314,BREST METROPOLE,29,FINISTERE,1021,26,1047,470,1484,96,1580,3097
2018,29039,CONCARNEAU,242900769,CA CONCARNEAU CORNOUAILLE AGGLOMERATION,29,FINISTERE,72,1,73,33,192,4,196,303
2018,29075,GUIPAVAS,242900314,BREST METROPOLE,29,FINISTERE,167,0,167,41,318,7,325,533
2018,29233,QUIMPERLE,242900694,CA QUIMPERLE COMMUNAUTE,29,FINISTERE,43,0,43,40,223,0,223,306
2018,2A247,PORTO VECCHIO,200040764,CC DU SUD CORSE,2A,CORSE DU SUD,88,0,88,17,38,9,47,152
2018,30028,BAGNOLS SUR CEZE,200034692,CA DU GARD RHODANIEN,30,GARD,150,0,150,48,94,9,103,301
2018,30032,BEAUCAIRE,243000585,CC BEAUCAIRE TERRE D'ARGENCE,30,GARD,60,0,60,19,105,1,106,185
2018,30189,NIMES,243000643,CA DE NIMES METROPOLE,30,GARD,1150,5,1155,201,628,101,729,2085
2018,30341,VAUVERT,243000593,CC DE PETITE CAMARGUE,30,GARD,37,0,37,42,105,1,106,185
2018,31187,FONSORBES,200068641,CA LE MURETAIN AGGLO,31,HAUTE GARONNE,76,2,78,0,231,4,235,314
2018,31483,SAINT GAUDENS,200072643,CC COEUR ET COTEAUX DU COMMINGES,31,HAUTE GARONNE,110,0,110,8,80,1,81,199
2018,33003,AMBARES ET LAGRAVE,243300316,BORDEAUX METROPOLE,33,GIRONDE,99,22,121,6,303,3,306,433
2018,33122,CESTAS,243301165,CC JALLE-EAU-BOURDE,33,GIRONDE,116,3,119,0,195,7,202,321
2018,33284,MIOS,243301504,CA DU BASSIN D'ARCACHON NORD,33,GIRONDE,20,5,25,0,250,6,256,280
2018,33318,PESSAC,243300316,BORDEAUX METROPOLE,33,GIRONDE,513,33,546,37,887,39,926,1508
2018,33366,SAINT ANDRE DE CUBZAC,243301223,CC DU GRAND CUBZAGUAIS,33,GIRONDE,46,8,54,0,309,4,313,367
2018,33522,TALENCE,243300316,BORDEAUX METROPOLE,33,GIRONDE,435,42,477,10,415,47,462,949
2018,33550,VILLENAVE D ORNON,243300316,BORDEAUX METROPOLE,33,GIRONDE,332,18,350,14,552,18,570,935
2018,34003,AGDE,243400819,CA HERAULT-MEDITERRANEE,34,HERAULT,171,9,180,29,103,12,115,325
2018,34108,FRONTIGNAN,200066355,CA SETE AGGLOPOLE MEDITERRANEE,34,HERAULT,133,13,146,18,174,5,179,344
2018,34154,MAUGUIO,243400470,CA DU PAYS DE L'OR,34,HERAULT,150,3,153,2,166,13,179,334
2018,34157,MEZE,200066355,CA SETE AGGLOPOLE MEDITERRANEE,34,HERAULT,90,2,92,0,67,1,68,160
2018,34337,VILLENEUVE LES MAGUELONE,243400017,MONTPELLIER MEDITERRANEE METROPOLE,34,HERAULT,83,3,86,0,82,7,89,176
2018,35055,CHANTEPIE,243500139,RENNES METROPOLE,35,ILLE ET VILAINE,42,4,46,16,194,1,195,257
2018,35069,CHATEAUGIRON,243500659,CC PAYS DE CHATEAUGIRON COMMUNAUTE,35,ILLE ET VILAINE,35,15,50,39,264,4,268,358
2018,35115,FOUGERES,200072452,CA FOUGERES AGGLOMERATION,35,ILLE ET VILAINE,84,16,100,68,234,2,236,404
2018,35210,PACE,243500139,RENNES METROPOLE,35,ILLE ET VILAINE,60,3,63,23,185,7,192,278
2018,35238,RENNES,243500139,RENNES METROPOLE,35,ILLE ET VILAINE,1818,168,1986,714,2073,232,2305,5005
2018,35288,SAINT MALO,243500782,CA DU PAYS DE SAINT MALO AGGLOMERATION,35,ILLE ET VILAINE,290,11,301,149,352,33,385,835
2018,37003,AMBOISE,200043065,CC DU VAL D AMBOISE,37,INDRE ET LOIRE,60,1,61,12,227,2,229,302
2018,37233,SAINT PIERRE DES CORPS,243700754,TOURS METROPOLE VAL DE LOIRE,37,INDRE ET LOIRE,96,14,110,57,298,6,304,472
2018,38085,CHARVIEU CHAVAGNEUX,243800935,CC LYON-SAINT-EXUPERY EN DAUPHINE,38,ISERE,20,48,68,0,245,0,245,313
2018,38151,ECHIROLLES,200040715,GRENOBLE-ALPES-METROPOLE,38,ISERE,358,26,384,110,404,13,417,911
2018,38169,FONTAINE,200040715,GRENOBLE-ALPES-METROPOLE,38,ISERE,147,12,159,30,354,8,362,551
2018,38185,GRENOBLE,200040715,GRENOBLE-ALPES-METROPOLE,38,ISERE,1601,267,1868,198,1667,105,1772,3838
2018,38229,MEYLAN,200040715,GRENOBLE-ALPES-METROPOLE,38,ISERE,194,25,219,0,186,13,199,417
2018,38317,LE PONT DE CLAIX,200040715,GRENOBLE-ALPES-METROPOLE,38,ISERE,122,1,123,45,139,1,140,308
2018,38382,SAINT EGREVE,200040715,GRENOBLE-ALPES-METROPOLE,38,ISERE,209,5,214,2,265,8,273,489
2018,38421,SAINT MARTIN D HERES,200040715,GRENOBLE-ALPES-METROPOLE,38,ISERE,268,33,301,53,520,12,532,886
2018,38553,VILLEFONTAINE,243800604,CA PORTE DE L'ISERE (CAPI),38,ISERE,168,19,187,43,293,6,299,529
2018,40192,MONT DE MARSAN,244000808,CA MONT DE MARSAN AGGLOMERATION,40,LANDES,180,4,184,30,414,3,417,631
2018,41269,VENDOME,200072072,CA TERRITOIRES VENDOMOIS,41,LOIR ET CHER,104,0,104,16,175,3,178,298
2018,42184,RIORGES,200035731,CA ROANNAIS AGGLOMERATION,42,LOIRE,42,1,43,6,150,2,152,201
2018,42186,RIVE DE GIER,244200770,SAINT-ETIENNE METROPOLE,42,LOIRE,55,29,84,15,189,1,190,289
2018,42207,SAINT CHAMOND,244200770,SAINT-ETIENNE METROPOLE,42,LOIRE,196,23,219,122,336,11,347,688
2018,44036,CHATEAUBRIANT,200072726,CC CHATEAUBRIANT-DERVAL,44,LOIRE ATLANTIQUE,56,0,56,29,153,3,156,241
2018,44055,LA BAULE ESCOUBLAC,244400610,CA DE LA PRESQU'ILE DE GUERANDE ATLANTIQUE (CAP ATLANTIQUE),44,LOIRE ATLANTIQUE,60,1,61,27,115,8,123,211
2018,44132,PORNICHET,244400644,CA DE LA REGION NAZAIRIENNE ET DE L'ESTUAIRE (CARENE),44,LOIRE ATLANTIQUE,50,2,52,2,130,2,132,186
2018,44154,SAINT BREVIN LES PINS,244400586,CC DU SUD ESTUAIRE,44,LOIRE ATLANTIQUE,42,9,51,9,190,6,196,256
2018,44172,SAINTE LUCE SUR LOIRE,244400404,NANTES METROPOLE,44,LOIRE ATLANTIQUE,122,2,124,0,346,7,353,477
2018,44184,SAINT NAZAIRE,244400644,CA DE LA REGION NAZAIRIENNE ET DE L'ESTUAIRE (CARENE),44,LOIRE ATLANTIQUE,380,25,405,177,831,44,875,1456
2018,45004,AMILLY,244500203,CA MONTARGOISE ET RIVES DU LOING (AME),45,LOIRET,110,1,111,0,191,0,191,302
2018,45075,LA CHAPELLE SAINT MESMIN,244500468,ORLEANS METROPOLE,45,LOIRET,59,10,69,0,170,4,174,243
2018,45208,MONTARGIS,244500203,CA MONTARGOISE ET RIVES DU LOING (AME),45,LOIRET,131,0,131,30,79,4,83,245
2018,47157,MARMANDE,200030674,CA VAL DE GARONNE AGGLOMERATION,47,LOT ET GARONNE,136,0,136,10,156,2,158,304
2018,48095,MENDE,244800405,CC COEUR DE LOZERE,48,LOZERE,112,0,112,74,140,1,141,327
2018,49023,BEAUPREAU EN MAUGES,200060010,CA MAUGES COMMUNAUTE,49,MAINE ET LOIRE,72,21,93,57,530,5,535,685
2018,49069,OREE D ANJOU,200060010,CA MAUGES COMMUNAUTE,49,MAINE ET LOIRE,24,3,27,42,398,8,406,474
2018,49092,CHEMILLE EN ANJOU,200060010,CA MAUGES COMMUNAUTE,49,MAINE ET LOIRE,34,23,57,43,459,7,466,566
2018,49218,MONTREVAULT SUR EVRE,200060010,CA MAUGES COMMUNAUTE,49,MAINE ET LOIRE,36,4,40,13,314,2,316,369
2018,49331,SEGRE EN ANJOU BLEU,244900809,CC ANJOU BLEU COMMUNAUTE,49,MAINE ET LOIRE,69,1,70,42,299,4,303,415
2018,50025,AVRANCHES,200069425,CA MONT-SAINT-MICHEL-NORMANDIE,50,MANCHE,45,0,45,36,125,1,126,207
2018,50129,CHERBOURG EN COTENTIN,200067205,CA DU COTENTIN,50,MANCHE,556,0,556,196,1084,36,1120,1872
2018,50502,SAINT LO,200066389,CA SAINT-LO AGGLO,50,MANCHE,90,7,97,42,252,3,255,394
2018,51454,REIMS,200067213,CU DU GRAND REIMS,51,MARNE,1262,323,1585,296,1387,143,1530,3411
2018,53062,CHATEAU GONTIER SUR MAYENNE,245300447,CC DU PAYS DE CHATEAU-GONTIER,53,MAYENNE,75,0,75,37,333,6,339,452
2018,53130,LAVAL,200083392,CA LAVAL AGGLOMERATION,53,MAYENNE,345,25,370,113,546,31,577,1059
2018,54329,LUNEVILLE,200070324,CC DU TERRITOIRE DE LUNEVILLE A BACCARAT,54,MEURTHE ET MOSELLE,96,0,96,42,207,4,211,349
2018,54578,VILLERS LES NANCY,245400676,METROPOLE DU GRAND NANCY,54,MEURTHE ET MOSELLE,100,1,101,14,126,7,133,248
2018,55029,BAR LE DUC,200033025,CA DE BAR-LE-DUC - SUD MEUSE,55,MEUSE,131,0,131,27,119,1,120,278
2018,56260,VANNES,200067932,CA GOLFE DU MORBIHAN - VANNES AGGLOMERATION,56,MORBIHAN,378,18,396,239,380,43,423,1058
2018,57221,FLORANGE,245701222,CA DU VAL DE FENSCH,57,MOSELLE,35,5,40,29,104,0,104,173
2018,57306,HAYANGE,245701222,CA DU VAL DE FENSCH,57,MOSELLE,55,5,60,0,142,1,143,203
2018,57463,METZ,200039865,METZ METROPOLE,57,MOSELLE,1159,25,1184,80,898,49,947,2212
2018,57631,SARREGUEMINES,200070746,CA SARREGUEMINES CONFLUENCES,57,MOSELLE,210,0,210,43,78,5,83,336
2018,57751,WOIPPY,200039865,METZ METROPOLE,57,MOSELLE,30,3,33,22,154,2,156,212
2018,57757,YUTZ,245701362,CA PORTES DE FRANCE-THIONVILLE,57,MOSELLE,101,22,123,16,169,4,173,312
2018,59009,VILLENEUVE D ASCQ,245900410,METROPOLE EUROPEENNE DE LILLE,59,NORD,567,98,665,246,653,43,696,1607
2018,59011,ANNOEULLIN,245901061,CC DE LA HAUTE DEULE,59,NORD,54,4,58,27,149,3,152,237
2018,59017,ARMENTIERES,245900410,METROPOLE EUROPEENNE DE LILLE,59,NORD,85,21,106,87,240,8,248,442
2018,59043,BAILLEUL,200040947,CC DE FLANDRE INTERIEURE,59,NORD,75,12,87,43,234,2,236,366
2018,59112,BRUAY SUR L ESCAUT,245901160,CA VALENCIENNES METROPOLE,59,NORD,15,0,15,53,77,0,77,145
2018,59139,CAUDRY,200030633,CA DU CAUDRESIS ET DU CATESIS,59,NORD,45,1,46,84,138,2,140,270
2018,59179,DOUCHY LES MINES,200042190,CA DE LA PORTE DU HAINAUT,59,NORD,20,1,21,84,125,1,126,231
2018,59249,FOURMIES,200043404,CC DU SUD AVESNOIS,59,NORD,24,5,29,43,66,2,68,139
2018,59286,HAUBOURDIN,245900410,METROPOLE EUROPEENNE DE LILLE,59,NORD,55,23,78,56,244,7,251,385
2018,59360,LOOS,245900410,METROPOLE EUROPEENNE DE LILLE,59,NORD,135,23,158,41,316,9,325,524
2018,59367,LYS LEZ LANNOY,245900410,METROPOLE EUROPEENNE DE LILLE,59,NORD,56,14,70,71,166,8,174,315
2018,59368,LA MADELEINE,245900410,METROPOLE EUROPEENNE DE LILLE,59,NORD,181,60,241,54,241,47,288,583
2018,59378,MARCQ EN BAROEUL,245900410,METROPOLE EUROPEENNE DE LILLE,59,NORD,266,126,392,65,537,82,619,1077
2018,59392,MAUBEUGE,200043396,CA MAUBEUGE VAL DE SAMBRE,59,NORD,116,0,116,184,156,2,158,458
2018,59421,MOUVAUX,245900410,METROPOLE EUROPEENNE DE LILLE,59,NORD,85,45,130,44,229,25,254,429
2018,59507,RONCHIN,245900410,METROPOLE EUROPEENNE DE LILLE,59,NORD,102,62,164,3,267,9,276,443
2018,59527,SAINT ANDRE LEZ LILLE,245900410,METROPOLE EUROPEENNE DE LILLE,59,NORD,100,26,126,28,161,12,173,327
2018,59606,VALENCIENNES,245901160,CA VALENCIENNES METROPOLE,59,NORD,363,6,369,176,323,17,340,885
2018,59616,VIEUX CONDE,245901160,CA VALENCIENNES METROPOLE,59,NORD,25,1,26,30,57,3,60,116
2018,60159,COMPIEGNE,200067965,CA DE LA REGION DE COMPIEGNE ET DE LA BASSE AUTOMNE,60,OISE,433,8,441,59,271,29,300,800
2018,62250,COURRIERES,246200299,CA D'HENIN-CARVIN,62,PAS DE CALAIS,70,6,76,44,137,1,138,257
2018,62427,HENIN BEAUMONT,246200299,CA D'HENIN-CARVIN,62,PAS DE CALAIS,110,37,147,40,210,3,213,400
2018,62510,LIEVIN,246200364,CA DE LENS - LIEVIN,62,PAS DE CALAIS,166,18,184,80,185,2,187,451
2018,62525,LONGUENESSE,200069037,CA DU PAYS DE SAINT-OMER,62,PAS DE CALAIS,45,1,46,42,119,3,122,210
2018,62570,MERICOURT,246200364,CA DE LENS - LIEVIN,62,PAS DE CALAIS,10,19,29,25,89,0,89,143
2018,62758,SAINT MARTIN BOULOGNE,246200729,CA DU BOULONNAIS,62,PAS DE CALAIS,50,13,63,53,97,4,101,217
2018,64348,LONS,200067254,CA PAU BEARN PYRENEES,64,PYRENEES ATLANTIQUES,74,17,91,0,212,18,230,320
2018,64430,ORTHEZ,200039204,CC DE LACQ-ORTHEZ,64,PYRENEES ATLANTIQUES,40,0,40,12,94,5,99,151
2018,64483,SAINT JEAN DE LUZ,200067106,CA DU PAYS BASQUE,64,PYRENEES ATLANTIQUES,48,22,70,33,86,6,92,195
2018,65286,LOURDES,200069300,CA TARBES-LOURDES-PYRENEES,65,HAUTES PYRENEES,126,0,126,47,52,4,56,229
2018,65440,TARBES,200069300,CA TARBES-LOURDES-PYRENEES,65,HAUTES PYRENEES,315,9,324,115,218,10,228,667
2018,66171,SAINT CYPRIEN,246600282,CC SUD-ROUSSILLON,66,PYRENEES ORIENTALES,40,2,42,0,56,1,57,99
2018,67043,BISCHHEIM,246700488,EUROMETROPOLE DE STRASBOURG,67,BAS RHIN,221,33,254,32,130,5,135,421
2018,67046,BISCHWILLER,200067874,CA DE HAGUENAU,67,BAS RHIN,167,23,190,0,47,1,48,238
2018,67130,ERSTEIN,200067924,CC DU CANTON D'ERSTEIN,67,BAS RHIN,65,28,93,0,139,2,141,235
2018,67348,OBERNAI,246701080,CC DU PAYS DE SAINTE-ODILE,67,BAS RHIN,126,10,136,4,84,0,84,224
2018,67365,OSTWALD,246700488,EUROMETROPOLE DE STRASBOURG,67,BAS RHIN,145,13,158,0,111,3,114,272
2018,67462,SELESTAT,246700967,CC DE SELESTAT,67,BAS RHIN,105,42,147,0,155,8,163,310
2018,67482,STRASBOURG,246700488,EUROMETROPOLE DE STRASBOURG,67,BAS RHIN,3498,476,3974,527,1665,205,1870,6370
2018,68166,KINGERSHEIM,200066009,CA MULHOUSE ALSACE AGGLOMERATION,68,HAUT RHIN,75,2,77,0,134,2,136,213
2018,68224,MULHOUSE,200066009,CA MULHOUSE ALSACE AGGLOMERATION,68,HAUT RHIN,1101,14,1115,234,401,38,439,1789
2018,68297,SAINT LOUIS,200066058,CA SAINT-LOUIS AGGLOMERATION,68,HAUT RHIN,136,4,140,40,149,1,150,329
2018,69019,BELLEVILLE EN BEAUJOLAIS,200067817,CC SAONE-BEAUJOLAIS,69,RHONE,35,7,42,19,254,6,260,321
2018,69081,ECULLY,200046977,METROPOLE DE LYON,69,RHONE,164,19,183,20,244,19,263,465
2018,69152,PIERRE BENITE,200046977,METROPOLE DE LYON,69,RHONE,158,10,168,61,156,3,159,387
2018,69199,SAINT FONS,200046977,METROPOLE DE LYON,69,RHONE,157,2,159,92,125,4,129,380
2018,69202,SAINTE FOY LES LYON,200046977,METROPOLE DE LYON,69,RHONE,174,56,230,0,232,35,267,497
2018,69264,VILLEFRANCHE SUR SAONE,200040590,CA VILLEFRANCHE BEAUJOLAIS SAONE,69,RHONE,330,23,353,127,393,19,412,892
2018,69271,CHASSIEU,200046977,METROPOLE DE LYON,69,RHONE,55,12,67,0,158,5,163,230
2018,69275,DECINES CHARPIEU,200046977,METROPOLE DE LYON,69,RHONE,154,39,193,46,382,7,389,628
2018,69283,MIONS,200046977,METROPOLE DE LYON,69,RHONE,59,23,82,0,235,2,237,319
2018,69381,LYON 1ER ARRONDISSEMENT,200046977,METROPOLE DE LYON,69,RHONE,275,67,342,9,226,81,307,658
2018,69382,LYON 2E ARRONDISSEMENT,200046977,METROPOLE DE LYON,69,RHONE,406,85,491,7,275,130,405,903
2018,69383,LYON 3E ARRONDISSEMENT,200046977,METROPOLE DE LYON,69,RHONE,1374,253,1627,19,1101,266,1367,3014
2018,69385,LYON 5E ARRONDISSEMENT,200046977,METROPOLE DE LYON,69,RHONE,406,56,462,36,400,69,469,967
2018,69387,LYON 7E ARRONDISSEMENT,200046977,METROPOLE DE LYON,69,RHONE,793,186,979,16,936,177,1113,2108
2018,69388,LYON 8E ARRONDISSEMENT,200046977,METROPOLE DE LYON,69,RHONE,904,75,979,194,774,91,865,2038
2018,70285,HERICOURT,247000722,CC DU PAYS D'HERICOURT,70,HAUTE SAONE,30,0,30,24,152,1,153,207
2018,71306,MONTCEAU LES MINES,247100290,CU LE CREUSOT MONTCEAU-LES-MINES,71,SAONE ET LOIRE,61,1,62,68,159,2,161,292
2018,72003,ALLONNES,247200132,CU LE MANS METROPOLE,72,SARTHE,18,1,19,65,164,3,167,250
2018,73179,LA MOTTE SERVOLEX,200069110,CA DU GRAND CHAMBERY,73,SAVOIE,50,9,59,5,208,3,211,275
2018,74012,ANNEMASSE,200011773,CA ANNEMASSE-LES VOIRONS-AGGLOMERATION,74,HAUTE SAVOIE,185,4,189,42,378,11,389,620
2018,74081,CLUSES,200033116,CC CLUSES-ARVE ET MONTAGNES,74,HAUTE SAVOIE,68,1,69,50,149,0,149,269
2018,74208,PASSY,200034882,CC PAYS DU MONT-BLANC,74,HAUTE SAVOIE,86,9,95,1,141,3,144,240
2018,74224,LA ROCHE SUR FORON,247400724,CC DU PAYS ROCHOIS,74,HAUTE SAVOIE,42,4,46,0,141,3,144,190
2018,74256,SALLANCHES,200034882,CC PAYS DU MONT-BLANC,74,HAUTE SAVOIE,108,4,112,0,212,6,218,329
2018,75105,PARIS 5E ARRONDISSEMENT,200054781,METROPOLE DU GRAND PARIS,75,PARIS,1025,2,1027,27,20,197,217,1271
2018,75108,PARIS 8E ARRONDISSEMENT,200054781,METROPOLE DU GRAND PARIS,75,PARIS,671,41,712,75,28,382,410,1196
2018,75112,PARIS 12E ARRONDISSEMENT,200054781,METROPOLE DU GRAND PARIS,75,PARIS,2518,163,2681,25,469,585,1054,3760
2018,75113,PARIS 13E ARRONDISSEMENT,200054781,METROPOLE DU GRAND PARIS,75,PARIS,3558,60,3618,60,399,404,803,4482
2018,75114,PARIS 14E ARRONDISSEMENT,200054781,METROPOLE DU GRAND PARIS,75,PARIS,2334,153,2487,41,365,456,821,3349
2018,75117,PARIS 17E ARRONDISSEMENT,200054781,METROPOLE DU GRAND PARIS,75,PARIS,2210,334,2544,68,432,1667,2099,4711
2018,75118,PARIS 18E ARRONDISSEMENT,200054781,METROPOLE DU GRAND PARIS,75,PARIS,3410,188,3598,88,458,910,1368,5053
2018,75120,PARIS 20E ARRONDISSEMENT,200054781,METROPOLE DU GRAND PARIS,75,PARIS,3861,106,3967,126,518,469,987,5080
2018,76231,ELBEUF,200023414,METROPOLE ROUEN NORMANDIE,76,SEINE MARITIME,74,2,76,38,130,0,130,244
2018,76259,FECAMP,200069821,CA FECAMP CAUX LITTORAL AGGLOMERATION,76,SEINE MARITIME,126,0,126,37,158,5,163,326
2018,76410,MAROMME,200023414,METROPOLE ROUEN NORMANDIE,76,SEINE MARITIME,37,11,48,9,198,2,200,257
2018,76575,SAINT ETIENNE DU ROUVRAY,200023414,METROPOLE ROUEN NORMANDIE,76,SEINE MARITIME,124,10,134,80,439,2,441,655
2018,77053,BRIE COMTE ROBERT,247700644,CC L'OREE DE LA BRIE,77,SEINE ET MARNE,115,2,117,7,288,5,293,416
2018,77067,CESSON,200059228,CA GRAND PARIS SUD SEINE ESSONNE SENART,77,SEINE ET MARNE,163,2,165,3,114,4,118,286
2018,77108,CHELLES,200057958,CA PARIS - VALLEE DE LA MARNE,77,SEINE ET MARNE,359,39,398,52,665,25,690,1140
2018,77243,LAGNY SUR MARNE,247700594,CA MARNE ET GONDOIRE,77,SEINE ET MARNE,86,12,98,1,345,9,354,453
2018,77284,MEAUX,200072130,CA DU PAYS DE MEAUX,77,SEINE ET MARNE,558,11,569,38,587,15,602,1208
2018,77285,LE MEE SUR SEINE,247700057,CA MELUN VAL DE SEINE,77,SEINE ET MARNE,246,0,246,61,215,5,220,527
2018,77288,MELUN,247700057,CA MELUN VAL DE SEINE,77,SEINE ET MARNE,421,1,422,32,338,15,353,807
2018,77373,PONTAULT COMBAULT,200057958,CA PARIS - VALLEE DE LA MARNE,77,SEINE ET MARNE,245,1,246,32,606,11,617,895
2018,77464,THORIGNY SUR MARNE,247700594,CA MARNE ET GONDOIRE,77,SEINE ET MARNE,81,1,82,0,129,3,132,214
2018,77468,TORCY,200057958,CA PARIS - VALLEE DE LA MARNE,77,SEINE ET MARNE,294,26,320,20,220,7,227,567
2018,77479,VAIRES SUR MARNE,200057958,CA PARIS - VALLEE DE LA MARNE,77,SEINE ET MARNE,136,0,136,0,148,4,152,288
2018,77514,VILLEPARISIS,200055655,CA ROISSY PAYS DE FRANCE,77,SEINE ET MARNE,138,2,140,8,425,8,433,581
2018,78015,ANDRESY,200059889,CU GRAND PARIS SEINE ET OISE,78,YVELINES,35,9,44,7,235,11,246,298
2018,78146,CHATOU,200058519,CA SAINT GERMAIN BOUCLES DE SEINE,78,YVELINES,453,17,470,10,260,104,364,843
2018,78242,FONTENAY LE FLEURY,247800584,CA VERSAILLES GRAND PARC (CAVGP),78,YVELINES,156,5,161,0,167,18,185,346
2018,78423,MONTIGNY LE BRETONNEUX,200058782,CA DE SAINT QUENTIN EN YVELINES,78,YVELINES,526,7,533,21,423,20,443,997
2018,78545,SAINT CYR L ECOLE,247800584,CA VERSAILLES GRAND PARC (CAVGP),78,YVELINES,275,61,336,0,209,19,228,564
2018,78586,SARTROUVILLE,200058519,CA SAINT GERMAIN BOUCLES DE SEINE,78,YVELINES,352,185,537,51,621,91,712,1300
2018,78646,VERSAILLES,247800584,CA VERSAILLES GRAND PARC (CAVGP),78,YVELINES,1123,138,1261,85,606,349,955,2302
2018,79049,BRESSUIRE,200040244,CA DU BOCAGE BRESSUIRAIS,79,DEUX SEVRES,70,0,70,37,299,4,303,410
2018,79202,PARTHENAY,200041333,CC DE PARTHENAY-GATINE,79,DEUX SEVRES,72,0,72,5,88,1,89,166
2018,79329,THOUARS,247900798,CC DU THOUARSAIS,79,DEUX SEVRES,91,0,91,26,171,1,172,289
2018,81099,GAILLAC,200066124,CA GAILLAC-GRAULHET,81,TARN,62,6,68,10,195,8,203,282
2018,81163,MAZAMET,248100430,CA DE CASTRES MAZAMET,81,TARN,52,1,53,21,15,6,21,95
2018,83062,LA GARDE,248300543,METROPOLE TOULON-PROVENCE-MEDITERRANEE,83,VAR,250,13,263,6,169,16,185,454
2018,83112,SAINT CYR SUR MER,248300394,CA SUD SAINTE BAUME,83,VAR,60,2,62,0,108,8,116,177
2018,83115,SAINTE MAXIME,200036077,CC DU GOLFE DE SAINT-TROPEZ,83,VAR,160,1,161,7,48,8,56,224
2018,83116,SAINT MAXIMIN LA SAINTE BAUME,200068104,CA DE LA PROVENCE VERTE,83,VAR,151,7,158,1,170,9,179,338
2018,83129,SIX FOURS LES PLAGES,248300543,METROPOLE TOULON-PROVENCE-MEDITERRANEE,83,VAR,261,60,321,0,234,9,243,565
2018,83148,VIDAUBAN,248300493,CA DRACENIE PROVENCE VERDON AGGLOMERATION,83,VAR,20,3,23,0,149,3,152,175
2018,84089,PERTUIS,200054807,METROPOLE D'AIX-MARSEILLE-PROVENCE,84,VAUCLUSE,150,2,152,0,265,6,271,423
2018,84141,VEDENE,248400251,CA DU GRAND AVIGNON (COGA),84,VAUCLUSE,65,21,86,0,155,3,158,244
2018,85109,LES HERBIERS,248500621,CC DU PAYS DES HERBIERS,85,VENDEE,77,33,110,45,339,9,348,503
2018,85191,LA ROCHE SUR YON,248500589,CA LA ROCHE SUR YON - AGGLOMERATION,85,VENDEE,378,16,394,96,569,27,596,1086
2018,88160,EPINAL,200068757,CA D'EPINAL,88,VOSGES,224,0,224,84,251,8,259,567
2018,90010,BELFORT,200069052,CA GRAND BELFORT,90,TERRITOIRE DE BELFORT,395,7,402,163,268,17,285,851
2018,91200,DOURDAN,249100595,CC LE DOURDANNAIS EN HUREPOIX (CCDH),91,ESSONNE,70,0,70,8,142,0,142,220
2018,91215,EPINAY SOUS SENART,200058477,CA VAL D'YERRES VAL DE SEINE,91,ESSONNE,101,0,101,33,140,1,141,275
2018,91216,EPINAY SUR ORGE,200056232,CA COMMUNAUTE PARIS-SACLAY,91,ESSONNE,155,2,157,0,103,5,108,265
2018,91223,ETAMPES,200017846,CA ETAMPOIS SUD ESSONNE,91,ESSONNE,238,17,255,30,231,9,240,526
2018,91228,EVRY COURCOURONNES,200059228,CA GRAND PARIS SUD SEINE ESSONNE SENART,91,ESSONNE,642,8,650,112,773,22,795,1557
2018,91235,FLEURY MEROGIS,200057859,CA COEUR D'ESSONNE AGGLOMERATION,91,ESSONNE,154,5,159,20,95,5,100,280
2018,91326,JUVISY SUR ORGE,200054781,METROPOLE DU GRAND PARIS,91,ESSONNE,155,19,174,0,155,27,182,356
2018,91434,MORSANG SUR ORGE,200057859,CA COEUR D'ESSONNE AGGLOMERATION,91,ESSONNE,200,6,206,0,254,7,261,467
2018,91477,PALAISEAU,200056232,CA COMMUNAUTE PARIS-SACLAY,91,ESSONNE,518,35,553,0,470,24,494,1047
2018,91589,SAVIGNY SUR ORGE,200054781,METROPOLE DU GRAND PARIS,91,ESSONNE,217,10,227,19,493,22,515,761
2018,92024,CLICHY,200054781,METROPOLE DU GRAND PARIS,92,HAUTS DE SEINE,826,29,855,20,495,180,675,1550
2018,92033,GARCHES,200054781,METROPOLE DU GRAND PARIS,92,HAUTS DE SEINE,359,1,360,0,71,74,145,505
2018,92035,LA GARENNE COLOMBES,200054781,METROPOLE DU GRAND PARIS,92,HAUTS DE SEINE,647,31,678,4,130,135,265,947
2018,92036,GENNEVILLIERS,200054781,METROPOLE DU GRAND PARIS,92,HAUTS DE SEINE,713,5,718,207,220,30,250,1175
2018,92040,ISSY LES MOULINEAUX,200054781,METROPOLE DU GRAND PARIS,92,HAUTS DE SEINE,1499,51,1550,11,635,331,966,2527
2018,92049,MONTROUGE,200054781,METROPOLE DU GRAND PARIS,92,HAUTS DE SEINE,1018,35,1053,28,262,222,484,1565
2018,92050,NANTERRE,200054781,METROPOLE DU GRAND PARIS,92,HAUTS DE SEINE,1335,24,1359,163,846,166,1012,2534
2018,92063,RUEIL MALMAISON,200054781,METROPOLE DU GRAND PARIS,92,HAUTS DE SEINE,1205,63,1268,33,353,274,627,1927
2018,92071,SCEAUX,200054781,METROPOLE DU GRAND PARIS,92,HAUTS DE SEINE,300,3,303,0,70,66,136,439
2018,92072,SEVRES,200054781,METROPOLE DU GRAND PARIS,92,HAUTS DE SEINE,295,17,312,13,209,58,267,592
2018,92073,SURESNES,200054781,METROPOLE DU GRAND PARIS,92,HAUTS DE SEINE,827,64,891,19,522,257,779,1689
2018,93013,LE BOURGET,200054781,METROPOLE DU GRAND PARIS,93,SEINE SAINT DENIS,141,0,141,0,62,6,68,209
2018,93014,CLICHY SOUS BOIS,200054781,METROPOLE DU GRAND PARIS,93,SEINE SAINT DENIS,185,2,187,45,95,4,99,331
2018,93029,DRANCY,200054781,METROPOLE DU GRAND PARIS,93,SEINE SAINT DENIS,493,0,493,0,323,24,347,840
2018,93031,EPINAY SUR SEINE,200054781,METROPOLE DU GRAND PARIS,93,SEINE SAINT DENIS,419,7,426,99,315,8,323,848
2018,93045,LES LILAS,200054781,METROPOLE DU GRAND PARIS,93,SEINE SAINT DENIS,232,2,234,0,222,66,288,521
2018,93055,PANTIN,200054781,METROPOLE DU GRAND PARIS,93,SEINE SAINT DENIS,636,30,666,75,327,114,441,1181
2018,93062,LE RAINCY,200054781,METROPOLE DU GRAND PARIS,93,SEINE SAINT DENIS,159,10,169,0,132,16,148,317
2018,93064,ROSNY SOUS BOIS,200054781,METROPOLE DU GRAND PARIS,93,SEINE SAINT DENIS,487,6,493,12,376,37,413,917
2018,93066,SAINT DENIS,200054781,METROPOLE DU GRAND PARIS,93,SEINE SAINT DENIS,1065,18,1083,170,608,59,667,1920
2018,93072,STAINS,200054781,METROPOLE DU GRAND PARIS,93,SEINE SAINT DENIS,321,5,326,34,113,5,118,478
2018,93073,TREMBLAY EN FRANCE,200054781,METROPOLE DU GRAND PARIS,93,SEINE SAINT DENIS,335,4,339,41,291,9,300,680
2018,93077,VILLEMOMBLE,200054781,METROPOLE DU GRAND PARIS,93,SEINE SAINT DENIS,250,14,264,0,225,18,243,507
2018,93079,VILLETANEUSE,200054781,METROPOLE DU GRAND PARIS,93,SEINE SAINT DENIS,65,0,65,72,55,3,58,195
2018,94002,ALFORTVILLE,200054781,METROPOLE DU GRAND PARIS,94,VAL DE MARNE,402,44,446,40,395,61,456,942
2018,94015,BRY SUR MARNE,200054781,METROPOLE DU GRAND PARIS,94,VAL DE MARNE,299,1,300,2,128,30,158,460
2018,94016,CACHAN,200054781,METROPOLE DU GRAND PARIS,94,VAL DE MARNE,317,5,322,20,290,37,327,669
2018,94019,CHENNEVIERES SUR MARNE,200054781,METROPOLE DU GRAND PARIS,94,VAL DE MARNE,200,4,204,13,133,15,148,366
2018,94022,CHOISY LE ROI,200054781,METROPOLE DU GRAND PARIS,94,VAL DE MARNE,500,40,540,54,426,19,445,1039
2018,94033,FONTENAY SOUS BOIS,200054781,METROPOLE DU GRAND PARIS,94,VAL DE MARNE,635,25,660,60,456,128,584,1304
2018,94037,GENTILLY,200054781,METROPOLE DU GRAND PARIS,94,VAL DE MARNE,261,5,266,58,104,15,119,443
2018,94038,L'HAY LES ROSES,200054781,METROPOLE DU GRAND PARIS,94,VAL DE MARNE,314,40,354,19,250,34,284,657
2018,94041,IVRY SUR SEINE,200054781,METROPOLE DU GRAND PARIS,94,VAL DE MARNE,837,70,907,100,345,61,406,1413
2018,94042,JOINVILLE LE PONT,200054781,METROPOLE DU GRAND PARIS,94,VAL DE MARNE,289,11,300,1,160,49,209,510
2018,94043,LE KREMLIN BICETRE,200054781,METROPOLE DU GRAND PARIS,94,VAL DE MARNE,492,7,499,11,212,29,241,751
2018,94046,MAISONS ALFORT,200054781,METROPOLE DU GRAND PARIS,94,VAL DE MARNE,616,20,636,2,532,113,645,1282
2018,94059,LE PLESSIS TREVISE,200054781,METROPOLE DU GRAND PARIS,94,VAL DE MARNE,165,4,169,0,174,15,189,359
2018,94060,LA QUEUE EN BRIE,200054781,METROPOLE DU GRAND PARIS,94,VAL DE MARNE,75,2,77,0,124,3,127,203
2018,94080,VINCENNES,200054781,METROPOLE DU GRAND PARIS,94,VAL DE MARNE,901,64,965,1,212,427,639,1606
2018,95313,L'ISLE ADAM,249500455,CC DE LA VALLEE DE L'OISE ET DES TROIS FORETS,95,VAL D OISE,70,35,105,3,105,4,109,217
2018,95476,OSNY,249500109,CA DE CERGY-PONTOISE,95,VAL D OISE,160,20,180,6,191,8,199,385
2018,95487,PERSAN,249500489,CC DU HAUT VAL D'OISE,95,VAL D OISE,56,2,58,19,156,2,158,235
2018,97124,SAINT CLAUDE,249710070,CA GRAND SUD CARAIBE,971,GUADELOUPE,40,14,54,27,40,1,41,122
2018,97129,SAINTE ROSE,249710062,CA DU NORD BASSE-TERRE,971,GUADELOUPE,187,12,199,53,74,5,79,330
2018,97213,LE LAMENTIN,249720061,CA DU CENTRE DE LA MARTINIQUE,972,MARTINIQUE,717,49,766,55,155,11,166,987
2018,97304,KOUROU,200027548,CC DES SAVANES,973,GUYANE,230,0,230,40,80,28,108,378
2018,97305,MACOURIA,249730045,CA DU CENTRE LITTORAL,973,GUYANE,80,1,81,1,23,3,26,108
2018,97309,REMIRE MONTJOLY,249730045,CA DU CENTRE LITTORAL,973,GUYANE,257,8,265,0,85,16,101,367
2018,97408,LA POSSESSION,249740101,CA TERRITOIRE DE LA COTE OUEST (TCO),974,LA REUNION,190,229,419,42,153,25,178,639
2018,97410,SAINT BENOIT,249740093,CA INTERCOMMUNALE DE LA REUNION EST (CIREST),974,LA REUNION,190,96,286,40,81,21,102,428
2018,97412,SAINT JOSEPH,249740085,CA DU SUD,974,LA REUNION,65,149,214,41,83,20,103,357
2018,97422,LE TAMPON,249740085,CA DU SUD,974,LA REUNION,238,130,368,10,381,50,431,809
2019,01249,MIRIBEL,240100800,CC DE MIRIBEL ET DU PLATEAU,01,AIN,102,6,108,16,165,0,165,289
2019,01323,REYSSOUZE,200071371,CC BRESSE ET SAONE,01,AIN,0,0,0,0,7,1,8,8
2019,02408,LAON,200043495,CA DU PAYS DE LAON,02,AISNE,116,2,118,52,211,1,212,382
2019,03095,CUSSET,200071363,CA VICHY COMMUNAUTE,03,ALLIER,26,0,26,36,109,5,114,176
2019,03321,YZEURE,200071140,CA MOULINS COMMUNAUTE,03,ALLIER,116,0,116,19,109,4,113,248
2019,06155,VALLAURIS,240600585,CA DE SOPHIA ANTIPOLIS,06,ALPES MARITIMES,226,13,239,33,167,7,174,445
2019,07102,GUILHERAND GRANGES,200041366,CC RHONE CRUSSOL,07,ARDECHE,73,10,83,6,140,12,152,240
2019,10333,SAINT ANDRE LES VERGERS,200069250,CA TROYES CHAMPAGNE METROPOLE,10,AUBE,112,0,112,0,137,10,147,259
2019,11203,LEZIGNAN CORBIERES,200035863,CC REGION LEZIGNANAISE,11,AUDE,52,0,52,36,63,3,66,154
2019,13001,AIX EN PROVENCE,200054807,METROPOLE D'AIX-MARSEILLE-PROVENCE,13,BOUCHES DU RHONE,1366,224,1590,50,928,149,1077,2717
2019,13004,ARLES,241300417,CA D'ARLES-CRAU-CAMARGUE-MONTAGNETTE,13,BOUCHES DU RHONE,191,11,202,63,348,9,357,622
2019,13047,ISTRES,200054807,METROPOLE D'AIX-MARSEILLE-PROVENCE,13,BOUCHES DU RHONE,504,9,513,0,302,8,310,823
2019,13071,LES PENNES MIRABEAU,200054807,METROPOLE D'AIX-MARSEILLE-PROVENCE,13,BOUCHES DU RHONE,165,37,202,15,155,17,172,389
2019,13097,SAINT MARTIN DE CRAU,241300417,CA D'ARLES-CRAU-CAMARGUE-MONTAGNETTE,13,BOUCHES DU RHONE,112,0,112,6,145,4,149,268
2019,13211,MARSEILLE 11E ARRONDISSEMENT,200054807,METROPOLE D'AIX-MARSEILLE-PROVENCE,13,BOUCHES DU RHONE,455,47,502,50,377,21,398,950
2019,13213,MARSEILLE 13E ARRONDISSEMENT,200054807,METROPOLE D'AIX-MARSEILLE-PROVENCE,13,BOUCHES DU RHONE,799,53,852,239,406,37,443,1535
2019,15014,AURILLAC,241500230,CA DU BASSIN D'AURILLAC,15,CANTAL,175,5,180,55,236,4,240,475
2019,16102,COGNAC,200070514,CA DU GRAND COGNAC,16,CHARENTE,137,0,137,47,143,20,163,347
2019,17299,ROCHEFORT,200041762,CA ROCHEFORT OCEAN,17,CHARENTE MARITIME,205,1,206,41,217,3,220,467
2019,22113,LANNION,200065928,CA LANNION-TREGOR COMMUNAUTE,22,COTES D ARMOR,130,0,130,48,226,2,228,406
2019,22215,PLOUFRAGAN,200069409,CA SAINT-BRIEUC ARMOR AGGLOMERATION,22,COTES D ARMOR,67,0,67,33,178,2,180,280
2019,26058,BOURG LES VALENCE,200068781,CA VALENCE ROMANS AGGLO,26,DROME,71,12,83,6,217,4,221,311
2019,26281,ROMANS SUR ISERE,200068781,CA VALENCE ROMANS AGGLO,26,DROME,198,13,211,75,322,7,329,615
2018,59569,SIN LE NOBLE,200044618,CA DOUAISIS AGGLO,59,NORD,60,5,65,84,138,2,140,289
2018,59599,TOURCOING,245900410,METROPOLE EUROPEENNE DE LILLE,59,NORD,540,98,638,468,910,31,941,2047
2018,59646,WASQUEHAL,245900410,METROPOLE EUROPEENNE DE LILLE,59,NORD,231,45,276,76,305,31,336,688
2018,60414,MONTATAIRE,200068047,CA CREIL SUD OISE,60,OISE,101,0,101,35,119,3,122,258
2018,60463,NOGENT SUR OISE,200068047,CA CREIL SUD OISE,60,OISE,110,1,111,49,181,2,183,343
2018,60509,PONT SAINTE MAXENCE,246000921,CC DES PAYS D'OISE ET D'HALATTE,60,OISE,167,9,176,28,109,11,120,324
2018,61001,ALENCON,246100663,CU D'ALENCON,61,ORNE,173,0,173,107,248,6,254,534
2018,61169,FLERS,200035814,CA FLERS AGGLO,61,ORNE,66,1,67,40,132,2,134,241
2018,62498,LENS,246200364,CA DE LENS - LIEVIN,62,PAS DE CALAIS,115,37,152,132,161,9,170,454
2018,63075,CHAMALIERES,246300701,CLERMONT AUVERGNE METROPOLE,63,PUY DE DOME,216,3,219,10,116,18,134,363
2018,63113,CLERMONT FERRAND,246300701,CLERMONT AUVERGNE METROPOLE,63,PUY DE DOME,987,75,1062,129,1218,79,1297,2487
2018,63124,COURNON D AUVERGNE,246300701,CLERMONT AUVERGNE METROPOLE,63,PUY DE DOME,120,9,129,12,265,4,269,410
2018,64102,BAYONNE,200067106,CA DU PAYS BASQUE,64,PYRENEES ATLANTIQUES,256,87,343,96,414,39,453,892
2018,64422,OLORON SAINTE MARIE,200067262,CC DU HAUT BEARN,64,PYRENEES ATLANTIQUES,89,0,89,28,88,2,90,207
2018,64445,PAU,200067254,CA PAU BEARN PYRENEES,64,PYRENEES ATLANTIQUES,429,44,473,112,607,35,642,1226
2018,95063,BEZONS,200058519,CA SAINT GERMAIN BOUCLES DE SEINE,95,VAL D OISE,225,60,285,39,311,26,337,661
2018,95176,CORMEILLES EN PARISIS,200058485,CA VAL PARISIS,95,VAL D OISE,180,28,208,3,266,18,284,495
2018,95210,ENGHIEN LES BAINS,200056380,CA PLAINE VALLEE,95,VAL D OISE,263,8,271,0,41,23,64,336
2018,95218,ERAGNY,249500109,CA DE CERGY-PONTOISE,95,VAL D OISE,110,24,134,0,274,8,282,416
2018,95555,SAINT GRATIEN,200056380,CA PLAINE VALLEE,95,VAL D OISE,178,2,180,0,227,23,250,431
2018,95582,SANNOIS,200058485,CA VAL PARISIS,95,VAL D OISE,225,3,228,0,387,12,399,628
2018,97103,BAIE MAHAULT,200018653,CA CAP EXCELLENCE,971,GUADELOUPE,151,44,195,46,256,15,271,512
2018,97113,LE GOSIER,200041507,CA LA RIVIERA DU LEVANT,971,GUADELOUPE,190,36,226,77,134,22,156,459
2018,97116,MORNE A L EAU,200044691,CA DU NORD GRANDE TERRE,971,GUADELOUPE,0,6,6,58,57,4,61,124
2018,97118,PETIT BOURG,249710062,CA DU NORD BASSE-TERRE,971,GUADELOUPE,25,36,61,50,145,26,171,282
2018,97228,SAINTE MARIE,200041788,CA DU PAYS NORD MARTINIQUE,972,MARTINIQUE,40,27,67,55,37,2,39,160
2018,97229,SCHOELCHER,249720061,CA DU CENTRE DE LA MARTINIQUE,972,MARTINIQUE,172,9,181,50,64,7,71,302
2018,97402,BRAS PANON,249740093,CA INTERCOMMUNALE DE LA REUNION EST (CIREST),974,LA REUNION,52,29,81,86,42,12,54,221
2018,97409,SAINT ANDRE,249740093,CA INTERCOMMUNALE DE LA REUNION EST (CIREST),974,LA REUNION,458,128,586,87,173,28,201,874
2018,97411,SAINT DENIS,249740119,CA INTERCOMMUNALE DU NORD DE LA REUNION (CINOR),974,LA REUNION,1356,571,1927,325,377,87,464,2716
2018,97413,SAINT LEU,249740101,CA TERRITOIRE DE LA COTE OUEST (TCO),974,LA REUNION,147,91,238,32,182,44,226,496
2018,97414,SAINT LOUIS,249740077,CA CIVIS (COMMUNAUTE INTERCOMMUNALE DES VILLES SOLIDAIRES),974,LA REUNION,129,102,231,88,190,56,246,565
2018,97801,SAINT-MARTIN,XX,XX,978,COLLECTIVITE D'OUTRE MER SAINT MARTIN,40,0,40,103,36,3,39,182
2019,01033,VALSERHONE,240100891,CC DU PAYS BELLEGARDIEN (CCPB),01,AIN,65,15,80,40,226,3,229,349
2019,01160,FERNEY VOLTAIRE,240100750,CA DU PAYS DE GEX,01,AIN,50,2,52,3,113,2,115,170
2019,01283,OYONNAX,200042935,CA HAUT - BUGEY AGGLOMERATION,01,AIN,60,7,67,123,179,5,184,374
2019,02173,CHAUNY,200071785,CA CHAUNY TERGNIER LA FERE,02,AISNE,68,18,86,32,162,5,167,285
2019,02691,SAINT QUENTIN,200071892,CA DU SAINT-QUENTINOIS,02,AISNE,178,64,242,193,403,16,419,854
2019,03185,MONTLUCON,200071082,CA MONTLUCON COMMUNAUTE,03,ALLIER,173,2,175,75,304,5,309,559
2019,04070,DIGNE LES BAINS,200067437,CA PROVENCE-ALPES-AGGLOMERATION,04,ALPES DE HAUTE PROVENCE,102,10,112,24,121,4,125,261
2019,05023,BRIANCON,240500439,CC DU BRIANCONNAIS,05,HAUTES ALPES,105,4,109,9,68,7,75,193
2019,05061,GAP,200067825,CA GAP-TALLARD-DURANCE,05,HAUTES ALPES,328,4,332,42,287,7,294,668
2019,06157,VENCE,200030195,METROPOLE NICE COTE D'AZUR,06,ALPES MARITIMES,159,4,163,10,89,4,93,266
2019,08105,CHARLEVILLE MEZIERES,200041630,CA ARDENNE METROPOLE,08,ARDENNES,358,38,396,125,267,20,287,808
2019,10387,TROYES,200069250,CA TROYES CHAMPAGNE METROPOLE,10,AUBE,443,0,443,126,285,40,325,894
2019,12300,VILLEFRANCHE DE ROUERGUE,200069383,CC OUEST AVEYRON COMMUNAUTE,12,AVEYRON,44,0,44,22,113,0,113,179
2019,13041,GARDANNE,200054807,METROPOLE D'AIX-MARSEILLE-PROVENCE,13,BOUCHES DU RHONE,155,11,166,24,213,6,219,409
2019,13056,MARTIGUES,200054807,METROPOLE D'AIX-MARSEILLE-PROVENCE,13,BOUCHES DU RHONE,569,4,573,28,214,14,228,829
2019,13206,MARSEILLE 6E ARRONDISSEMENT,200054807,METROPOLE D'AIX-MARSEILLE-PROVENCE,13,BOUCHES DU RHONE,602,145,747,8,226,93,319,1074
2019,13215,MARSEILLE 15E ARRONDISSEMENT,200054807,METROPOLE D'AIX-MARSEILLE-PROVENCE,13,BOUCHES DU RHONE,622,20,642,296,175,26,201,1139
2019,14047,BAYEUX,241400555,CC DE BAYEUX INTERCOM,14,CALVADOS,40,6,46,19,202,4,206,271
2019,21054,BEAUNE,200006682,CA BEAUNE,21,COTE D OR,158,5,163,40,233,9,242,445
2019,21171,CHEVIGNY SAINT SAUVEUR,242100410,DIJON METROPOLE,21,COTE D OR,36,5,41,11,170,2,172,224
2019,24322,PERIGUEUX,200040392,CA LE GRAND PERIGUEUX,24,DORDOGNE,288,6,294,28,166,20,186,508
2019,27229,EVREUX,200071454,CA EVREUX PORTES DE NORMANDIE,27,EURE,498,13,511,87,416,9,425,1023
2019,27681,VERNON,200072312,CA SEINE NORMANDIE AGGLOMERATION,27,EURE,130,55,185,3,270,9,279,466
2019,28088,CHATEAUDUN,200069961,CC DU GRAND CHATEAUDUN,28,EURE ET LOIR,79,5,84,37,100,2,102,223
2019,29075,GUIPAVAS,242900314,BREST METROPOLE,29,FINISTERE,167,1,168,41,308,7,315,524
2019,29103,LANDERNEAU,242900801,CC DU PAYS DE LANDERNEAU-DAOULAS,29,FINISTERE,60,0,60,51,273,1,274,385
2019,29212,PLOUZANE,242900314,BREST METROPOLE,29,FINISTERE,48,0,48,41,309,4,313,402
2019,29232,QUIMPER,200068120,CA QUIMPER BRETAGNE OCCIDENTALE,29,FINISTERE,287,11,298,205,758,21,779,1282
2019,2A004,AJACCIO,242010056,CA DU PAYS AJACCIEN,2A,CORSE DU SUD,495,6,501,26,205,37,242,769
2019,2A247,PORTO VECCHIO,200040764,CC DU SUD CORSE,2A,CORSE DU SUD,88,0,88,13,0,6,6,107
2019,2B033,BASTIA,242000354,CA DE BASTIA,2B,HAUTE CORSE,289,25,314,25,0,8,8,347
2019,30341,VAUVERT,243000593,CC DE PETITE CAMARGUE,30,GARD,37,1,38,35,103,1,104,177
2019,31044,BALMA,243100518,TOULOUSE METROPOLE,31,HAUTE GARONNE,219,11,230,0,157,18,175,406
2019,31113,CASTANET TOLOSAN,243100633,CA DU SICOVAL,31,HAUTE GARONNE,139,9,148,0,175,5,180,328
2019,31116,CASTELGINEST,243100518,TOULOUSE METROPOLE,31,HAUTE GARONNE,49,2,51,0,197,3,200,251
2019,31157,CUGNAUX,243100518,TOULOUSE METROPOLE,31,HAUTE GARONNE,208,18,226,0,240,9,249,474
2019,31187,FONSORBES,200068641,CA LE MURETAIN AGGLO,31,HAUTE GARONNE,76,6,82,0,191,5,196,278
2019,31395,MURET,200068641,CA LE MURETAIN AGGLO,31,HAUTE GARONNE,173,0,173,0,294,12,306,479
2019,31446,RAMONVILLE SAINT AGNE,243100633,CA DU SICOVAL,31,HAUTE GARONNE,201,3,204,0,124,11,135,339
2019,31483,SAINT GAUDENS,200072643,CC COEUR ET COTEAUX DU COMMINGES,31,HAUTE GARONNE,104,0,104,10,74,0,74,188
2019,31488,SAINT JEAN,243100518,TOULOUSE METROPOLE,31,HAUTE GARONNE,76,8,84,0,161,10,171,255
2019,31561,L'UNION,243100518,TOULOUSE METROPOLE,31,HAUTE GARONNE,106,5,111,0,107,13,120,232
2019,33003,AMBARES ET LAGRAVE,243300316,BORDEAUX METROPOLE,33,GIRONDE,109,24,133,7,304,6,310,449
2019,33005,ANDERNOS LES BAINS,243301504,CA DU BASSIN D'ARCACHON NORD,33,GIRONDE,42,0,42,3,120,2,122,167
2019,33009,ARCACHON,243300563,CA BASSIN D'ARCACHON SUD-POLE ATLANTIQUE (COBAS),33,GIRONDE,83,1,84,11,9,2,11,106
2019,33051,BIGANOS,243301504,CA DU BASSIN D'ARCACHON NORD,33,GIRONDE,50,19,69,0,166,1,167,236
2019,33056,BLANQUEFORT,243300316,BORDEAUX METROPOLE,33,GIRONDE,122,10,132,0,245,5,250,382
2019,33063,BORDEAUX,243300316,BORDEAUX METROPOLE,33,GIRONDE,3103,247,3350,127,2148,519,2667,6144
2019,33069,LE BOUSCAT,243300316,BORDEAUX METROPOLE,33,GIRONDE,264,45,309,0,239,31,270,578
2019,33119,CENON,243300316,BORDEAUX METROPOLE,33,GIRONDE,58,16,74,84,309,13,322,479
2019,33122,CESTAS,243301165,CC JALLE-EAU-BOURDE,33,GIRONDE,116,6,122,0,198,3,201,323
2019,33162,EYSINES,243300316,BORDEAUX METROPOLE,33,GIRONDE,168,38,206,0,391,2,393,598
2019,33167,FLOIRAC,243300316,BORDEAUX METROPOLE,33,GIRONDE,156,3,159,54,276,5,281,494
2019,33192,GRADIGNAN,243300316,BORDEAUX METROPOLE,33,GIRONDE,244,14,258,17,224,20,244,519
2019,33281,MERIGNAC,243300316,BORDEAUX METROPOLE,33,GIRONDE,589,76,665,0,1025,62,1087,1752
2019,33284,MIOS,243301504,CA DU BASSIN D'ARCACHON NORD,33,GIRONDE,20,7,27,3,269,3,272,301
2019,33318,PESSAC,243300316,BORDEAUX METROPOLE,33,GIRONDE,513,44,557,38,827,35,862,1457
2019,33366,SAINT ANDRE DE CUBZAC,243301223,CC DU GRAND CUBZAGUAIS,33,GIRONDE,46,9,55,0,336,1,337,392
2019,33449,SAINT MEDARD EN JALLES,243300316,BORDEAUX METROPOLE,33,GIRONDE,192,10,202,0,526,12,538,741
2019,33550,VILLENAVE D ORNON,243300316,BORDEAUX METROPOLE,33,GIRONDE,332,39,371,12,536,12,548,932
2019,34003,AGDE,243400819,CA HERAULT-MEDITERRANEE,34,HERAULT,181,16,197,54,102,9,111,363
2019,34032,BEZIERS,243400769,CA DE BEZIERS-MEDITERRANEE,34,HERAULT,320,13,333,107,415,17,432,872
2019,34108,FRONTIGNAN,200066355,CA SETE AGGLOPOLE MEDITERRANEE,34,HERAULT,130,16,146,23,188,3,191,361
2019,34123,JUVIGNAC,243400017,MONTPELLIER MEDITERRANEE METROPOLE,34,HERAULT,70,11,81,0,136,12,148,229
2019,34255,SAINT GELY DU FESC,200022986,CC DU GRAND PIC SAINT-LOUP,34,HERAULT,66,8,74,0,100,10,110,184
2019,34337,VILLENEUVE LES MAGUELONE,243400017,MONTPELLIER MEDITERRANEE METROPOLE,34,HERAULT,83,5,88,0,91,3,94,182
2019,35047,BRUZ,243500139,RENNES METROPOLE,35,ILLE ET VILAINE,75,37,112,41,257,10,267,421
2019,35055,CHANTEPIE,243500139,RENNES METROPOLE,35,ILLE ET VILAINE,42,7,49,20,175,2,177,246
2019,35069,CHATEAUGIRON,243500659,CC PAYS DE CHATEAUGIRON COMMUNAUTE,35,ILLE ET VILAINE,35,15,50,36,275,3,278,364
2019,35288,SAINT MALO,243500782,CA DU PAYS DE SAINT MALO AGGLOMERATION,35,ILLE ET VILAINE,290,13,303,135,358,40,398,835
2019,37233,SAINT PIERRE DES CORPS,243700754,TOURS METROPOLE VAL DE LOIRE,37,INDRE ET LOIRE,96,14,110,54,311,10,321,485
2019,37261,TOURS,243700754,TOURS METROPOLE VAL DE LOIRE,37,INDRE ET LOIRE,1183,169,1352,115,1293,102,1395,2862
2019,38053,BOURGOIN JALLIEU,243800604,CA PORTE DE L'ISERE (CAPI),38,ISERE,88,51,139,41,327,7,334,514
2019,38169,FONTAINE,200040715,GRENOBLE-ALPES-METROPOLE,38,ISERE,147,15,162,38,349,10,359,559
2019,38229,MEYLAN,200040715,GRENOBLE-ALPES-METROPOLE,38,ISERE,184,25,209,1,191,13,204,414
2019,38474,SASSENAGE,200040715,GRENOBLE-ALPES-METROPOLE,38,ISERE,88,5,93,0,189,3,192,286
2019,38485,SEYSSINET PARISET,200040715,GRENOBLE-ALPES-METROPOLE,38,ISERE,104,10,114,0,166,4,170,284
2019,41269,VENDOME,200072072,CA TERRITOIRES VENDOMOIS,41,LOIR ET CHER,104,0,104,1,171,2,173,279
2019,42095,FIRMINY,244200770,SAINT-ETIENNE METROPOLE,42,LOIRE,50,17,67,45,156,3,159,271
2019,42186,RIVE DE GIER,244200770,SAINT-ETIENNE METROPOLE,42,LOIRE,55,26,81,13,203,0,203,298
2019,42207,SAINT CHAMOND,244200770,SAINT-ETIENNE METROPOLE,42,LOIRE,198,27,225,135,360,7,367,727
2019,42218,SAINT ETIENNE,244200770,SAINT-ETIENNE METROPOLE,42,LOIRE,1003,66,1069,237,1193,66,1259,2566
2019,44036,CHATEAUBRIANT,200072726,CC CHATEAUBRIANT-DERVAL,44,LOIRE ATLANTIQUE,56,0,56,16,149,0,149,221
2019,44055,LA BAULE ESCOUBLAC,244400610,CA DE LA PRESQU'ILE DE GUERANDE ATLANTIQUE (CAP ATLANTIQUE),44,LOIRE ATLANTIQUE,60,5,65,25,88,12,100,190
2019,44109,NANTES,244400404,NANTES METROPOLE,44,LOIRE ATLANTIQUE,3295,300,3595,425,3279,753,4032,8052
2019,44132,PORNICHET,244400644,CA DE LA REGION NAZAIRIENNE ET DE L'ESTUAIRE (CARENE),44,LOIRE ATLANTIQUE,50,5,55,4,118,13,131,189
2019,44172,SAINTE LUCE SUR LOIRE,244400404,NANTES METROPOLE,44,LOIRE ATLANTIQUE,122,5,127,0,336,6,342,469
2019,44184,SAINT NAZAIRE,244400644,CA DE LA REGION NAZAIRIENNE ET DE L'ESTUAIRE (CARENE),44,LOIRE ATLANTIQUE,380,30,410,179,785,37,822,1411
2019,44215,VERTOU,244400404,NANTES METROPOLE,44,LOIRE ATLANTIQUE,90,50,140,7,467,27,494,641
2019,45284,SAINT JEAN DE BRAYE,244500468,ORLEANS METROPOLE,45,LOIRET,198,29,227,0,287,11,298,525
2019,47001,AGEN,200035459,CA D'AGEN,47,LOT ET GARONNE,229,0,229,92,296,10,306,627
2019,47323,VILLENEUVE SUR LOT,200023307,CA DU GRAND VILLENEUVOIS,47,LOT ET GARONNE,147,0,147,46,175,8,183,376
2019,49007,ANGERS,244900015,CU ANGERS LOIRE METROPOLE,49,MAINE ET LOIRE,1159,146,1305,265,1393,127,1520,3090
2019,49023,BEAUPREAU EN MAUGES,200060010,CA MAUGES COMMUNAUTE,49,MAINE ET LOIRE,72,26,98,59,510,8,518,676
2019,49069,OREE D ANJOU,200060010,CA MAUGES COMMUNAUTE,49,MAINE ET LOIRE,26,3,29,46,369,5,374,449
2019,49092,CHEMILLE EN ANJOU,200060010,CA MAUGES COMMUNAUTE,49,MAINE ET LOIRE,34,27,61,39,454,8,462,561
2019,49099,CHOLET,200071678,CA AGGLOMERATION DU CHOLETAIS,49,MAINE ET LOIRE,292,21,313,164,690,21,711,1188
2019,49244,MAUGES SUR LOIRE,200060010,CA MAUGES COMMUNAUTE,49,MAINE ET LOIRE,36,1,37,42,420,5,425,503
2019,49246,LES PONTS DE CE,244900015,CU ANGERS LOIRE METROPOLE,49,MAINE ET LOIRE,40,6,46,4,178,11,189,240
2019,49301,SEVREMOINE,200060010,CA MAUGES COMMUNAUTE,49,MAINE ET LOIRE,36,23,59,57,603,5,608,724
2019,51108,CHALONS EN CHAMPAGNE,200066876,CA DE CHALONS-EN-CHAMPAGNE,51,MARNE,476,28,504,55,384,10,394,954
2019,51230,EPERNAY,200067684,CA EPERNAY,51,MARNE,219,18,237,43,179,4,183,463
2019,51454,REIMS,200067213,CU DU GRAND REIMS,51,MARNE,1322,402,1724,304,1377,155,1532,3560
2019,51573,TINQUEUX,200067213,CU DU GRAND REIMS,51,MARNE,74,16,90,0,171,5,176,266
2019,51649,VITRY LE FRANCOIS,200034718,CC DE VITRY,51,MARNE,110,1,111,31,100,3,103,245
2019,54528,TOUL,200070563,CC TERRES TOULOISES,54,MEURTHE ET MOSELLE,110,0,110,14,159,3,162,286
2019,55029,BAR LE DUC,200033025,CA DE BAR-LE-DUC - SUD MEUSE,55,MEUSE,131,0,131,56,111,4,115,302
2019,56078,GUIDEL,200042174,CA LORIENT AGGLOMERATION,56,MORBIHAN,30,6,36,35,163,9,172,243
2019,56083,HENNEBONT,200042174,CA LORIENT AGGLOMERATION,56,MORBIHAN,50,3,53,58,187,2,189,300
2019,56260,VANNES,200067932,CA GOLFE DU MORBIHAN - VANNES AGGLOMERATION,56,MORBIHAN,413,22,435,264,374,33,407,1106
2019,57160,CREUTZWALD,245701164,CC DU WARNDT,57,MOSELLE,58,1,59,34,97,0,97,190
2019,57227,FORBACH,245700372,CA DE FORBACH PORTE DE FRANCE,57,MOSELLE,81,0,81,34,100,2,102,217
2022,37195,LA RICHE,243700754,TOURS METROPOLE VAL DE LOIRE,37,INDRE ET LOIRE,70,21,91,12,159,5,164,267
2022,37208,SAINT AVERTIN,243700754,TOURS METROPOLE VAL DE LOIRE,37,INDRE ET LOIRE,122,4,126,2,174,5,179,307
2022,38053,BOURGOIN JALLIEU,243800604,CA PORTE DE L'ISERE (CAPI),38,ISERE,92,59,151,23,338,4,342,516
2022,38193,L'ISLE D ABEAU,243800604,CA PORTE DE L'ISERE (CAPI),38,ISERE,125,53,178,0,253,13,266,444
2022,38317,LE PONT DE CLAIX,200040715,GRENOBLE-ALPES-METROPOLE,38,ISERE,162,4,166,38,110,1,111,316
2022,38544,VIENNE,200077014,CA VIENNE CONDRIEU,38,ISERE,168,27,195,15,419,14,433,643
2022,40192,MONT DE MARSAN,244000808,CA MONT DE MARSAN AGGLOMERATION,40,LANDES,192,0,192,22,375,3,378,592
2022,42044,LE CHAMBON FEUGEROLLES,244200770,SAINT-ETIENNE METROPOLE,42,LOIRE,86,2,88,21,90,1,91,199
2022,44047,COUERON,244400404,NANTES METROPOLE,44,LOIRE ATLANTIQUE,85,64,149,0,491,8,499,648
2022,44132,PORNICHET,244400644,CA DE LA REGION NAZAIRIENNE ET DE L'ESTUAIRE (CARENE),44,LOIRE ATLANTIQUE,50,19,69,0,115,4,119,189
2022,45147,FLEURY LES AUBRAIS,244500468,ORLEANS METROPOLE,45,LOIRET,132,32,164,0,263,11,274,438
2022,45208,MONTARGIS,244500203,CA MONTARGOISE ET RIVES DU LOING (AME),45,LOIRET,131,10,141,23,71,1,72,235
2022,46042,CAHORS,200023737,CA DU GRAND CAHORS,46,LOT,142,11,153,10,194,4,198,361
2022,49069,OREE D ANJOU,200060010,CA MAUGES COMMUNAUTE,49,MAINE ET LOIRE,26,0,26,33,281,4,285,344
2022,51454,REIMS,200067213,CU DU GRAND REIMS,51,MARNE,1405,516,1921,304,1105,144,1249,3473
2022,55545,VERDUN,200049187,CA DU GRAND VERDUN,55,MEUSE,90,11,101,25,144,4,148,274
2022,56083,HENNEBONT,200042174,CA LORIENT AGGLOMERATION,56,MORBIHAN,50,8,58,58,160,8,168,285
2022,56098,LANESTER,200042174,CA LORIENT AGGLOMERATION,56,MORBIHAN,105,27,132,78,278,7,285,495
2022,56162,PLOEMEUR,200042174,CA LORIENT AGGLOMERATION,56,MORBIHAN,124,21,145,40,147,14,161,346
2022,56178,PONTIVY,245614433,CC PONTIVY COMMUNAUTE,56,MORBIHAN,45,5,50,55,159,2,161,266
2022,57221,FLORANGE,245701222,CA DU VAL DE FENSCH,57,MOSELLE,35,17,52,17,74,2,76,145
2022,57240,FREYMING MERLEBACH,245700398,CC DE FREYMING-MERLEBACH,57,MOSELLE,0,0,0,11,89,0,89,100
2022,57630,SARREBOURG,200068146,CC SARREBOURG MOSELLE SUD,57,MOSELLE,50,5,55,14,135,0,135,204
2022,57751,WOIPPY,200039865,METZ METROPOLE,57,MOSELLE,30,7,37,47,132,1,133,217
2022,58194,NEVERS,245804406,CA DE NEVERS,58,NIEVRE,278,13,291,45,194,9,203,539
2022,59122,CAMBRAI,200068500,CA DE CAMBRAI,59,NORD,102,14,116,124,263,6,269,509
2022,59279,HALLUIN,200093201,METROPOLE EUROPEENNE DE LILLE,59,NORD,82,61,143,56,245,1,246,445
2022,59299,HEM,200093201,METROPOLE EUROPEENNE DE LILLE,59,NORD,129,76,205,60,190,9,199,464
2022,59383,MARLY,245901160,CA VALENCIENNES METROPOLE,59,NORD,90,17,107,30,135,0,135,272
2022,59426,NEUVILLE EN FERRAIN,200093201,METROPOLE EUROPEENNE DE LILLE,59,NORD,77,37,114,56,92,2,94,264
2022,59527,SAINT ANDRE LEZ LILLE,200093201,METROPOLE EUROPEENNE DE LILLE,59,NORD,103,51,154,26,152,17,169,349
2022,59560,SECLIN,200093201,METROPOLE EUROPEENNE DE LILLE,59,NORD,127,35,162,42,123,5,128,332
2022,59646,WASQUEHAL,200093201,METROPOLE EUROPEENNE DE LILLE,59,NORD,223,85,308,60,269,13,282,650
2022,61006,ARGENTAN,200068450,CC ARGENTAN INTERCOM,61,ORNE,88,0,88,30,143,0,143,261
2022,62041,ARRAS,200033579,CU D'ARRAS,62,PAS DE CALAIS,323,108,431,132,263,23,286,849
2022,62186,BULLY LES MINES,246200364,CA DE LENS - LIEVIN,62,PAS DE CALAIS,30,18,48,32,101,1,102,182
2022,62215,CARVIN,246200299,CA D'HENIN-CARVIN,62,PAS DE CALAIS,60,30,90,17,251,3,254,361
2022,62413,HARNES,246200364,CA DE LENS - LIEVIN,62,PAS DE CALAIS,0,28,28,46,121,3,124,198
2022,62548,MARCK,200090751,CA GRAND CALAIS TERRES ET MERS,62,PAS DE CALAIS,47,2,49,28,89,0,89,166
2022,63075,CHAMALIERES,246300701,CLERMONT AUVERGNE METROPOLE,63,PUY DE DOME,159,10,169,6,66,28,94,269
2022,63178,ISSOIRE,200070407,CA AGGLO PAYS D'ISSOIRE,63,PUY DE DOME,85,5,90,7,266,3,269,366
2022,64430,ORTHEZ,200039204,CC DE LACQ-ORTHEZ,64,PYRENEES ATLANTIQUES,50,0,50,6,71,2,73,129
2022,66037,CANET EN ROUSSILLON,200027183,CU PERPIGNAN MEDITERRANEE METROPOLE,66,PYRENEES ORIENTALES,79,13,92,2,55,9,64,158
2022,66136,PERPIGNAN,200027183,CU PERPIGNAN MEDITERRANEE METROPOLE,66,PYRENEES ORIENTALES,716,188,904,267,395,52,447,1618
2022,66171,SAINT CYPRIEN,246600282,CC SUD-ROUSSILLON,66,PYRENEES ORIENTALES,31,7,38,6,45,5,50,94
2022,66172,SAINT ESTEVE,200027183,CU PERPIGNAN MEDITERRANEE METROPOLE,66,PYRENEES ORIENTALES,40,7,47,14,112,2,114,175
2022,66180,SAINT LAURENT DE LA SALANQUE,200027183,CU PERPIGNAN MEDITERRANEE METROPOLE,66,PYRENEES ORIENTALES,50,7,57,0,60,3,63,120
2022,67204,HOENHEIM,246700488,EUROMETROPOLE DE STRASBOURG,67,BAS RHIN,90,44,134,0,87,4,91,224
2022,67447,SCHILTIGHEIM,246700488,EUROMETROPOLE DE STRASBOURG,67,BAS RHIN,397,126,523,52,257,10,267,842
2022,68112,GUEBWILLER,246800569,CC DE LA REGION DE GUEBWILLER,68,HAUT RHIN,70,13,83,0,52,4,56,139
2022,68271,RIEDISHEIM,200066009,CA MULHOUSE ALSACE AGGLOMERATION,68,HAUT RHIN,70,4,74,0,61,3,64,139
2022,68278,RIXHEIM,200066009,CA MULHOUSE ALSACE AGGLOMERATION,68,HAUT RHIN,130,7,137,11,112,2,114,262
2022,68297,SAINT LOUIS,200066058,CA SAINT-LOUIS AGGLOMERATION,68,HAUT RHIN,152,18,170,33,109,4,113,317
2022,69264,VILLEFRANCHE SUR SAONE,200040590,CA VILLEFRANCHE BEAUJOLAIS SAONE,69D,RHONE,304,23,327,130,263,12,275,732
2022,69029,BRON,200046977,METROPOLE DE LYON,69M,RHONE,376,59,435,55,250,35,285,774
2022,69149,OULLINS,200046977,METROPOLE DE LYON,69M,RHONE,204,50,254,21,330,29,359,634
2022,69259,VENISSIEUX,200046977,METROPOLE DE LYON,69M,RHONE,482,42,524,518,392,24,416,1458
2022,69266,VILLEURBANNE,200046977,METROPOLE DE LYON,69M,RHONE,962,404,1366,391,1793,112,1905,3662
2022,69271,CHASSIEU,200046977,METROPOLE DE LYON,69M,RHONE,67,15,82,0,128,6,134,216
2022,69282,MEYZIEU,200046977,METROPOLE DE LYON,69M,RHONE,239,133,372,58,437,17,454,884
2022,69286,RILLIEUX LA PAPE,200046977,METROPOLE DE LYON,69M,RHONE,224,81,305,56,267,19,286,647
2022,69381,LYON 1ER ARRONDISSEMENT,200046977,METROPOLE DE LYON,69M,RHONE,282,64,346,3,186,74,260,610
2022,69386,LYON 6E ARRONDISSEMENT,200046977,METROPOLE DE LYON,69M,RHONE,564,222,786,29,366,202,568,1383
2022,72003,ALLONNES,247200132,CU LE MANS METROPOLE,72,SARTHE,18,1,19,47,143,5,148,213
2022,72264,SABLE SUR SARTHE,247200090,CC DU PAYS SABOLIEN,72,SARTHE,45,0,45,20,144,1,145,210
2022,73008,AIX LES BAINS,200068674,CA GRAND LAC,73,SAVOIE,155,67,222,8,274,29,303,534
2022,73065,CHAMBERY,200069110,CA DU GRAND CHAMBERY,73,SAVOIE,370,37,407,52,486,47,533,993
2022,73179,LA MOTTE SERVOLEX,200069110,CA DU GRAND CHAMBERY,73,SAVOIE,50,20,70,10,180,11,191,272
2022,74224,LA ROCHE SUR FORON,247400724,CC DU PAYS ROCHOIS,74,HAUTE SAVOIE,42,8,50,0,117,5,122,172
2022,74243,SAINT JULIEN EN GENEVOIS,247400690,CC DU GENEVOIS,74,HAUTE SAVOIE,101,18,119,0,146,10,156,274
2022,75102,PARIS 2E ARRONDISSEMENT,200054781,METROPOLE DU GRAND PARIS,75,PARIS,378,10,388,4,17,159,176,568
2022,75103,PARIS 3E ARRONDISSEMENT,200054781,METROPOLE DU GRAND PARIS,75,PARIS,696,22,718,9,62,162,224,951
2022,75104,PARIS 4E ARRONDISSEMENT,200054781,METROPOLE DU GRAND PARIS,75,PARIS,572,6,578,23,30,90,120,721
2022,75111,PARIS 11E ARRONDISSEMENT,200054781,METROPOLE DU GRAND PARIS,75,PARIS,2737,251,2988,63,167,609,776,3826
2022,76057,BARENTIN,247600646,CC CAUX - AUSTREBERTHE,76,SEINE MARITIME,72,7,79,0,219,2,221,300
2022,76216,DEVILLE LES ROUEN,200023414,METROPOLE ROUEN NORMANDIE,76,SEINE MARITIME,40,12,52,4,173,3,176,232
2022,76217,DIEPPE,247600786,CA DE LA REGION DIEPPOISE,76,SEINE MARITIME,184,1,185,89,182,5,187,461
2022,76231,ELBEUF,200023414,METROPOLE ROUEN NORMANDIE,76,SEINE MARITIME,80,4,84,26,121,3,124,235
2022,76540,ROUEN,200023414,METROPOLE ROUEN NORMANDIE,76,SEINE MARITIME,984,285,1269,24,817,72,889,2182
2022,76681,SOTTEVILLE LES ROUEN,200023414,METROPOLE ROUEN NORMANDIE,76,SEINE MARITIME,176,32,208,11,358,8,366,585
2022,77014,AVON,200072346,CA DU PAYS DE FONTAINEBLEAU,77,SEINE ET MARNE,69,6,75,0,126,12,138,213
2022,77058,BUSSY SAINT GEORGES,247700594,CA MARNE ET GONDOIRE,77,SEINE ET MARNE,350,11,361,14,211,20,231,605
2022,77067,CESSON,200059228,CA GRAND PARIS SUD SEINE ESSONNE SENART,77,SEINE ET MARNE,163,3,166,2,104,5,109,277
2022,77131,COULOMMIERS,200090504,CA COULOMMIERS PAYS DE BRIE,77,SEINE ET MARNE,160,20,180,11,142,1,143,334
2022,77186,FONTAINEBLEAU,200072346,CA DU PAYS DE FONTAINEBLEAU,77,SEINE ET MARNE,139,13,152,7,100,16,116,275
2022,77258,LOGNES,200057958,CA PARIS - VALLEE DE LA MARNE,77,SEINE ET MARNE,206,8,214,0,117,5,122,335
2022,77284,MEAUX,200072130,CA DU PAYS DE MEAUX,77,SEINE ET MARNE,538,45,583,20,452,16,468,1071
2022,77288,MELUN,247700057,CA MELUN VAL DE SEINE,77,SEINE ET MARNE,451,16,467,16,308,31,339,822
2022,77305,MONTEREAU FAULT YONNE,247700107,CC PAYS DE MONTEREAU,77,SEINE ET MARNE,128,2,130,21,162,6,168,320
2022,77333,NEMOURS,200023240,CC PAYS DE NEMOURS,77,SEINE ET MARNE,0,13,13,5,149,4,153,171
2022,77337,NOISIEL,200057958,CA PARIS - VALLEE DE LA MARNE,77,SEINE ET MARNE,197,3,200,18,84,15,99,317
2022,77350,OZOIR LA FERRIERE,200023125,CC LES PORTES BRIARDES ENTRE VILLES ET FORETS,77,SEINE ET MARNE,200,18,218,3,226,7,233,454
2022,77407,SAINT FARGEAU PONTHIERRY,247700057,CA MELUN VAL DE SEINE,77,SEINE ET MARNE,124,2,126,3,214,1,215,344
2022,77479,VAIRES SUR MARNE,200057958,CA PARIS - VALLEE DE LA MARNE,77,SEINE ET MARNE,131,1,132,0,124,7,131,263
2022,78123,CARRIERES SOUS POISSY,200059889,CU GRAND PARIS SEINE ET OISE,78,YVELINES,145,121,266,18,200,19,219,503
2022,78165,LES CLAYES SOUS BOIS,200058782,CA DE SAINT QUENTIN EN YVELINES,78,YVELINES,163,39,202,16,165,6,171,389
2022,78172,CONFLANS SAINTE HONORINE,200059889,CU GRAND PARIS SEINE ET OISE,78,YVELINES,331,74,405,0,374,23,397,802
2022,78190,CROISSY SUR SEINE,200058519,CA SAINT GERMAIN BOUCLES DE SEINE,78,YVELINES,124,11,135,0,37,42,79,214
2022,78335,LIMAY,200059889,CU GRAND PARIS SEINE ET OISE,78,YVELINES,139,32,171,0,179,3,182,353
2022,78418,MONTESSON,200058519,CA SAINT GERMAIN BOUCLES DE SEINE,78,YVELINES,195,6,201,0,115,22,137,338
2022,78481,LE PECQ,200058519,CA SAINT GERMAIN BOUCLES DE SEINE,78,YVELINES,159,25,184,3,130,17,147,335
2022,78545,SAINT CYR L ECOLE,247800584,CA VERSAILLES GRAND PARC (CAVGP),78,YVELINES,270,82,352,0,173,25,198,550
2022,78642,VERNEUIL SUR SEINE,200059889,CU GRAND PARIS SEINE ET OISE,78,YVELINES,76,28,104,0,196,11,207,310
2022,78686,VIROFLAY,247800584,CA VERSAILLES GRAND PARC (CAVGP),78,YVELINES,222,41,263,0,89,73,162,425
2022,79191,NIORT,200041317,CA DU NIORTAIS,79,DEUX SEVRES,423,2,425,76,560,35,595,1096
2022,79202,PARTHENAY,200041333,CC DE PARTHENAY-GATINE,79,DEUX SEVRES,72,0,72,4,74,7,81,157
2022,81004,ALBI,248100737,CA DE L'ALBIGEOIS (C2A),81,TARN,378,76,454,33,208,31,239,726
2022,81105,GRAULHET,200066124,CA GAILLAC-GRAULHET,81,TARN,76,1,77,23,67,2,69,169
2022,81140,LAVAUR,200034023,CC TARN-AGOUT,81,TARN,115,0,115,9,115,7,122,246
2022,82121,MONTAUBAN,248200099,CA GRAND MONTAUBAN,82,TARN ET GARONNE,488,50,538,82,452,18,470,1090
2022,83023,BRIGNOLES,200068104,CA DE LA PROVENCE VERTE,83,VAR,119,9,128,0,164,8,172,300
2022,83047,LA CRAU,248300543,METROPOLE TOULON-PROVENCE-MEDITERRANEE,83,VAR,97,26,123,0,221,5,226,349
2022,83049,CUERS,200027100,CC MEDITERRANEE PORTE DES MAURES,83,VAR,50,37,87,0,171,5,176,264
2022,83061,FREJUS,200035319,CA ESTEREL COTE D'AZUR AGGLOMERATION,83,VAR,406,22,428,31,312,23,335,794
2022,83062,LA GARDE,248300543,METROPOLE TOULON-PROVENCE-MEDITERRANEE,83,VAR,253,37,290,3,172,12,184,477
2022,83069,HYERES,248300543,METROPOLE TOULON-PROVENCE-MEDITERRANEE,83,VAR,372,40,412,10,321,23,344,766
2022,83129,SIX FOURS LES PLAGES,248300543,METROPOLE TOULON-PROVENCE-MEDITERRANEE,83,VAR,243,79,322,4,233,13,246,572
2022,83148,VIDAUBAN,248300493,CA DRACENIE PROVENCE VERDON AGGLOMERATION,83,VAR,20,8,28,0,130,3,133,161
2022,84007,AVIGNON,248400251,CA DU GRAND AVIGNON (COGA),84,VAUCLUSE,748,144,892,67,321,38,359,1318
2022,84031,CARPENTRAS,248400053,CA VENTOUX-COMTAT-VENAISSIN (COVE),84,VAUCLUSE,208,30,238,0,175,9,184,422
2022,84087,ORANGE,248400236,CC PAYS D'ORANGE EN PROVENCE,84,VAUCLUSE,172,9,181,6,274,8,282,469
2022,84088,PERNES LES FONTAINES,248400293,CA DES SORGUES DU COMTAT,84,VAUCLUSE,68,9,77,0,115,1,116,192
2022,84089,PERTUIS,200054807,METROPOLE D'AIX-MARSEILLE-PROVENCE,84,VAUCLUSE,150,3,153,9,253,7,260,422
2022,85109,LES HERBIERS,248500621,CC DU PAYS DES HERBIERS,85,VENDEE,61,52,113,38,295,6,301,452
2022,85191,LA ROCHE SUR YON,248500589,CA LA ROCHE SUR YON - AGGLOMERATION,85,VENDEE,390,70,460,103,534,26,560,1123
2022,85194,LES SABLES D OLONNE,200071165,CA LES SABLES D'OLONNE AGGLOMERATION,85,VENDEE,106,49,155,65,356,18,374,595
2022,86066,CHATELLERAULT,248600413,CA GRAND CHATELLERAULT,86,VIENNE,125,15,140,91,215,5,220,451
2022,88160,EPINAL,200068757,CA D'EPINAL,88,VOSGES,225,9,234,65,251,10,261,561
2022,89024,AUXERRE,200067114,CA DE L'AUXERROIS,89,YONNE,260,7,267,31,360,12,372,670
2022,91103,BRETIGNY SUR ORGE,200057859,CA COEUR D'ESSONNE AGGLOMERATION,91,ESSONNE,253,66,319,0,414,7,421,740
2022,91114,BRUNOY,200058477,CA VAL D'YERRES VAL DE SEINE,91,ESSONNE,220,12,232,18,214,18,232,482
2022,91174,CORBEIL ESSONNES,200059228,CA GRAND PARIS SUD SEINE ESSONNE SENART,91,ESSONNE,346,32,378,85,398,29,427,889
2022,91215,EPINAY SOUS SENART,200058477,CA VAL D'YERRES VAL DE SEINE,91,ESSONNE,65,1,66,32,131,4,135,233
2022,91377,MASSY,200056232,CA COMMUNAUTE PARIS-SACLAY,91,ESSONNE,915,95,1010,26,690,29,719,1756
2022,91432,MORANGIS,200054781,METROPOLE DU GRAND PARIS,91,ESSONNE,125,6,131,1,181,2,183,315
2022,91471,ORSAY,200056232,CA COMMUNAUTE PARIS-SACLAY,91,ESSONNE,204,19,223,6,93,14,107,336
2022,91521,RIS ORANGIS,200059228,CA GRAND PARIS SUD SEINE ESSONNE SENART,91,ESSONNE,201,39,240,17,317,8,325,582
2022,91589,SAVIGNY SUR ORGE,200054781,METROPOLE DU GRAND PARIS,91,ESSONNE,222,32,254,14,507,10,517,786
2022,91657,VIGNEUX SUR SEINE,200058477,CA VAL D'YERRES VAL DE SEINE,91,ESSONNE,218,36,254,8,278,11,289,551
2022,91691,YERRES,200058477,CA VAL D'YERRES VAL DE SEINE,91,ESSONNE,465,16,481,20,320,38,358,859
2022,92002,ANTONY,200054781,METROPOLE DU GRAND PARIS,92,HAUTS DE SEINE,938,60,998,13,412,135,547,1558
2022,92014,BOURG LA REINE,200054781,METROPOLE DU GRAND PARIS,92,HAUTS DE SEINE,327,10,337,0,83,69,152,489
2022,92024,CLICHY,200054781,METROPOLE DU GRAND PARIS,92,HAUTS DE SEINE,961,146,1107,36,433,241,674,1817
2022,92032,FONTENAY AUX ROSES,200054781,METROPOLE DU GRAND PARIS,92,HAUTS DE SEINE,226,28,254,0,140,20,160,413
2022,92040,ISSY LES MOULINEAUX,200054781,METROPOLE DU GRAND PARIS,92,HAUTS DE SEINE,1437,83,1520,12,521,213,734,2266
2022,92048,MEUDON,200054781,METROPOLE DU GRAND PARIS,92,HAUTS DE SEINE,680,51,731,3,220,124,344,1078
2022,92050,NANTERRE,200054781,METROPOLE DU GRAND PARIS,92,HAUTS DE SEINE,1360,82,1442,119,706,152,858,2418
2022,92064,SAINT CLOUD,200054781,METROPOLE DU GRAND PARIS,92,HAUTS DE SEINE,494,62,556,4,126,180,306,866
2022,92071,SCEAUX,200054781,METROPOLE DU GRAND PARIS,92,HAUTS DE SEINE,322,0,322,0,75,52,127,449
2022,92073,SURESNES,200054781,METROPOLE DU GRAND PARIS,92,HAUTS DE SEINE,802,151,953,40,447,222,669,1662
2022,92078,VILLENEUVE LA GARENNE,200054781,METROPOLE DU GRAND PARIS,92,HAUTS DE SEINE,294,5,299,23,78,10,88,410
2022,93005,AULNAY SOUS BOIS,200054781,METROPOLE DU GRAND PARIS,93,SEINE SAINT DENIS,791,31,822,111,345,24,369,1302
2022,93007,LE BLANC MESNIL,200054781,METROPOLE DU GRAND PARIS,93,SEINE SAINT DENIS,336,15,351,9,139,22,161,521
2022,93027,LA COURNEUVE,200054781,METROPOLE DU GRAND PARIS,93,SEINE SAINT DENIS,337,5,342,53,105,12,117,513
2022,93031,EPINAY SUR SEINE,200054781,METROPOLE DU GRAND PARIS,93,SEINE SAINT DENIS,459,19,478,95,265,43,308,881
2022,93048,MONTREUIL,200054781,METROPOLE DU GRAND PARIS,93,SEINE SAINT DENIS,1297,195,1492,56,699,391,1090,2637
2022,93050,NEUILLY SUR MARNE,200054781,METROPOLE DU GRAND PARIS,93,SEINE SAINT DENIS,399,18,417,37,326,21,347,801
2022,93062,LE RAINCY,200054781,METROPOLE DU GRAND PARIS,93,SEINE SAINT DENIS,179,9,188,0,128,12,140,328
2022,93063,ROMAINVILLE,200054781,METROPOLE DU GRAND PARIS,93,SEINE SAINT DENIS,377,48,425,0,282,105,387,812
2022,93071,SEVRAN,200054781,METROPOLE DU GRAND PARIS,93,SEINE SAINT DENIS,317,16,333,92,200,11,211,636
2022,93077,VILLEMOMBLE,200054781,METROPOLE DU GRAND PARIS,93,SEINE SAINT DENIS,246,33,279,0,202,39,241,520
2022,94002,ALFORTVILLE,200054781,METROPOLE DU GRAND PARIS,94,VAL DE MARNE,446,124,570,40,356,69,425,1036
2022,94015,BRY SUR MARNE,200054781,METROPOLE DU GRAND PARIS,94,VAL DE MARNE,293,23,316,22,93,22,115,453
2022,94022,CHOISY LE ROI,200054781,METROPOLE DU GRAND PARIS,94,VAL DE MARNE,442,86,528,41,384,16,400,969
2022,94044,LIMEIL BREVANNES,200054781,METROPOLE DU GRAND PARIS,94,VAL DE MARNE,287,25,312,18,256,14,270,601
2022,94055,ORMESSON SUR MARNE,200054781,METROPOLE DU GRAND PARIS,94,VAL DE MARNE,97,9,106,0,82,4,86,193
2022,94067,SAINT MANDE,200054781,METROPOLE DU GRAND PARIS,94,VAL DE MARNE,417,47,464,35,31,211,242,742
2022,94068,SAINT MAUR DES FOSSES,200054781,METROPOLE DU GRAND PARIS,94,VAL DE MARNE,772,160,932,61,446,169,615,1608
2022,94074,VALENTON,200054781,METROPOLE DU GRAND PARIS,94,VAL DE MARNE,122,10,132,53,50,3,53,238
2022,94076,VILLEJUIF,200054781,METROPOLE DU GRAND PARIS,94,VAL DE MARNE,698,62,760,70,316,58,374,1203
2022,94079,VILLIERS SUR MARNE,200054781,METROPOLE DU GRAND PARIS,94,VAL DE MARNE,254,55,309,18,242,32,274,601
2022,95176,CORMEILLES EN PARISIS,200058485,CA VAL PARISIS,95,VAL D OISE,180,49,229,0,284,33,317,545
2022,95197,DEUIL LA BARRE,200056380,CA PLAINE VALLEE,95,VAL D OISE,120,39,159,0,290,25,315,474
2022,95199,DOMONT,200056380,CA PLAINE VALLEE,95,VAL D OISE,110,38,148,0,177,4,181,328
2022,95203,EAUBONNE,200058485,CA VAL PARISIS,95,VAL D OISE,362,12,374,0,309,27,336,710
2022,95252,FRANCONVILLE,200058485,CA VAL PARISIS,95,VAL D OISE,302,15,317,0,415,18,433,750
2022,95351,LOUVRES,200055655,CA ROISSY PAYS DE FRANCE,95,VAL D OISE,104,1,105,0,93,11,104,209
2022,95424,MONTIGNY LES CORMEILLES,200058485,CA VAL PARISIS,95,VAL D OISE,121,10,131,37,219,10,229,397
2022,95428,MONTMORENCY,200056380,CA PLAINE VALLEE,95,VAL D OISE,134,32,166,0,177,22,199,366
2022,95500,PONTOISE,249500109,CA DE CERGY-PONTOISE,95,VAL D OISE,304,36,340,19,265,15,280,639
2022,95572,SAINT OUEN L AUMONE,249500109,CA DE CERGY-PONTOISE,95,VAL D OISE,236,50,286,30,249,11,260,576
2022,95582,SANNOIS,200058485,CA VAL PARISIS,95,VAL D OISE,234,13,247,0,340,18,358,605
2022,95607,TAVERNY,200058485,CA VAL PARISIS,95,VAL D OISE,177,16,193,0,365,9,374,567
2022,97107,CAPESTERRE BELLE EAU,249710070,CA GRAND SUD CARAIBE,971,GUADELOUPE,65,3,68,76,35,5,40,185
2022,97116,MORNE A L EAU,200044691,CA DU NORD GRANDE TERRE,971,GUADELOUPE,0,6,6,55,65,8,73,134
2022,97118,PETIT BOURG,249710062,CA DU NORD BASSE-TERRE,971,GUADELOUPE,45,48,93,37,140,13,153,283
2022,97120,POINTE A PITRE,200018653,CA CAP EXCELLENCE,971,GUADELOUPE,190,1,191,60,40,6,46,297
2022,97124,SAINT CLAUDE,249710070,CA GRAND SUD CARAIBE,971,GUADELOUPE,40,16,56,23,42,4,46,125
2022,97125,SAINT FRANCOIS,200041507,CA LA RIVIERA DU LEVANT,971,GUADELOUPE,53,59,112,41,64,2,66,220
2022,97220,RIVIERE PILOTE,249720053,CA DE L'ESPACE SUD DE LA MARTINIQUE,972,MARTINIQUE,47,12,59,27,23,7,30,116
2022,97229,SCHOELCHER,249720061,CA DU CENTRE DE LA MARTINIQUE,972,MARTINIQUE,172,13,185,48,71,9,80,313
2022,97402,BRAS PANON,249740093,CA INTERCOMMUNALE DE LA REUNION EST (CIREST),974,LA REUNION,52,72,124,48,61,4,65,236
2022,97407,LE PORT,249740101,CA TERRITOIRE DE LA COTE OUEST (TCO),974,LA REUNION,314,51,365,50,103,15,118,533
2022,97411,SAINT DENIS,249740119,CA INTERCOMMUNALE DU NORD DE LA REUNION (CINOR),974,LA REUNION,1401,728,2129,294,359,101,460,2883
2022,97415,SAINT PAUL,249740101,CA TERRITOIRE DE LA COTE OUEST (TCO),974,LA REUNION,449,609,1058,251,463,128,591,1899
2022,97416,SAINT PIERRE,249740077,CA CIVIS (COMMUNAUTE INTERCOMMUNALE DES VILLES SOLIDAIRES),974,LA REUNION,540,470,1010,124,419,62,481,1616
2022,97418,SAINTE MARIE,249740119,CA INTERCOMMUNALE DU NORD DE LA REUNION (CINOR),974,LA REUNION,459,241,700,1,178,42,220,922
2022,97422,LE TAMPON,249740085,CA DU SUD,974,LA REUNION,231,243,474,31,558,91,649,1154